rows 80
cols 100
players 5
m ...............................%%%.................%%.......%.................%%%%%%%%%%%..%%%%%%%%.
m ...............................%%%...............%%%%%.......................%%%%..%.%%...%%.%%%%%%.
m ..............%%%..............%%%..............%%%%%%....................%%.%%%%.........%%...%%...
m .......%%....%%..........%...%%%%%.....%.......%%%%%.%%..%....%...........%%.%%%%........%%%........
m .......%%..%%......%.....%...%%%%%...%..%.........%...........%....%......%%............%%%%........
m ..%.....%...%%%.%%%.%%...%...%%%%.......%.............%%%.....%...%%%.%%%.............%..%..........
m .............%%.%...%%...%%.%...........%%....%%.%%...%%%%.............%%...........................
m ................%.%.%%%................%%..%..%%%%%%%%%%%.......%.........%.........................
m ..................%...%.....%%%..%......%...%%%%%%%%%%%%%.................................%%%%%.....
m ................%.%%%%%.....%%%..%.%...%%%%..%%%%%%%%%%%%..%%...........%%%......%..........%%%.....
m ............4.....%%%.......%%%.......%.......%%%%%%%%%....%%%.%.........%%%.................%%.....
m ................%%%%%......%%%%%...%%%%%..%....%%%%%%%%%%%.%%............%%%%........%%.........%...
m ..............%%%%%%%......%%%.....%%%%..........%%%%%%%%%%..............%.......%...........%......
m ..%%...........%%%%%%.......%%.....%%%%%..%....%.%%%%%%%%%%.........................................
m .%%........%%..%%%%%%......%%.......%%%%%...%%%%..%%%%%%%%%.................................%.......
m ............%......%................%%%%%%%%%%%%..%%%%%%%%%..................%..............%.......
m ...........%%.......%.................%%%%%%%%%%%..%%%%%%%%................................%%%......
m .........%%%%%.......................%%%%..%.%%...%%.%%%%%%................................%%%......
m ........%%%%%%....................%%.%%%%.........%%...%%.................%%%..............%%%......
m .......%%%%%.%%..%....%...........%%.%%%%........%%%...............%%....%%..........%...%%%%%.....%
m %.........%...........%....%......%%............%%%%...............%%..%%......%.....%...%%%%%...%..
m %.............%%%.....%...%%%.%%%.............%..%............%.....%...%%%.%%%.%%...%...%%%%.......
m %%....%%.%%...%%%%.............%%........................................%%.%...%%...%%.%...........
m %..%..%%%%%%%%%%%.......%.........%.........................................%.%.%%%................%
m %...%%%%%%%%%%%%%.................................%%%%%.......................%...%.....%%%..%......
m %%%..%%%%%%%%%%%%..%%...........%%%......%..........%%%.....................%.%%%%%.....%%%..%.%...%
m ......%%%%%%%%%....%%%.%.........%%%.................%%.................2.....%%%.......%%%.......%.
m ..%....%%%%%%%%%%%.%%............%%%%........%%.........%...................%%%%%......%%%%%...%%%%%
m .........%%%%%%%%%%..............%.......%...........%....................%%%%%%%......%%%.....%%%%.
m ..%....%.%%%%%%%%%%...........................................%%...........%%%%%%.......%%.....%%%%%
m %...%%%%..%%%%%%%%%.................................%........%%........%%..%%%%%%......%%.......%%%%
m %%%%%%%%..%%%%%%%%%..................%..............%...................%......%................%%%%
m %%%%%%%%%..%%%%%%%%................................%%%.................%%.......%.................%%
m %..%.%%...%%.%%%%%%................................%%%...............%%%%%.......................%%%
m %.........%%...%%.................%%%..............%%%..............%%%%%%....................%%.%%%
m %........%%%...............%%....%%..........%...%%%%%.....%.......%%%%%.%%..%....%...........%%.%%%
m ........%%%%...............%%..%%......%.....%...%%%%%...%..%.........%...........%....%......%%....
m ......%..%............%.....%...%%%.%%%.%%...%...%%%%.......%.............%%%.....%...%%%.%%%.......
m .................................%%.%...%%...%%.%...........%%....%%.%%...%%%%.............%%.......
m ....................................%.%.%%%................%%..%..%%%%%%%%%%%.......%.........%.....
m ..........%%%%%.......................%...%.....%%%..%......%...%%%%%%%%%%%%%.......................
m .%..........%%%.....................%.%%%%%.....%%%..%.%...%%%%..%%%%%%%%%%%%..%%...........%%%.....
m .............%%.................0.....%%%.......%%%.......%.......%%%%%%%%%....%%%.%.........%%%....
m .....%%.........%...................%%%%%......%%%%%...%%%%%..%....%%%%%%%%%%%.%%............%%%%...
m .%...........%....................%%%%%%%......%%%.....%%%%..........%%%%%%%%%%..............%......
m ......................%%...........%%%%%%.......%%.....%%%%%..%....%.%%%%%%%%%%.....................
m ............%........%%........%%..%%%%%%......%%.......%%%%%...%%%%..%%%%%%%%%.....................
m ............%...................%......%................%%%%%%%%%%%%..%%%%%%%%%..................%..
m ...........%%%.................%%.......%.................%%%%%%%%%%%..%%%%%%%%.....................
m ...........%%%...............%%%%%.......................%%%%..%.%%...%%.%%%%%%.....................
m ...........%%%..............%%%%%%....................%%.%%%%.........%%...%%.................%%%...
m .....%...%%%%%.....%.......%%%%%.%%..%....%...........%%.%%%%........%%%...............%%....%%.....
m .....%...%%%%%...%..%.........%...........%....%......%%............%%%%...............%%..%%......%
m %%...%...%%%%.......%.............%%%.....%...%%%.%%%.............%..%............%.....%...%%%.%%%.
m %%...%%.%...........%%....%%.%%...%%%%.............%%........................................%%.%...
m %%%................%%..%..%%%%%%%%%%%.......%.........%.........................................%.%.
m ..%.....%%%..%......%...%%%%%%%%%%%%%.................................%%%%%.......................%.
m %%%.....%%%..%.%...%%%%..%%%%%%%%%%%%..%%...........%%%......%..........%%%.....................%.%%
m %.......%%%.......%.......%%%%%%%%%....%%%.%.........%%%.................%%.................3.....%%
m %......%%%%%...%%%%%..%....%%%%%%%%%%%.%%............%%%%........%%.........%...................%%%%
m %......%%%.....%%%%..........%%%%%%%%%%..............%.......%...........%....................%%%%%%
m %.......%%.....%%%%%..%....%.%%%%%%%%%%...........................................%%...........%%%%%
m %......%%.......%%%%%...%%%%..%%%%%%%%%.................................%........%%........%%..%%%%%
m ................%%%%%%%%%%%%..%%%%%%%%%..................%..............%...................%......%
m %.................%%%%%%%%%%%..%%%%%%%%................................%%%.................%%.......
m .................%%%%..%.%%...%%.%%%%%%................................%%%...............%%%%%......
m ..............%%.%%%%.........%%...%%.................%%%..............%%%..............%%%%%%......
m ..%...........%%.%%%%........%%%...............%%....%%..........%...%%%%%.....%.......%%%%%.%%..%..
m ..%....%......%%............%%%%...............%%..%%......%.....%...%%%%%...%..%.........%.........
m ..%...%%%.%%%.............%..%............%.....%...%%%.%%%.%%...%...%%%%.......%.............%%%...
m ...........%%........................................%%.%...%%...%%.%...........%%....%%.%%...%%%%..
m ....%.........%.........................................%.%.%%%................%%..%..%%%%%%%%%%%...
m ..............................%%%%%.......................%...%.....%%%..%......%...%%%%%%%%%%%%%...
m %...........%%%......%..........%%%.....................%.%%%%%.....%%%..%.%...%%%%..%%%%%%%%%%%%..%
m %%.%.........%%%.................%%.................1.....%%%.......%%%.......%.......%%%%%%%%%....%
m %............%%%%........%%.........%...................%%%%%......%%%%%...%%%%%..%....%%%%%%%%%%%.%
m .............%.......%...........%....................%%%%%%%......%%%.....%%%%..........%%%%%%%%%%.
m ..........................................%%...........%%%%%%.......%%.....%%%%%..%....%.%%%%%%%%%%.
m ................................%........%%........%%..%%%%%%......%%.......%%%%%...%%%%..%%%%%%%%%.
m .................%..............%...................%......%................%%%%%%%%%%%%..%%%%%%%%%.
