%%%%%%%%%%%%%%%%%%%%%%%%%%%
%.........................%
%.a.....................b.%
%.........................%
%.........................%
%.........................%
%.........................%
%.........................%
%.........................%
%.........................%
%.........................%
%.........................%
%.........................%
%.........................%
%.........................%
%.........................%
%.........................%
%.........................%
%.........................%
%.........................%
%.........................%
%.........................%
%.........................%
%.........................%
%.d.....................c.%
%.........................%
%%%%%%%%%%%%%%%%%%%%%%%%%%%