%%%%%%%%%%%%...%%%%%%%%%%%%
%..........%...%..........%
%..........%...%..........%
%..........%...%..........%
%...a.................b...%
%.........................%
%.........................%
%.........................%
%.........................%
%............%............%
%............%............%
%%%%.........%.........%%%%
.............%.............
.........%%%%%%%%%.........
.............%.............
%%%%.........%.........%%%%
%............%............%
%............%............%
%.........................%
%.........................%
%.........................%
%.........................%
%...d.................c...%
%..........%...%..........%
%..........%...%..........%
%..........%...%..........%
%%%%%%%%%%%%...%%%%%%%%%%%%