players 2
rows 90
cols 90
m %%%%%%%%%%%%%%%%%%%%%%%%%%%%%%%%%%%%%%%%%%%%%%%%%%%%%%%%%%%%%%%%%%%%%%%%%%%%%%%%%%%%%%%%%%
m %...........%....%...................%%%%%%%%%%%%%%%%...................%....%...........%
m %................%...................%%%%%%%%%%%%%%%%...................%................%
m %..%%................................%%%%%%%%%%%%%%%%................................%%..%
m %..%%%...............................%%%%%%%%%%%%%%%%...............................%%%..%
m %...%%...............................%%%%%%%%%%%%%%%%...............................%%...%
m %.....................................%%%%%%%%%%%%%%.....................................%
m %.......................................%%%%%%%%%%.......................................%
m %................................%........%%%%%%........%................................%
m %............a....................%..%....%%%%%%....%..%....................b............%
m %..............%%%....%...........%%%%%...%%%%%%...%%%%%...........%....%%%..............%
m %..................................%%%%...%%%%%%...%%%%..................................%
m %%................%.................%%%%%%%%%%%%%%%%%%.................%................%%
m %........b........%.................%%..%%%%%%%%%%..%%.................%........a........%
m %.................%.................%%..%.%%..%%.%..%%.................%.................%
m %.........%..........%%...............%.%.%....%.%.%...............%%..........%.........%
m %.........%.........%%%.......%%..........................%%.......%%%.........%.........%
m %%%.......%.........%.%.......%%..%%%.%............%.%%%..%%.......%.%.........%.......%%%
m %...........%%%....%..........%%...%%.%............%.%%...%%..........%....%%%...........%
m %.................%%.....%.....%%........................%%.....%.....%%.................%
m %...............%%..%....%.....%%%%%...%..........%...%%%%%.....%....%..%%...............%
m %..............%%..........%%....%%%%....%%....%%....%%%%....%%..........%%..............%
m %.........%....%%%....%%%..%%....%%%..%%.%%.%%.%%.%%..%%%....%%..%%%....%%%....%.........%
m %.....................%%%%%%%%%%%%%%.%%%%%%%%%%%%%%%%.%%%%%%%%%%%%%%.....................%
m %.....................%%%%%%%%%%%%%%.%%%%%%%%%%%%%%%%.%%%%%%%%%%%%%%.....................%
m %..................%%..%%%%%%%%%%%%....%%%%%%%%%%%%....%%%%%%%%%%%%..%%..................%
m %......................%%%%%%%%%%%%%.%.%%%%%%%%%%%%.%.%%%%%%%%%%%%%......................%
m %....................%%%%%%%%%%%%%%%%%%%%%%%%%%%%%%%%%%%%%%%%%%%%%%%%....................%
m %....................%%%%%%%%%%%%%%%%%%%%%%%%%%%%%%%%%%%%%%%%%%%%%%%%....................%
m %......................%%%%%%%%%%%%%%%%%%%%%%%%%%%%%%%%%%%%%%%%%%%%......................%
m %...............%%%....%%%%%%%%%%%%%%%%%%%%%%%%%%%%%%%%%%%%%%%%%%%%....%%%...............%
m %...............%%%%%..%%%%%%%%%%%%%%%%%%%%%%%%%%%%%%%%%%%%%%%%%%%%..%%%%%...............%
m %..................%%..%%%%%%%%%%%%%%%%%%%%%%%%%%%%%%%%%%%%%%%%%%%%..%%..................%
m %.......%...........%%%%%%%%%%%%%%%%%%%%%%%%%%%%%%%%%%%%%%%%%%%%%%%%%%...........%.......%
m %........%%......%..%%%%%%%%%%%%%%%%%%%%%%%%%%%%%%%%%%%%%%%%%%%%%%%%%%..%......%%........%
m %.........%%.....%%.%%%%%.%%%%%%%%%%%%%%%%%%%%%%%%%%%%%%%%%%%%%%.%%%%%.%%.....%%.........%
m %.........%%%%%..%%..%.....%%%%%%%%%%%%%%%%%%%%%%%%%%%%%%%%%%%%.....%..%%..%%%%%.........%
m %%%%%%...%%%%%%........%%.%%%%%%%%%%%%%%%%%%%%%%%%%%%%%%%%%%%%%%.%%........%%%%%%...%%%%%%
m %%%%%%%...%%%..%.%%...%%%..%%%%%%%%%%%%%%%%%%%%%%%%%%%%%%%%%%%%..%%%...%%.%..%%%...%%%%%%%
m %%%%%%%.....%.......%.%%%%%%%%%%%%%%%%%%%%%%%%%%%%%%%%%%%%%%%%%%%%%%.%.......%.....%%%%%%%
m %%%%%%%%....%%%%.......%%%%%%%%%%%%%%%%%%%%%%%%%%%%%%%%%%%%%%%%%%%%.......%%%%....%%%%%%%%
m %%%%%%%%....%%.......%%%%%%%%%%%%%%%%%%%%%%%%%%%%%%%%%%%%%%%%%%%%%%%%.......%%....%%%%%%%%
m %%%%%%%%%%%%%%%%.....%%%%%%%%%%%%%%%%%%%%%%%%%%%%%%%%%%%%%%%%%%%%%%%%.....%%%%%%%%%%%%%%%%
m %%%%%%%%%%%%%%%........%%%%%%%%%%%%%%%%%%%%%%%%%%%%%%%%%%%%%%%%%%%%........%%%%%%%%%%%%%%%
m %%%%%%%%%%%%%%........%%%%%%%%%%%%%%%%%%%%%%%%%%%%%%%%%%%%%%%%%%%%%%........%%%%%%%%%%%%%%
m %%%%%%%%%%%%%%........%%%%%%%%%%%%%%%%%%%%%%%%%%%%%%%%%%%%%%%%%%%%%%........%%%%%%%%%%%%%%
m %%%%%%%%%%%%%%%........%%%%%%%%%%%%%%%%%%%%%%%%%%%%%%%%%%%%%%%%%%%%........%%%%%%%%%%%%%%%
m %%%%%%%%%%%%%%%%.....%%%%%%%%%%%%%%%%%%%%%%%%%%%%%%%%%%%%%%%%%%%%%%%%.....%%%%%%%%%%%%%%%%
m %%%%%%%%....%%.......%%%%%%%%%%%%%%%%%%%%%%%%%%%%%%%%%%%%%%%%%%%%%%%%.......%%....%%%%%%%%
m %%%%%%%%....%%%%.......%%%%%%%%%%%%%%%%%%%%%%%%%%%%%%%%%%%%%%%%%%%%.......%%%%....%%%%%%%%
m %%%%%%%.....%.......%.%%%%%%%%%%%%%%%%%%%%%%%%%%%%%%%%%%%%%%%%%%%%%%.%.......%.....%%%%%%%
m %%%%%%%...%%%..%.%%...%%%..%%%%%%%%%%%%%%%%%%%%%%%%%%%%%%%%%%%%..%%%...%%.%..%%%...%%%%%%%
m %%%%%%...%%%%%%........%%.%%%%%%%%%%%%%%%%%%%%%%%%%%%%%%%%%%%%%%.%%........%%%%%%...%%%%%%
m %.........%%%%%..%%..%.....%%%%%%%%%%%%%%%%%%%%%%%%%%%%%%%%%%%%.....%..%%..%%%%%.........%
m %.........%%.....%%.%%%%%.%%%%%%%%%%%%%%%%%%%%%%%%%%%%%%%%%%%%%%.%%%%%.%%.....%%.........%
m %........%%......%..%%%%%%%%%%%%%%%%%%%%%%%%%%%%%%%%%%%%%%%%%%%%%%%%%%..%......%%........%
m %.......%...........%%%%%%%%%%%%%%%%%%%%%%%%%%%%%%%%%%%%%%%%%%%%%%%%%%...........%.......%
m %..................%%..%%%%%%%%%%%%%%%%%%%%%%%%%%%%%%%%%%%%%%%%%%%%..%%..................%
m %...............%%%%%..%%%%%%%%%%%%%%%%%%%%%%%%%%%%%%%%%%%%%%%%%%%%..%%%%%...............%
m %...............%%%....%%%%%%%%%%%%%%%%%%%%%%%%%%%%%%%%%%%%%%%%%%%%....%%%...............%
m %......................%%%%%%%%%%%%%%%%%%%%%%%%%%%%%%%%%%%%%%%%%%%%......................%
m %....................%%%%%%%%%%%%%%%%%%%%%%%%%%%%%%%%%%%%%%%%%%%%%%%%....................%
m %....................%%%%%%%%%%%%%%%%%%%%%%%%%%%%%%%%%%%%%%%%%%%%%%%%....................%
m %......................%%%%%%%%%%%%%.%.%%%%%%%%%%%%.%.%%%%%%%%%%%%%......................%
m %..................%%..%%%%%%%%%%%%....%%%%%%%%%%%%....%%%%%%%%%%%%..%%..................%
m %.....................%%%%%%%%%%%%%%.%%%%%%%%%%%%%%%%.%%%%%%%%%%%%%%.....................%
m %.....................%%%%%%%%%%%%%%.%%%%%%%%%%%%%%%%.%%%%%%%%%%%%%%.....................%
m %.........%....%%%....%%%..%%....%%%..%%.%%.%%.%%.%%..%%%....%%..%%%....%%%....%.........%
m %..............%%..........%%....%%%%....%%....%%....%%%%....%%..........%%..............%
m %...............%%..%....%.....%%%%%...%..........%...%%%%%.....%....%..%%...............%
m %.................%%.....%.....%%........................%%.....%.....%%.................%
m %...........%%%....%..........%%...%%.%............%.%%...%%..........%....%%%...........%
m %%%.......%.........%.%.......%%..%%%.%............%.%%%..%%.......%.%.........%.......%%%
m %.........%.........%%%.......%%..........................%%.......%%%.........%.........%
m %.........%..........%%...............%.%.%....%.%.%...............%%..........%.........%
m %.................%.................%%..%.%%..%%.%..%%.................%.................%
m %........a........%.................%%..%%%%%%%%%%..%%.................%........b........%
m %%................%.................%%%%%%%%%%%%%%%%%%.................%................%%
m %..................................%%%%...%%%%%%...%%%%..................................%
m %..............%%%....%...........%%%%%...%%%%%%...%%%%%...........%....%%%..............%
m %............b....................%..%....%%%%%%....%..%....................a............%
m %................................%........%%%%%%........%................................%
m %.......................................%%%%%%%%%%.......................................%
m %.....................................%%%%%%%%%%%%%%.....................................%
m %...%%...............................%%%%%%%%%%%%%%%%...............................%%...%
m %..%%%...............................%%%%%%%%%%%%%%%%...............................%%%..%
m %..%%................................%%%%%%%%%%%%%%%%................................%%..%
m %................%...................%%%%%%%%%%%%%%%%...................%................%
m %...........%....%...................%%%%%%%%%%%%%%%%...................%....%...........%
m %%%%%%%%%%%%%%%%%%%%%%%%%%%%%%%%%%%%%%%%%%%%%%%%%%%%%%%%%%%%%%%%%%%%%%%%%%%%%%%%%%%%%%%%%%

