players 8
rows 100
cols 100
m %%%%%%%%%%%%%%%%%%%%%%%%%%%%%%%%%%%%%%%%%%%%%%%%%%%%%%%%%%%%%%%%%%%%%%%%%%%%%%%%%%%%%%%%%%%%%%%%%%%%
m %%%%%%%%%%%%%%%%....................................................................%%%%%%%%%%%%%%%%
m %%%%%%%%%%%%%%%%....................................................................%%%%%%%%%%%%%%%%
m %%%%%%%%%%%%%%........................................................................%%%%%%%%%%%%%%
m %%%%%%%%%%%%%..........................................................................%%%%%%%%%%%%%
m %%%%%%%%%%%%%..........................................................................%%%%%%%%%%%%%
m %%%%%%%%%%%%%..........................................................................%%%%%%%%%%%%%
m %%%%%%%%%%%%%..........................................................................%%%%%%%%%%%%%
m %%%%%%%%%%%%%....%........%..............................................%........%....%%%%%%%%%%%%%
m %%%%%%%%%%%%%%..%..%%..........................................................%%..%..%%%%%%%%%%%%%%
m %%%%%%%%%%%%%.....................%..............................%.....................%%%%%%%%%%%%%
m %%%%%%%%%%%%%....%%...............%..............................%...............%%....%%%%%%%%%%%%%
m %%%%%%%%%%%%...%....%%%%%%%%%..........................................%%%%%%%%%....%...%%%%%%%%%%%%
m %%%%.....%....%%.%%%.%%%%%%%%..........................................%%%%%%%%.%%%.%%....%.....%%%%
m %%%..........%...%.%.%..%%%%%.%%................%..%................%%.%%%%%..%.%.%...%..........%%%
m %%%.........%%.%........%%%%%%%%................%..%................%%%%%%%%........%.%%.........%%%
m %........%...............%%%%%%%................%..%................%%%%%%%...............%........%
m %.......%..%.%%.....%.....%%%%%%...............%....%...............%%%%%%.....%.....%%.%..%.......%
m %..........%.%.............%%%%......................................%%%%.............%.%..........%
m %........%...%%....%%%.....%%%%.................%%%%.................%%%%.....%%%....%%...%........%
m %........%..%....%.%%%....%%%%..................%%%%..................%%%%....%%%.%....%..%........%
m %...........%%%....%%%%%...%%%.%%...............%%%%...............%%.%%%...%%%%%....%%%...........%
m %...........%%.......%%%.......................%%%%%%.......................%%%.......%%...........%
m %...........%%.......%%..........................%%..........................%%.......%%...........%
m %...........%%%%................................%%%%................................%%%%...........%
m %...........%%%%%..........%%...................%%%%...................%%..........%%%%%...........%
m %.......%...%%%%%%..%..........%...............%%%%%%...............%..........%..%%%%%%...%.......%
m %...........%%%%%%%%%%...%.%%%.........a....%..%%%%%%..%....b.........%%%.%...%%%%%%%%%%...........%
m %...........%%%%%%%%%%...%.%..............%%%..%%%%%%..%%%..............%.%...%%%%%%%%%%...........%
m %..............%%%%%%%.....%....%%..%%....%%%%%%%%%%%%%%%%....%%..%%....%.....%%%%%%%..............%
m %.............%%%%%%..........%%%%%%%%%%%.%%%%%%%%%%%%%%%%.%%%%%%%%%%%..........%%%%%%.............%
m %.............%%%%...%....%...%%%%%%%%%%%%%%%%%%%%%%%%%%%%%%%%%%%%%%%%...%....%...%%%%.............%
m %....................%.......%%%%%%%%%%%%%%%%%%%%%%%%%%%%%%%%%%%%%%%%%%.......%....................%
m %............................%%%%%%%%%%%%%%%%%%%%%%%%%%%%%%%%%%%%%%%%%%............................%
m %.........%%..................%%%%%%%%%%%%%%%%%%%%%%%%%%%%%%%%%%%%%%%%..................%%.........%
m %.............................%%%%%%%%%%%%%%%%%%%%%%%%%%%%%%%%%%%%%%%%.............................%
m %............................%%%%%%%%%%%%%%%%%%%%%%%%%%%%%%%%%%%%%%%%%%............................%
m %............................%%%%%%%%%%%%%%%%%%%%%%%%%%%%%%%%%%%%%%%%%%............................%
m %.............................%%%%%%%%%%%%%%%%%%%%%%%%%%%%%%%%%%%%%%%%.............................%
m %..........................a..%%%%%%%%%%%%%%%%%%%%%%%%%%%%%%%%%%%%%%%%..b..........................%
m %.............................%%%%%%%%%%%%%%%%%%%%%%%%%%%%%%%%%%%%%%%%.............................%
m %..............................%%%%%%%%%%%%%%%%%%%%%%%%%%%%%%%%%%%%%%..............................%
m %...........................%%%%%%%%%%%%%%%%%%%%%%%%%%%%%%%%%%%%%%%%%%%%...........................%
m %...........................%%%%%%%%%%%%%%%%%%%%%%%%%%%%%%%%%%%%%%%%%%%%...........................%
m %..........................%%%%%%%%%%%%%%%%%%%%%%%%%%%%%%%%%%%%%%%%%%%%%%..........................%
m %............................%%%%%%%%%%%%%%%%%%%%%%%%%%%%%%%%%%%%%%%%%%............................%
m %............................%%%%%%%%%%%%%%%%%%%%%%%%%%%%%%%%%%%%%%%%%%............................%
m %................%....%...%%%%%%%%%%%%%%%%%%%%%%%%%%%%%%%%%%%%%%%%%%%%%%%%...%....%................%
m %.............%%%..%%%%.%%%%%%%%%%%%%%%%%%%%%%%%%%%%%%%%%%%%%%%%%%%%%%%%%%%%.%%%%..%%%.............%
m %..................%%%%%%%%%%%%%%%%%%%%%%%%%%%%%%%%%%%%%%%%%%%%%%%%%%%%%%%%%%%%%%..................%
m %..................%%%%%%%%%%%%%%%%%%%%%%%%%%%%%%%%%%%%%%%%%%%%%%%%%%%%%%%%%%%%%%..................%
m %.............%%%..%%%%.%%%%%%%%%%%%%%%%%%%%%%%%%%%%%%%%%%%%%%%%%%%%%%%%%%%%.%%%%..%%%.............%
m %................%....%...%%%%%%%%%%%%%%%%%%%%%%%%%%%%%%%%%%%%%%%%%%%%%%%%...%....%................%
m %............................%%%%%%%%%%%%%%%%%%%%%%%%%%%%%%%%%%%%%%%%%%............................%
m %............................%%%%%%%%%%%%%%%%%%%%%%%%%%%%%%%%%%%%%%%%%%............................%
m %..........................%%%%%%%%%%%%%%%%%%%%%%%%%%%%%%%%%%%%%%%%%%%%%%..........................%
m %...........................%%%%%%%%%%%%%%%%%%%%%%%%%%%%%%%%%%%%%%%%%%%%...........................%
m %...........................%%%%%%%%%%%%%%%%%%%%%%%%%%%%%%%%%%%%%%%%%%%%...........................%
m %..............................%%%%%%%%%%%%%%%%%%%%%%%%%%%%%%%%%%%%%%..............................%
m %.............................%%%%%%%%%%%%%%%%%%%%%%%%%%%%%%%%%%%%%%%%.............................%
m %..........................b..%%%%%%%%%%%%%%%%%%%%%%%%%%%%%%%%%%%%%%%%..a..........................%
m %.............................%%%%%%%%%%%%%%%%%%%%%%%%%%%%%%%%%%%%%%%%.............................%
m %............................%%%%%%%%%%%%%%%%%%%%%%%%%%%%%%%%%%%%%%%%%%............................%
m %............................%%%%%%%%%%%%%%%%%%%%%%%%%%%%%%%%%%%%%%%%%%............................%
m %.............................%%%%%%%%%%%%%%%%%%%%%%%%%%%%%%%%%%%%%%%%.............................%
m %.........%%..................%%%%%%%%%%%%%%%%%%%%%%%%%%%%%%%%%%%%%%%%..................%%.........%
m %............................%%%%%%%%%%%%%%%%%%%%%%%%%%%%%%%%%%%%%%%%%%............................%
m %....................%.......%%%%%%%%%%%%%%%%%%%%%%%%%%%%%%%%%%%%%%%%%%.......%....................%
m %.............%%%%...%....%...%%%%%%%%%%%%%%%%%%%%%%%%%%%%%%%%%%%%%%%%...%....%...%%%%.............%
m %.............%%%%%%..........%%%%%%%%%%%.%%%%%%%%%%%%%%%%.%%%%%%%%%%%..........%%%%%%.............%
m %..............%%%%%%%.....%....%%..%%....%%%%%%%%%%%%%%%%....%%..%%....%.....%%%%%%%..............%
m %...........%%%%%%%%%%...%.%..............%%%..%%%%%%..%%%..............%.%...%%%%%%%%%%...........%
m %...........%%%%%%%%%%...%.%%%.........b....%..%%%%%%..%....a.........%%%.%...%%%%%%%%%%...........%
m %.......%...%%%%%%..%..........%...............%%%%%%...............%..........%..%%%%%%...%.......%
m %...........%%%%%..........%%...................%%%%...................%%..........%%%%%...........%
m %...........%%%%................................%%%%................................%%%%...........%
m %...........%%.......%%..........................%%..........................%%.......%%...........%
m %...........%%.......%%%.......................%%%%%%.......................%%%.......%%...........%
m %...........%%%....%%%%%...%%%.%%...............%%%%...............%%.%%%...%%%%%....%%%...........%
m %........%..%....%.%%%....%%%%..................%%%%..................%%%%....%%%.%....%..%........%
m %........%...%%....%%%.....%%%%.................%%%%.................%%%%.....%%%....%%...%........%
m %..........%.%.............%%%%......................................%%%%.............%.%..........%
m %.......%..%.%%.....%.....%%%%%%...............%....%...............%%%%%%.....%.....%%.%..%.......%
m %........%...............%%%%%%%................%..%................%%%%%%%...............%........%
m %%%.........%%.%........%%%%%%%%................%..%................%%%%%%%%........%.%%.........%%%
m %%%..........%...%.%.%..%%%%%.%%................%..%................%%.%%%%%..%.%.%...%..........%%%
m %%%%.....%....%%.%%%.%%%%%%%%..........................................%%%%%%%%.%%%.%%....%.....%%%%
m %%%%%%%%%%%%...%....%%%%%%%%%..........................................%%%%%%%%%....%...%%%%%%%%%%%%
m %%%%%%%%%%%%%....%%...............%..............................%...............%%....%%%%%%%%%%%%%
m %%%%%%%%%%%%%.....................%..............................%.....................%%%%%%%%%%%%%
m %%%%%%%%%%%%%%..%..%%..........................................................%%..%..%%%%%%%%%%%%%%
m %%%%%%%%%%%%%....%........%..............................................%........%....%%%%%%%%%%%%%
m %%%%%%%%%%%%%..........................................................................%%%%%%%%%%%%%
m %%%%%%%%%%%%%..........................................................................%%%%%%%%%%%%%
m %%%%%%%%%%%%%..........................................................................%%%%%%%%%%%%%
m %%%%%%%%%%%%%..........................................................................%%%%%%%%%%%%%
m %%%%%%%%%%%%%%........................................................................%%%%%%%%%%%%%%
m %%%%%%%%%%%%%%%%....................................................................%%%%%%%%%%%%%%%%
m %%%%%%%%%%%%%%%%....................................................................%%%%%%%%%%%%%%%%
m %%%%%%%%%%%%%%%%%%%%%%%%%%%%%%%%%%%%%%%%%%%%%%%%%%%%%%%%%%%%%%%%%%%%%%%%%%%%%%%%%%%%%%%%%%%%%%%%%%%%

