players 8
rows 108
cols 108
m %%%%%%%%%%%%%%%%%%%%%%%%%%%%%%%%%%%%%%%%%%%%%%%%%%%%%%%%%%%%%%%%%%%%%%%%%%%%%%%%%%%%%%%%%%%%%%%%%%%%%%%%%%%%
m %%%%%%%%%%%%%%%%%%%%.....%%%%%%.%%%%%%%%%%%%%%%%%%%%%%%%%%%%%%%%%%%%%%%%%%%%.%%%%%%.....%%%%%%%%%%%%%%%%%%%%
m %%%%%%%%%%%%%%%%%%%..%%.%%%%.%..%%%%%%%%%%%%%%%%%%%%%%%%%%%%%%%%%%%%%%%%%%%%..%.%%%%.%%..%%%%%%%%%%%%%%%%%%%
m %%%%%%%%%%%%%%%%%%...%%%%%%%....%.%%%%%%%%%%%%%%%%%%%%%%%%%%%%%%%%%%%%%%%%.%....%%%%%%%...%%%%%%%%%%%%%%%%%%
m %%%%%%%%%%%%%%%%%%....%%%%%.......%%.%%%%%%%%%%%%%%%%%%%%%%%%%%%%%%%%%%.%%.......%%%%%....%%%%%%%%%%%%%%%%%%
m %%%%%%%%%%%%%%%%%...%.%%%%%.....%%...%%%%%%%%%%%%%%%%%%%%%%%%%%%%%%%%%%...%%.....%%%%%.%...%%%%%%%%%%%%%%%%%
m %%%%%%%%%%%%%%%%......%%............%....%%%%%%%%%%%%%%%%%%%%%%%%%%....%............%%......%%%%%%%%%%%%%%%%
m %%%%%%%%%%%%%%%%....%%%......%%%%...%%.....%%%%%%%%%%%%%%%%%%%%%%.....%%...%%%%......%%%....%%%%%%%%%%%%%%%%
m %%%%%%%%%%%%%%%%%%%.%%%..%....%%%%.........%%%%%%%%%%%%%%%%%%%%%%.........%%%%....%..%%%.%%%%%%%%%%%%%%%%%%%
m %%%%%%%%%%%%%%%%%...%%%..%....%%%%.........%%%%%%%%%%%%%%%%%%%%%%.........%%%%....%..%%%...%%%%%%%%%%%%%%%%%
m %%%%%%%%%%%%%%%%%..%%%......%.%%%%%%.%%%%%...%%%%%%%%%%%%%%%%%%...%%%%%.%%%%%%.%......%%%..%%%%%%%%%%%%%%%%%
m %%%%%%%%%%%%%%%%.......%....%.%%%%...%%%%....%%%%%%%%%%%%%%%%%%....%%%%...%%%%.%....%.......%%%%%%%%%%%%%%%%
m %%%%%%%%%%%%%%%%...........%%..%%%.%...%%%.%%%%%%%%%%%%%%%%%%%%%%.%%%...%.%%%..%%...........%%%%%%%%%%%%%%%%
m %%%%%%%%%%%%%%%%....%......%%%..%%.....%%%.%%%%%%%%%%%%%%%%%%%%%%.%%%.....%%..%%%......%....%%%%%%%%%%%%%%%%
m %%%%%%%%%%%%%%%%...%%......%%%..%............%.%%%%%%%%%%%%%%.%............%..%%%......%%...%%%%%%%%%%%%%%%%
m %%%%%%%%%%%%%%%%....%%.......%.%%%..............%%%%%%%%%%%%..............%%%.%.......%%....%%%%%%%%%%%%%%%%
m %%%%%%..%%%.....%%%%.......%....%%...............%%%%%%%%%%...............%%....%.......%%%%.....%%%..%%%%%%
m %%%%%...%.......%%%...%...%%....%...............%%%%%%%%%%%%...............%....%%...%...%%%.......%...%%%%%
m %%%.....%.......%%%.%...%%%%%...................%%%%%%%%%%%%...................%%%%%...%.%%%.......%.....%%%
m %%........%...%.%..%......%.%%.....................%%%%%%.....................%%.%......%..%.%...%........%%
m %....%.%%%%..%%%..%.......%.%.....%%%................%%................%%%.....%.%.......%..%%%..%%%%.%....%
m %.%%...%%%%....%........%%....%%............................................%%....%%........%....%%%%...%%.%
m %.%%%%%%%%.......%.....%%%.......................a........b.......................%%%.....%.......%%%%%%%%.%
m %..%%%%....%..........%..%...%................................................%...%..%..........%....%%%%..%
m %.%%%%............%..%%..............................................................%%..%............%%%%.%
m %%%%%%..%%........%..%%%...%....................................................%...%%%..%........%%..%%%%%%
m %%%%%%...........%%%%..................................................................%%%%...........%%%%%%
m %%%%........%%%.%%%......%..........%..................................%..........%......%%%.%%%........%%%%
m %%........%%%%%...%%%..........%%..........................................%%..........%%%...%%%%%........%%
m %%%....%.....%%%...%...%............................................................%...%...%%%.....%....%%%
m %%.....%%%%%.........%................................................................%.........%%%%%.....%%
m %......%%%%%%..%.....%......%..................................................%......%.....%..%%%%%%......%
m %%%%.%.%%%%%%%%%%%..........%..................................................%..........%%%%%%%%%%%.%.%%%%
m %%%..%..%%%%%%.%%..........................................................................%%.%%%%%%..%..%%%
m %%%%%.....%.........%..................................................................%.........%.....%%%%%
m %%%%%.....%.%.......%..................................................................%.......%.%.....%%%%%
m %%%%..%%............%......%....................................................%......%............%%..%%%%
m %%%%%%.%..%%....................................................................................%%..%.%%%%%%
m %%%%%%....%%....................................................................................%%....%%%%%%
m %%%%%%....%%%%................................................................................%%%%....%%%%%%
m %%%%%%....%%%%................................................................................%%%%....%%%%%%
m %%%%%%%...%.%%....................................%%%%%%%%....................................%%.%...%%%%%%%
m %%%%%%%..............................................%%..............................................%%%%%%%
m %%%%%%%%%%..%%.......................................%%.......................................%%..%%%%%%%%%%
m %%%%%%%%%%..%%.......................................%%.......................................%%..%%%%%%%%%%
m %%%%%%%%%%%%%%%..............................................................................%%%%%%%%%%%%%%%
m %%%%%%%%%%%%%%................................................................................%%%%%%%%%%%%%%
m %%%%%%%%%%%%%%%......................................%%......................................%%%%%%%%%%%%%%%
m %%%%%%%%%%%%%%%%.%%..................................%%..................................%%.%%%%%%%%%%%%%%%%
m %%%%%%%%%%%%%%%%%%%...c..........................%...%%...%..........................c...%%%%%%%%%%%%%%%%%%%
m %%%%%%%%%%%%%%%%%%%......................%........%......%........%......................%%%%%%%%%%%%%%%%%%%
m %%%%%%%%%%%%%%%%%%%%.....................%...........%%...........%.....................%%%%%%%%%%%%%%%%%%%%
m %%%%%%%%%%%%%%%%%%%%.....................%..........%%%%..........%.....................%%%%%%%%%%%%%%%%%%%%
m %%%%%%%%%%%%%%%%%%%%%....................%%%%..%%%.%%%%%%.%%%..%%%%....................%%%%%%%%%%%%%%%%%%%%%
m %%%%%%%%%%%%%%%%%%%%%....................%%%%..%%%.%%%%%%.%%%..%%%%....................%%%%%%%%%%%%%%%%%%%%%
m %%%%%%%%%%%%%%%%%%%%.....................%..........%%%%..........%.....................%%%%%%%%%%%%%%%%%%%%
m %%%%%%%%%%%%%%%%%%%%.....................%...........%%...........%.....................%%%%%%%%%%%%%%%%%%%%
m %%%%%%%%%%%%%%%%%%%......................%........%......%........%......................%%%%%%%%%%%%%%%%%%%
m %%%%%%%%%%%%%%%%%%%...d..........................%...%%...%..........................d...%%%%%%%%%%%%%%%%%%%
m %%%%%%%%%%%%%%%%.%%..................................%%..................................%%.%%%%%%%%%%%%%%%%
m %%%%%%%%%%%%%%%......................................%%......................................%%%%%%%%%%%%%%%
m %%%%%%%%%%%%%%................................................................................%%%%%%%%%%%%%%
m %%%%%%%%%%%%%%%..............................................................................%%%%%%%%%%%%%%%
m %%%%%%%%%%..%%.......................................%%.......................................%%..%%%%%%%%%%
m %%%%%%%%%%..%%.......................................%%.......................................%%..%%%%%%%%%%
m %%%%%%%..............................................%%..............................................%%%%%%%
m %%%%%%%...%.%%....................................%%%%%%%%....................................%%.%...%%%%%%%
m %%%%%%....%%%%................................................................................%%%%....%%%%%%
m %%%%%%....%%%%................................................................................%%%%....%%%%%%
m %%%%%%....%%....................................................................................%%....%%%%%%
m %%%%%%.%..%%....................................................................................%%..%.%%%%%%
m %%%%..%%............%......%....................................................%......%............%%..%%%%
m %%%%%.....%.%.......%..................................................................%.......%.%.....%%%%%
m %%%%%.....%.........%..................................................................%.........%.....%%%%%
m %%%..%..%%%%%%.%%..........................................................................%%.%%%%%%..%..%%%
m %%%%.%.%%%%%%%%%%%..........%..................................................%..........%%%%%%%%%%%.%.%%%%
m %......%%%%%%..%.....%......%..................................................%......%.....%..%%%%%%......%
m %%.....%%%%%.........%................................................................%.........%%%%%.....%%
m %%%....%.....%%%...%...%............................................................%...%...%%%.....%....%%%
m %%........%%%%%...%%%..........%%..........................................%%..........%%%...%%%%%........%%
m %%%%........%%%.%%%......%..........%..................................%..........%......%%%.%%%........%%%%
m %%%%%%...........%%%%..................................................................%%%%...........%%%%%%
m %%%%%%..%%........%..%%%...%....................................................%...%%%..%........%%..%%%%%%
m %.%%%%............%..%%..............................................................%%..%............%%%%.%
m %..%%%%....%..........%..%...%................................................%...%..%..........%....%%%%..%
m %.%%%%%%%%.......%.....%%%.......................a........b.......................%%%.....%.......%%%%%%%%.%
m %.%%...%%%%....%........%%....%%............................................%%....%%........%....%%%%...%%.%
m %....%.%%%%..%%%..%.......%.%.....%%%................%%................%%%.....%.%.......%..%%%..%%%%.%....%
m %%........%...%.%..%......%.%%.....................%%%%%%.....................%%.%......%..%.%...%........%%
m %%%.....%.......%%%.%...%%%%%...................%%%%%%%%%%%%...................%%%%%...%.%%%.......%.....%%%
m %%%%%...%.......%%%...%...%%....%...............%%%%%%%%%%%%...............%....%%...%...%%%.......%...%%%%%
m %%%%%%..%%%.....%%%%.......%....%%...............%%%%%%%%%%...............%%....%.......%%%%.....%%%..%%%%%%
m %%%%%%%%%%%%%%%%....%%.......%.%%%..............%%%%%%%%%%%%..............%%%.%.......%%....%%%%%%%%%%%%%%%%
m %%%%%%%%%%%%%%%%...%%......%%%..%............%.%%%%%%%%%%%%%%.%............%..%%%......%%...%%%%%%%%%%%%%%%%
m %%%%%%%%%%%%%%%%....%......%%%..%%.....%%%.%%%%%%%%%%%%%%%%%%%%%%.%%%.....%%..%%%......%....%%%%%%%%%%%%%%%%
m %%%%%%%%%%%%%%%%...........%%..%%%.%...%%%.%%%%%%%%%%%%%%%%%%%%%%.%%%...%.%%%..%%...........%%%%%%%%%%%%%%%%
m %%%%%%%%%%%%%%%%.......%....%.%%%%...%%%%....%%%%%%%%%%%%%%%%%%....%%%%...%%%%.%....%.......%%%%%%%%%%%%%%%%
m %%%%%%%%%%%%%%%%%..%%%......%.%%%%%%.%%%%%...%%%%%%%%%%%%%%%%%%...%%%%%.%%%%%%.%......%%%..%%%%%%%%%%%%%%%%%
m %%%%%%%%%%%%%%%%%...%%%..%....%%%%.........%%%%%%%%%%%%%%%%%%%%%%.........%%%%....%..%%%...%%%%%%%%%%%%%%%%%
m %%%%%%%%%%%%%%%%%%%.%%%..%....%%%%.........%%%%%%%%%%%%%%%%%%%%%%.........%%%%....%..%%%.%%%%%%%%%%%%%%%%%%%
m %%%%%%%%%%%%%%%%....%%%......%%%%...%%.....%%%%%%%%%%%%%%%%%%%%%%.....%%...%%%%......%%%....%%%%%%%%%%%%%%%%
m %%%%%%%%%%%%%%%%......%%............%....%%%%%%%%%%%%%%%%%%%%%%%%%%....%............%%......%%%%%%%%%%%%%%%%
m %%%%%%%%%%%%%%%%%...%.%%%%%.....%%...%%%%%%%%%%%%%%%%%%%%%%%%%%%%%%%%%%...%%.....%%%%%.%...%%%%%%%%%%%%%%%%%
m %%%%%%%%%%%%%%%%%%....%%%%%.......%%.%%%%%%%%%%%%%%%%%%%%%%%%%%%%%%%%%%.%%.......%%%%%....%%%%%%%%%%%%%%%%%%
m %%%%%%%%%%%%%%%%%%...%%%%%%%....%.%%%%%%%%%%%%%%%%%%%%%%%%%%%%%%%%%%%%%%%%.%....%%%%%%%...%%%%%%%%%%%%%%%%%%
m %%%%%%%%%%%%%%%%%%%..%%.%%%%.%..%%%%%%%%%%%%%%%%%%%%%%%%%%%%%%%%%%%%%%%%%%%%..%.%%%%.%%..%%%%%%%%%%%%%%%%%%%
m %%%%%%%%%%%%%%%%%%%%.....%%%%%%.%%%%%%%%%%%%%%%%%%%%%%%%%%%%%%%%%%%%%%%%%%%%.%%%%%%.....%%%%%%%%%%%%%%%%%%%%
m %%%%%%%%%%%%%%%%%%%%%%%%%%%%%%%%%%%%%%%%%%%%%%%%%%%%%%%%%%%%%%%%%%%%%%%%%%%%%%%%%%%%%%%%%%%%%%%%%%%%%%%%%%%%

