players 8
rows 104
cols 104
m %%%%%%%%%%%%%%%%%%%%%%%%%%%%%%%%%%%%%%%%%%%%%%%%%%%%%%%%%%%%%%%%%%%%%%%%%%%%%%%%%%%%%%%%%%%%%%%%%%%%%%%%
m %%............%.%%%%%%%%%%%%%%%%%%%%..%%..%..%%%%%%%%%%%%%%..%..%%..%%%%%%%%%%%%%%%%%%%%.%............%%
m %...............%%%%%%%%%%%%%%%%%%%%.........%%%%%%%%%%%%%%.........%%%%%%%%%%%%%%%%%%%%...............%
m %...............%%%%%%%%%%%%%%%%%%%..........%%%%%%%%%%%%%%..........%%%%%%%%%%%%%%%%%%%...............%
m %............%...%%%%%%%%%%%%%%%%%%.........%%%%%%%%%%%%%%%%.........%%%%%%%%%%%%%%%%%%...%............%
m %.................%%%%%%%%%%%%%%%%%.....%%%%%%%%%%%%%%%%%%%%%%%%.....%%%%%%%%%%%%%%%%%.................%
m %...................%%%%%%%%%%%%%.........%%%%%%%%%%%%%%%%%%%%.........%%%%%%%%%%%%%...................%
m %.......................%....%%..........%...%.%%%%%%%%%%.%...%..........%%....%.......................%
m %............................%...%%........%....%%%%%%%%....%........%%...%............................%
m %...........................%...%%%...........%.%%%%%%%%.%...........%%%...%...........................%
m %..............................%%%%%%.......%%%.%%%%%%%%.%%%.......%%%%%%..............................%
m %........................%%..%%%%%%%.............%%%%%%.............%%%%%%%..%%........................%
m %........................%%%%%%%%%%%.........%...%%%%%%...%.........%%%%%%%%%%%........................%
m %...%......................%%%%%%%....%%.......%.%%%%%%.%.......%%....%%%%%%%......................%...%
m %%.........................%%%%%%%....%%.........%%%%%%.........%%....%%%%%%%.........................%%
m %........................%%%%%%%%%....%%.......%%%%%%%%%%.......%%....%%%%%%%%%........................%
m %%%%......................%%%%%%%%%%.%%%.%....%%%%%%%%%%%%....%.%%%.%%%%%%%%%%......................%%%%
m %%%%%................%..%.%%%%%%%%%....%.....%%%%%%%%%%%%%%.....%....%%%%%%%%%.%..%................%%%%%
m %%%%%%.............%.%%%%a%%%%%%%%%...........%%%%%..%%%%%...........%%%%%%%%%b%%%%.%.............%%%%%%
m %%%%%%............%%%%%%%.%%%%%%%%%%%..............................%%%%%%%%%%%.%%%%%%%............%%%%%%
m %%%%%%%............%%%%%..%%%%%%%%%%................................%%%%%%%%%%..%%%%%............%%%%%%%
m %%%%%%%..........%%%%%%..%%%%%%%%%%%%.........%..........%.........%%%%%%%%%%%%..%%%%%%..........%%%%%%%
m %%%%%%%...........%%%%...%%%%%%%%%%%........%%%..........%%%........%%%%%%%%%%%...%%%%...........%%%%%%%
m %%%%%%%...........%%%....%%%%%%%%%%..................................%%%%%%%%%%....%%%...........%%%%%%%
m %%%%%%%%.........%%%.....%%%%%%%%%................%..%................%%%%%%%%%.....%%%.........%%%%%%%%
m %%%%%%%....%%..%..c..%%%%...%%%%%......%%%....%..%%..%%..%....%%%......%%%%%...%%%%..d..%..%%....%%%%%%%
m %%%%%%%....%%..%%%%%%%%%%....%...%%....%%%%..%%..%%..%%..%%..%%%%....%%...%....%%%%%%%%%%..%%....%%%%%%%
m %%%%%%%.....%%%%%%%%%%%%%.......%%%....%.....%%...%..%...%%.....%....%%%.......%%%%%%%%%%%%%.....%%%%%%%
m %%%%%%%..%..%%%%%%%%%%%%%%........%%.........%....%..%....%.........%%........%%%%%%%%%%%%%%..%..%%%%%%%
m %%%%%%%%%..%%%%%%%%%%%%%%%%........%%.......%%..%......%..%%.......%%........%%%%%%%%%%%%%%%%..%%%%%%%%%
m %%%%%%%%...%%%%%%%%%%%%%%%.......%......%...%%%...%%%%...%%%...%......%.......%%%%%%%%%%%%%%%...%%%%%%%%
m %%%%%%%...%%%%%%%%%%%%%%%%..................%%%...%%%%...%%%..................%%%%%%%%%%%%%%%%...%%%%%%%
m %%%%%%%..%%%%%%%%%%%%%%%%%.%..............%%%%..%%%%%%%%..%%%%..............%.%%%%%%%%%%%%%%%%%..%%%%%%%
m %%%%%%..%%%%%%%%%%%%%%%%%.%%..%....%.......%%%.%%%%%%%%%%.%%%.......%....%..%%.%%%%%%%%%%%%%%%%%..%%%%%%
m %%%%%%..%%%%%...%%%%%%%%..%%%...........%%.%%%.%%%%%%%%%%.%%%.%%...........%%%..%%%%%%%%...%%%%%..%%%%%%
m %%%.......%%%...%..%%%%.....%%...%......%%..%...%%%%%%%%...%..%%......%...%%.....%%%%..%...%%%.......%%%
m %.........%........%.%.......%.......%%%%%%.%.%%%%%%%%%%%%.%.%%%%%%.......%.......%.%........%.........%
m %...............%...................%%%%%%%...%%%%%%%%%%%%...%%%%%%%...................%...............%
m %%...........%%%%...................%%%%%%%%..%%%%%%%%%%%%..%%%%%%%%...................%%%%...........%%
m %%...........%%%%%.......%%%........%%%%%%%%...%%%%%%%%%%...%%%%%%%%........%%%.......%%%%%...........%%
m %....%...................%%...%...%%%%%%%%%%%..%%%%%%%%%%..%%%%%%%%%%%...%...%%...................%....%
m %....%.%........%........%%.......%%%%%%%%%%.....%%%%%%.....%%%%%%%%%%.......%%........%........%.%....%
m %%...%%...................%.....%...%%%%%%%......%%..%%......%%%%%%%...%.....%...................%%...%%
m %....%%.%.......................%%%...%%%%....................%%%%...%%%.......................%.%%....%
m %...%%%...%...........%......%%%%%%%%...%...%..............%...%...%%%%%%%%......%...........%...%%%...%
m %%%%%%%%..%.%....%....%...%%%%%%%%%..........%%...%%%%...%%..........%%%%%%%%%...%....%....%.%..%%%%%%%%
m %%%%%%%..%%.....%%%..%%..%%%..%%....%%%......%%%%.%%%%.%%%%......%%%....%%..%%%..%%..%%%.....%%..%%%%%%%
m %%%%%%%%.....%.%%%%..............%%.%%%%%.....%%%%%%%%%%%%.....%%%%%.%%..............%%%%.%.....%%%%%%%%
m %%%%%%%%%%%....%%%%..........%..%%%%%%%%%.....%%%%%%%%%%%%.....%%%%%%%%%..%..........%%%%....%%%%%%%%%%%
m %%%%%%%%%%%%%%%%%%%......%%.....%%%%%%%%%%%....%%%%%%%%%%....%%%%%%%%%%%.....%%......%%%%%%%%%%%%%%%%%%%
m %%%%%%%%%%%%%%%%%%%.....%%%%%.%%%%%%%%%%%%%..%%%%%%%%%%%%%%..%%%%%%%%%%%%%.%%%%%.....%%%%%%%%%%%%%%%%%%%
m %%%%%%%%%%%%%%%%%%............%%%%%%%%%%%%...%%%%%%%%%%%%%%...%%%%%%%%%%%%............%%%%%%%%%%%%%%%%%%
m %%%%%%%%%%%%%%%%%%............%%%%%%%%%%%%...%%%%%%%%%%%%%%...%%%%%%%%%%%%............%%%%%%%%%%%%%%%%%%
m %%%%%%%%%%%%%%%%%%%.....%%%%%.%%%%%%%%%%%%%..%%%%%%%%%%%%%%..%%%%%%%%%%%%%.%%%%%.....%%%%%%%%%%%%%%%%%%%
m %%%%%%%%%%%%%%%%%%%......%%.....%%%%%%%%%%%....%%%%%%%%%%....%%%%%%%%%%%.....%%......%%%%%%%%%%%%%%%%%%%
m %%%%%%%%%%%....%%%%..........%..%%%%%%%%%.....%%%%%%%%%%%%.....%%%%%%%%%..%..........%%%%....%%%%%%%%%%%
m %%%%%%%%.....%.%%%%..............%%.%%%%%.....%%%%%%%%%%%%.....%%%%%.%%..............%%%%.%.....%%%%%%%%
m %%%%%%%..%%.....%%%..%%..%%%..%%....%%%......%%%%.%%%%.%%%%......%%%....%%..%%%..%%..%%%.....%%..%%%%%%%
m %%%%%%%%..%.%....%....%...%%%%%%%%%..........%%...%%%%...%%..........%%%%%%%%%...%....%....%.%..%%%%%%%%
m %...%%%...%...........%......%%%%%%%%...%...%..............%...%...%%%%%%%%......%...........%...%%%...%
m %....%%.%.......................%%%...%%%%....................%%%%...%%%.......................%.%%....%
m %%...%%...................%.....%...%%%%%%%......%%..%%......%%%%%%%...%.....%...................%%...%%
m %....%.%........%........%%.......%%%%%%%%%%.....%%%%%%.....%%%%%%%%%%.......%%........%........%.%....%
m %....%...................%%...%...%%%%%%%%%%%..%%%%%%%%%%..%%%%%%%%%%%...%...%%...................%....%
m %%...........%%%%%.......%%%........%%%%%%%%...%%%%%%%%%%...%%%%%%%%........%%%.......%%%%%...........%%
m %%...........%%%%...................%%%%%%%%..%%%%%%%%%%%%..%%%%%%%%...................%%%%...........%%
m %...............%...................%%%%%%%...%%%%%%%%%%%%...%%%%%%%...................%...............%
m %.........%........%.%.......%.......%%%%%%.%.%%%%%%%%%%%%.%.%%%%%%.......%.......%.%........%.........%
m %%%.......%%%...%..%%%%.....%%...%......%%..%...%%%%%%%%...%..%%......%...%%.....%%%%..%...%%%.......%%%
m %%%%%%..%%%%%...%%%%%%%%..%%%...........%%.%%%.%%%%%%%%%%.%%%.%%...........%%%..%%%%%%%%...%%%%%..%%%%%%
m %%%%%%..%%%%%%%%%%%%%%%%%.%%..%....%.......%%%.%%%%%%%%%%.%%%.......%....%..%%.%%%%%%%%%%%%%%%%%..%%%%%%
m %%%%%%%..%%%%%%%%%%%%%%%%%.%..............%%%%..%%%%%%%%..%%%%..............%.%%%%%%%%%%%%%%%%%..%%%%%%%
m %%%%%%%...%%%%%%%%%%%%%%%%..................%%%...%%%%...%%%..................%%%%%%%%%%%%%%%%...%%%%%%%
m %%%%%%%%...%%%%%%%%%%%%%%%.......%......%...%%%...%%%%...%%%...%......%.......%%%%%%%%%%%%%%%...%%%%%%%%
m %%%%%%%%%..%%%%%%%%%%%%%%%%........%%.......%%..%......%..%%.......%%........%%%%%%%%%%%%%%%%..%%%%%%%%%
m %%%%%%%..%..%%%%%%%%%%%%%%........%%.........%....%..%....%.........%%........%%%%%%%%%%%%%%..%..%%%%%%%
m %%%%%%%.....%%%%%%%%%%%%%.......%%%....%.....%%...%..%...%%.....%....%%%.......%%%%%%%%%%%%%.....%%%%%%%
m %%%%%%%....%%..%%%%%%%%%%....%...%%....%%%%..%%..%%..%%..%%..%%%%....%%...%....%%%%%%%%%%..%%....%%%%%%%
m %%%%%%%....%%..%..e..%%%%...%%%%%......%%%....%..%%..%%..%....%%%......%%%%%...%%%%..f..%..%%....%%%%%%%
m %%%%%%%%.........%%%.....%%%%%%%%%................%..%................%%%%%%%%%.....%%%.........%%%%%%%%
m %%%%%%%...........%%%....%%%%%%%%%%..................................%%%%%%%%%%....%%%...........%%%%%%%
m %%%%%%%...........%%%%...%%%%%%%%%%%........%%%..........%%%........%%%%%%%%%%%...%%%%...........%%%%%%%
m %%%%%%%..........%%%%%%..%%%%%%%%%%%%.........%..........%.........%%%%%%%%%%%%..%%%%%%..........%%%%%%%
m %%%%%%%............%%%%%..%%%%%%%%%%................................%%%%%%%%%%..%%%%%............%%%%%%%
m %%%%%%............%%%%%%%.%%%%%%%%%%%..............................%%%%%%%%%%%.%%%%%%%............%%%%%%
m %%%%%%.............%.%%%%g%%%%%%%%%...........%%%%%..%%%%%...........%%%%%%%%%h%%%%.%.............%%%%%%
m %%%%%................%..%.%%%%%%%%%....%.....%%%%%%%%%%%%%%.....%....%%%%%%%%%.%..%................%%%%%
m %%%%......................%%%%%%%%%%.%%%.%....%%%%%%%%%%%%....%.%%%.%%%%%%%%%%......................%%%%
m %........................%%%%%%%%%....%%.......%%%%%%%%%%.......%%....%%%%%%%%%........................%
m %%.........................%%%%%%%....%%.........%%%%%%.........%%....%%%%%%%.........................%%
m %...%......................%%%%%%%....%%.......%.%%%%%%.%.......%%....%%%%%%%......................%...%
m %........................%%%%%%%%%%%.........%...%%%%%%...%.........%%%%%%%%%%%........................%
m %........................%%..%%%%%%%.............%%%%%%.............%%%%%%%..%%........................%
m %..............................%%%%%%.......%%%.%%%%%%%%.%%%.......%%%%%%..............................%
m %...........................%...%%%...........%.%%%%%%%%.%...........%%%...%...........................%
m %............................%...%%........%....%%%%%%%%....%........%%...%............................%
m %.......................%....%%..........%...%.%%%%%%%%%%.%...%..........%%....%.......................%
m %...................%%%%%%%%%%%%%.........%%%%%%%%%%%%%%%%%%%%.........%%%%%%%%%%%%%...................%
m %.................%%%%%%%%%%%%%%%%%.....%%%%%%%%%%%%%%%%%%%%%%%%.....%%%%%%%%%%%%%%%%%.................%
m %............%...%%%%%%%%%%%%%%%%%%.........%%%%%%%%%%%%%%%%.........%%%%%%%%%%%%%%%%%%...%............%
m %...............%%%%%%%%%%%%%%%%%%%..........%%%%%%%%%%%%%%..........%%%%%%%%%%%%%%%%%%%...............%
m %...............%%%%%%%%%%%%%%%%%%%%.........%%%%%%%%%%%%%%.........%%%%%%%%%%%%%%%%%%%%...............%
m %%............%.%%%%%%%%%%%%%%%%%%%%..%%..%..%%%%%%%%%%%%%%..%..%%..%%%%%%%%%%%%%%%%%%%%.%............%%
m %%%%%%%%%%%%%%%%%%%%%%%%%%%%%%%%%%%%%%%%%%%%%%%%%%%%%%%%%%%%%%%%%%%%%%%%%%%%%%%%%%%%%%%%%%%%%%%%%%%%%%%%

