players 4
rows 96
cols 96
m %%%%%%%%%%%%%%%%%%%%%%%%%%%%%%%%%%%%%%%%%%%%%%%%%%%%%%%%%%%%%%%%%%%%%%%%%%%%%%%%%%%%%%%%%%%%%%%%
m %.......%..................%%.......%%%%%%%%%%%%%%%%%%%%%%%%.......%%..................%.......%
m %..........................%.......%%%%%%%%%%%%%%%%%%%%%%%%%%.......%..........................%
m %....................%%%%...........%%%%%%%%%%%%%%%%%%%%%%%%...........%%%%....................%
m %....................%%%%...........%%%%%%%%%%%%%%%%%%%%%%%%...........%%%%....................%
m %....................%%....%.........%%%%%%%%%%%%%%%%%%%%%%.........%....%%....................%
m %....................................%%%%%%%%%%%%%%%%%%%%%%....................................%
m %...........................%......%%%%%%%%%%%%%%%%%%%%%%%%%%......%...........................%
m %%................%........%%......%%.a%%%%%%%%%%%%%%%%%%b.%%......%%........%................%%
m %................%%..%%...............%%%%%%%%%%%%%%%%%%%%...............%%..%%................%
m %..........%...........................%%%%%%%%%%%%%%%%%%...........................%..........%
m %.........%......%.......%%...%.%%.%%..%%%%%%%%%%%%%%%%%%..%%.%%.%...%%.......%......%.........%
m %............%%%........%%%%..%%...%%..%%%%%%%%%%%%%%%%%%..%%...%%..%%%%........%%%............%
m %...........%%.....%%.%%%%%%.......%%..%%%%.%......%.%%%%..%%.......%%%%%%.%%.....%%...........%
m %...........%...%..%%%%%%%.....%%%%%%%%%................%%%%%%%%%.....%%%%%%%..%...%...........%
m %...........%..%%...%...%......%%%%%%%%..................%%%%%%%%......%...%...%%..%...........%
m %.............%%................%%%%%%%%...%%......%%...%%%%%%%%................%%.............%
m %........%.%.....%%..%%............%%%%%%..............%%%%%%............%%..%%.....%.%........%
m %.......%%.......%.............%%...%%....................%%...%%.............%.......%%.......%
m %............%%.....%%.........%%....%....................%....%%.........%%.....%%............%
m %............%%%...%.%........%%................................%%........%.%...%%%............%
m %..%%%...%....%..%.%%.........%%..%..........................%..%%.........%%.%..%....%...%%%..%
m %..%%%...%...%%..%............%%%.%%%%..%..............%..%%%%.%%%............%..%%...%...%%%..%
m %..%%........%%.................%%%%%%%..................%%%%%%%.................%%........%%..%
m %..%%.......%%%%..................%%%%....................%%%%..................%%%%.......%%..%
m %..........%%%%....................%........................%....................%%%%..........%
m %..........%%%.....................%..........%%%%..........%.....................%%%..........%
m %%%..%..%...%%................................%%%%................................%%...%..%..%%%
m %%.....%%....................%........%......%%%%%%......%........%....................%%.....%%
m %...........................%........%..%%..%%%%%%%%..%%..%........%...........................%
m %..........%%.......%%%........%.....%..%%...%%%%%%...%%..%.....%........%%%.......%%..........%
m %...........%.%%..%%%%%.......%..%.....%%%...%%%%%%...%%%.....%..%.......%%%%%..%%.%...........%
m %..........%..%%%.%%..%%.........%...%........%%%%........%...%.........%%..%%.%%%..%..........%
m %..........%..%%%......%.......%%...........%......%...........%%.......%......%%%..%..........%
m %.............%%%....%%%%...................%......%...................%%%%....%%%.............%
m %.%....%%..%%%%%%%....%%%%%..........................................%%%%%....%%%%%%%..%%....%.%
m %%%%%..%%..%%%%%%%%...%%%..............................................%%%...%%%%%%%%..%%..%%%%%
m %%%%%%%%......%%%%%%..%%%....%%.%..............................%.%%....%%%..%%%%%%......%%%%%%%%
m %%%%%%%%c%....%%%%.....%....%.................%%%%.................%....%.....%%%%....%c%%%%%%%%
m %%%%%%%%%%%%%%%.%%.............%........%.%%..%%%%..%%.%........%.............%%.%%%%%%%%%%%%%%%
m %%%%%%%%%%%%%%...%....%......%%%.......%%%%%%%%%%%%%%%%%%.......%%%......%....%...%%%%%%%%%%%%%%
m %%%%%%%%%%%%%%...............%%%........%%%%%%%%%%%%%%%%........%%%...............%%%%%%%%%%%%%%
m %%%%%%%%%%%%%%.........................%%%%%%%%%%%%%%%%%%.........................%%%%%%%%%%%%%%
m %%%%%%%%%%%%%...%......................%%%%%%%%%%%%%%%%%%......................%...%%%%%%%%%%%%%
m %%%%%%%%%%%%%%..%............%...%%.....%%%%%%%%%%%%%%%%.....%%...%............%..%%%%%%%%%%%%%%
m %%%%%%%%%%%%%...............%%%%........%%%%%%%%%%%%%%%%........%%%%...............%%%%%%%%%%%%%
m %%%%%%%%%%%%%.............%%%%%%%.....%%%%%%%%%%%%%%%%%%%%.....%%%%%%%.............%%%%%%%%%%%%%
m %%%%%%%%%%%%%.............%%%%%%%.....%%%%%%%%%%%%%%%%%%%%.....%%%%%%%.............%%%%%%%%%%%%%
m %%%%%%%%%%%%%.............%%%%%%%.....%%%%%%%%%%%%%%%%%%%%.....%%%%%%%.............%%%%%%%%%%%%%
m %%%%%%%%%%%%%.............%%%%%%%.....%%%%%%%%%%%%%%%%%%%%.....%%%%%%%.............%%%%%%%%%%%%%
m %%%%%%%%%%%%%...............%%%%........%%%%%%%%%%%%%%%%........%%%%...............%%%%%%%%%%%%%
m %%%%%%%%%%%%%%..%............%...%%.....%%%%%%%%%%%%%%%%.....%%...%............%..%%%%%%%%%%%%%%
m %%%%%%%%%%%%%...%......................%%%%%%%%%%%%%%%%%%......................%...%%%%%%%%%%%%%
m %%%%%%%%%%%%%%.........................%%%%%%%%%%%%%%%%%%.........................%%%%%%%%%%%%%%
m %%%%%%%%%%%%%%...............%%%........%%%%%%%%%%%%%%%%........%%%...............%%%%%%%%%%%%%%
m %%%%%%%%%%%%%%...%....%......%%%.......%%%%%%%%%%%%%%%%%%.......%%%......%....%...%%%%%%%%%%%%%%
m %%%%%%%%%%%%%%%.%%.............%........%.%%..%%%%..%%.%........%.............%%.%%%%%%%%%%%%%%%
m %%%%%%%%d%....%%%%.....%....%.................%%%%.................%....%.....%%%%....%d%%%%%%%%
m %%%%%%%%......%%%%%%..%%%....%%.%..............................%.%%....%%%..%%%%%%......%%%%%%%%
m %%%%%..%%..%%%%%%%%...%%%..............................................%%%...%%%%%%%%..%%..%%%%%
m %.%....%%..%%%%%%%....%%%%%..........................................%%%%%....%%%%%%%..%%....%.%
m %.............%%%....%%%%...................%......%...................%%%%....%%%.............%
m %..........%..%%%......%.......%%...........%......%...........%%.......%......%%%..%..........%
m %..........%..%%%.%%..%%.........%...%........%%%%........%...%.........%%..%%.%%%..%..........%
m %...........%.%%..%%%%%.......%..%.....%%%...%%%%%%...%%%.....%..%.......%%%%%..%%.%...........%
m %..........%%.......%%%........%.....%..%%...%%%%%%...%%..%.....%........%%%.......%%..........%
m %...........................%........%..%%..%%%%%%%%..%%..%........%...........................%
m %%.....%%....................%........%......%%%%%%......%........%....................%%.....%%
m %%%..%..%...%%................................%%%%................................%%...%..%..%%%
m %..........%%%.....................%..........%%%%..........%.....................%%%..........%
m %..........%%%%....................%........................%....................%%%%..........%
m %..%%.......%%%%..................%%%%....................%%%%..................%%%%.......%%..%
m %..%%........%%.................%%%%%%%..................%%%%%%%.................%%........%%..%
m %..%%%...%...%%..%............%%%.%%%%..%..............%..%%%%.%%%............%..%%...%...%%%..%
m %..%%%...%....%..%.%%.........%%..%..........................%..%%.........%%.%..%....%...%%%..%
m %............%%%...%.%........%%................................%%........%.%...%%%............%
m %............%%.....%%.........%%....%....................%....%%.........%%.....%%............%
m %.......%%.......%.............%%...%%....................%%...%%.............%.......%%.......%
m %........%.%.....%%..%%............%%%%%%..............%%%%%%............%%..%%.....%.%........%
m %.............%%................%%%%%%%%...%%......%%...%%%%%%%%................%%.............%
m %...........%..%%...%...%......%%%%%%%%..................%%%%%%%%......%...%...%%..%...........%
m %...........%...%..%%%%%%%.....%%%%%%%%%................%%%%%%%%%.....%%%%%%%..%...%...........%
m %...........%%.....%%.%%%%%%.......%%..%%%%.%......%.%%%%..%%.......%%%%%%.%%.....%%...........%
m %............%%%........%%%%..%%...%%..%%%%%%%%%%%%%%%%%%..%%...%%..%%%%........%%%............%
m %.........%......%.......%%...%.%%.%%..%%%%%%%%%%%%%%%%%%..%%.%%.%...%%.......%......%.........%
m %..........%...........................%%%%%%%%%%%%%%%%%%...........................%..........%
m %................%%..%%...............%%%%%%%%%%%%%%%%%%%%...............%%..%%................%
m %%................%........%%......%%.a%%%%%%%%%%%%%%%%%%b.%%......%%........%................%%
m %...........................%......%%%%%%%%%%%%%%%%%%%%%%%%%%......%...........................%
m %....................................%%%%%%%%%%%%%%%%%%%%%%....................................%
m %....................%%....%.........%%%%%%%%%%%%%%%%%%%%%%.........%....%%....................%
m %....................%%%%...........%%%%%%%%%%%%%%%%%%%%%%%%...........%%%%....................%
m %....................%%%%...........%%%%%%%%%%%%%%%%%%%%%%%%...........%%%%....................%
m %..........................%.......%%%%%%%%%%%%%%%%%%%%%%%%%%.......%..........................%
m %.......%..................%%.......%%%%%%%%%%%%%%%%%%%%%%%%.......%%..................%.......%
m %%%%%%%%%%%%%%%%%%%%%%%%%%%%%%%%%%%%%%%%%%%%%%%%%%%%%%%%%%%%%%%%%%%%%%%%%%%%%%%%%%%%%%%%%%%%%%%%

