players 2
rows 94
cols 94
m %%%%%%%%%%%%%%%%%%%%%%%%%%%%%%%%%%%%%%%%%%%%%%%%%%%%%%%%%%%%%%%%%%%%%%%%%%%%%%%%%%%%%%%%%%%%%%
m %%%%%%%%%%%%%%%%%%%%%%%................................................%%%%%%%%%%%%%%%%%%%%%%%
m %%%%%%%%%%%%%%%%%%%%%%%................................................%%%%%%%%%%%%%%%%%%%%%%%
m %%%%%%%%%%%%%%%%%%%%%%%........%..............%%..............%........%%%%%%%%%%%%%%%%%%%%%%%
m %%%%%%%%%%%%%%%%%%%%%%........................%%........................%%%%%%%%%%%%%%%%%%%%%%
m %%%%%%%%%%%%%%%%%%%%%.........................%%.........................%%%%%%%%%%%%%%%%%%%%%
m %%%%%%%%%%%%%%%%%%%%%........................%..%........................%%%%%%%%%%%%%%%%%%%%%
m %%%%%%%%%%%%%%%%.%%%%........................%..%........................%%%%.%%%%%%%%%%%%%%%%
m %%%%%%%%%%%%%%%..%%%..%.%%%........a......................b........%%%.%..%%%..%%%%%%%%%%%%%%%
m %%%%%%%%%%%%%%%....%..%%%%%%.............%..........%.............%%%%%%..%....%%%%%%%%%%%%%%%
m %%%%%%%%%%%%%%%%%%...%%%%%%%.............%..........%.............%%%%%%%...%%%%%%%%%%%%%%%%%%
m %%%%%%%%%%%%%%%%%%%..%%%%%%%%%................%%................%%%%%%%%%..%%%%%%%%%%%%%%%%%%%
m %%%%%%%%%%%%%%%%%%%...%%%%%%%%................%%................%%%%%%%%...%%%%%%%%%%%%%%%%%%%
m %%%%%%%%%%%%%%%%%%%.%.%%%%%%.................%%%%.................%%%%%%.%.%%%%%%%%%%%%%%%%%%%
m %%%%%%%%%%%%%%%%%%%%%%%%%%...................%%%%...................%%%%%%%%%%%%%%%%%%%%%%%%%%
m %%%%%%%%..%%%%%%%%%%%%%%%%..................%%%%%%..................%%%%%%%%%%%%%%%%..%%%%%%%%
m %%%%%%%...%%%%%%%%%%%%%%%%%................%%%%%%%%................%%%%%%%%%%%%%%%%%...%%%%%%%
m %%%%%%%%%.%%%%%%%%%%%%%%%%%%................%%%%%%................%%%%%%%%%%%%%%%%%%.%%%%%%%%%
m %%%%%%%%%..%%%%%%%%%%%%%%%%%.............%..%%%%%%..%.............%%%%%%%%%%%%%%%%%..%%%%%%%%%
m %%%%%%%%%%....%%%%%%%%%%%%%%................%%%%%%................%%%%%%%%%%%%%%....%%%%%%%%%%
m %%%%%%%%.....%%%%%%%%%%%%%%%.................%%%%.................%%%%%%%%%%%%%%%.....%%%%%%%%
m %%%%%.....%%..%%%%%%%%%%%%%%%%...............%%%%...............%%%%%%%%%%%%%%%%..%%.....%%%%%
m %%%%....%%%%%%%%%%%%%%%%%%%%%%%%.%.%.....%..%%%%%%..%.....%.%.%%%%%%%%%%%%%%%%%%%%%%%%....%%%%
m %........%%%%%%%%%%%%%%%%%%%%%%%%%%%%%%.......%%.......%%%%%%%%%%%%%%%%%%%%%%%%%%%%%%........%
m %.......%%%%%%%%%%%%%%%%%%%%%%%%%%%%%%%................%%%%%%%%%%%%%%%%%%%%%%%%%%%%%%%.......%
m %.......%%%%%%%%%%%%%%%%%%%%%%%%%%%%%%%%..............%%%%%%%%%%%%%%%%%%%%%%%%%%%%%%%%.......%
m %.......%%%%%%..%%%%%%%%%%%%%%%%%%%%%%%%..............%%%%%%%%%%%%%%%%%%%%%%%%..%%%%%%.......%
m %........%%%%%...%%%%%%%%%%%%%%%%%%%%%%%%............%%%%%%%%%%%%%%%%%%%%%%%%...%%%%%........%
m %..........%%........%%%%%%%%%%%%%%%%%%%..............%%%%%%%%%%%%%%%%%%%........%%..........%
m %..........%%........%%%%%%%%%%%%%%%%%%%%............%%%%%%%%%%%%%%%%%%%%........%%..........%
m %.....................%%%%%%%%%%%%%%%%%%%%..........%%%%%%%%%%%%%%%%%%%%.....................%
m %..%..................%%%%%%%%%%%%%%%%%%%%..........%%%%%%%%%%%%%%%%%%%%..................%..%
m %......................%%%%%%%%%%%%%%%%%..............%%%%%%%%%%%%%%%%%......................%
m %.....................%%%%%%%%%%%%%%%%%%...%%....%%...%%%%%%%%%%%%%%%%%%.....................%
m %......................%%%%%%%%%%%%%%%%.......%%.......%%%%%%%%%%%%%%%%......................%
m %.......b.............%%%%%%%%%%%%%%%%......%.%%.%......%%%%%%%%%%%%%%%%.............a.......%
m %......................%%%%%%%%%%%%%%%%................%%%%%%%%%%%%%%%%......................%
m %......................%%%%%%%%%%%%%%%%%.%..........%.%%%%%%%%%%%%%%%%%......................%
m %......................%%%%%%%%%%%%.%%%%%%%........%%%%%%%.%%%%%%%%%%%%......................%
m %........................%%%%%%%%%...%%%%%..........%%%%%...%%%%%%%%%........................%
m %..........................%.%%%......%%%%..........%%%%......%%%.%..........................%
m %........%%.......%...%.......%%.....%%%%%.%..%%..%.%%%%%.....%%.......%...%.......%%........%
m %.....................................%...%%%.%%.%%%...%.....................................%
m %...............%................%.......%%%%%%%%%%%%.......%................%...............%
m %..............%%%%%..%..........%.%......%%%%%%%%%%......%.%..........%..%%%%%..............%
m %.....%%.....%%%%%%%%%%....................%%%%%%%%....................%%%%%%%%%%.....%%.....%
m %..%%%.....%%%%%%%%%%%%%..........%%.....%%%%%%%%%%%%.....%%..........%%%%%%%%%%%%%.....%%%..%
m %..%%%.....%%%%%%%%%%%%%..........%%.....%%%%%%%%%%%%.....%%..........%%%%%%%%%%%%%.....%%%..%
m %.....%%.....%%%%%%%%%%....................%%%%%%%%....................%%%%%%%%%%.....%%.....%
m %..............%%%%%..%..........%.%......%%%%%%%%%%......%.%..........%..%%%%%..............%
m %...............%................%.......%%%%%%%%%%%%.......%................%...............%
m %.....................................%...%%%.%%.%%%...%.....................................%
m %........%%.......%...%.......%%.....%%%%%.%..%%..%.%%%%%.....%%.......%...%.......%%........%
m %..........................%.%%%......%%%%..........%%%%......%%%.%..........................%
m %........................%%%%%%%%%...%%%%%..........%%%%%...%%%%%%%%%........................%
m %......................%%%%%%%%%%%%.%%%%%%%........%%%%%%%.%%%%%%%%%%%%......................%
m %......................%%%%%%%%%%%%%%%%%.%..........%.%%%%%%%%%%%%%%%%%......................%
m %......................%%%%%%%%%%%%%%%%................%%%%%%%%%%%%%%%%......................%
m %.......a.............%%%%%%%%%%%%%%%%......%.%%.%......%%%%%%%%%%%%%%%%.............b.......%
m %......................%%%%%%%%%%%%%%%%.......%%.......%%%%%%%%%%%%%%%%......................%
m %.....................%%%%%%%%%%%%%%%%%%...%%....%%...%%%%%%%%%%%%%%%%%%.....................%
m %......................%%%%%%%%%%%%%%%%%..............%%%%%%%%%%%%%%%%%......................%
m %..%..................%%%%%%%%%%%%%%%%%%%%..........%%%%%%%%%%%%%%%%%%%%..................%..%
m %.....................%%%%%%%%%%%%%%%%%%%%..........%%%%%%%%%%%%%%%%%%%%.....................%
m %..........%%........%%%%%%%%%%%%%%%%%%%%............%%%%%%%%%%%%%%%%%%%%........%%..........%
m %..........%%........%%%%%%%%%%%%%%%%%%%..............%%%%%%%%%%%%%%%%%%%........%%..........%
m %........%%%%%...%%%%%%%%%%%%%%%%%%%%%%%%............%%%%%%%%%%%%%%%%%%%%%%%%...%%%%%........%
m %.......%%%%%%..%%%%%%%%%%%%%%%%%%%%%%%%..............%%%%%%%%%%%%%%%%%%%%%%%%..%%%%%%.......%
m %.......%%%%%%%%%%%%%%%%%%%%%%%%%%%%%%%%..............%%%%%%%%%%%%%%%%%%%%%%%%%%%%%%%%.......%
m %.......%%%%%%%%%%%%%%%%%%%%%%%%%%%%%%%................%%%%%%%%%%%%%%%%%%%%%%%%%%%%%%%.......%
m %........%%%%%%%%%%%%%%%%%%%%%%%%%%%%%%.......%%.......%%%%%%%%%%%%%%%%%%%%%%%%%%%%%%........%
m %%%%....%%%%%%%%%%%%%%%%%%%%%%%%.%.%.....%..%%%%%%..%.....%.%.%%%%%%%%%%%%%%%%%%%%%%%%....%%%%
m %%%%%.....%%..%%%%%%%%%%%%%%%%...............%%%%...............%%%%%%%%%%%%%%%%..%%.....%%%%%
m %%%%%%%%.....%%%%%%%%%%%%%%%.................%%%%.................%%%%%%%%%%%%%%%.....%%%%%%%%
m %%%%%%%%%%....%%%%%%%%%%%%%%................%%%%%%................%%%%%%%%%%%%%%....%%%%%%%%%%
m %%%%%%%%%..%%%%%%%%%%%%%%%%%.............%..%%%%%%..%.............%%%%%%%%%%%%%%%%%..%%%%%%%%%
m %%%%%%%%%.%%%%%%%%%%%%%%%%%%................%%%%%%................%%%%%%%%%%%%%%%%%%.%%%%%%%%%
m %%%%%%%...%%%%%%%%%%%%%%%%%................%%%%%%%%................%%%%%%%%%%%%%%%%%...%%%%%%%
m %%%%%%%%..%%%%%%%%%%%%%%%%..................%%%%%%..................%%%%%%%%%%%%%%%%..%%%%%%%%
m %%%%%%%%%%%%%%%%%%%%%%%%%%...................%%%%...................%%%%%%%%%%%%%%%%%%%%%%%%%%
m %%%%%%%%%%%%%%%%%%%.%.%%%%%%.................%%%%.................%%%%%%.%.%%%%%%%%%%%%%%%%%%%
m %%%%%%%%%%%%%%%%%%%...%%%%%%%%................%%................%%%%%%%%...%%%%%%%%%%%%%%%%%%%
m %%%%%%%%%%%%%%%%%%%..%%%%%%%%%................%%................%%%%%%%%%..%%%%%%%%%%%%%%%%%%%
m %%%%%%%%%%%%%%%%%%...%%%%%%%.............%..........%.............%%%%%%%...%%%%%%%%%%%%%%%%%%
m %%%%%%%%%%%%%%%....%..%%%%%%.............%..........%.............%%%%%%..%....%%%%%%%%%%%%%%%
m %%%%%%%%%%%%%%%..%%%..%.%%%........b......................a........%%%.%..%%%..%%%%%%%%%%%%%%%
m %%%%%%%%%%%%%%%%.%%%%........................%..%........................%%%%.%%%%%%%%%%%%%%%%
m %%%%%%%%%%%%%%%%%%%%%........................%..%........................%%%%%%%%%%%%%%%%%%%%%
m %%%%%%%%%%%%%%%%%%%%%.........................%%.........................%%%%%%%%%%%%%%%%%%%%%
m %%%%%%%%%%%%%%%%%%%%%%........................%%........................%%%%%%%%%%%%%%%%%%%%%%
m %%%%%%%%%%%%%%%%%%%%%%%........%..............%%..............%........%%%%%%%%%%%%%%%%%%%%%%%
m %%%%%%%%%%%%%%%%%%%%%%%................................................%%%%%%%%%%%%%%%%%%%%%%%
m %%%%%%%%%%%%%%%%%%%%%%%................................................%%%%%%%%%%%%%%%%%%%%%%%
m %%%%%%%%%%%%%%%%%%%%%%%%%%%%%%%%%%%%%%%%%%%%%%%%%%%%%%%%%%%%%%%%%%%%%%%%%%%%%%%%%%%%%%%%%%%%%%

