players 2
rows 94
cols 94
m %%%%%%%%%%%%%%%%%%%%%%%%%%%%%%%%%%%%%%%%%%%%%%%%%%%%%%%%%%%%%%%%%%%%%%%%%%%%%%%%%%%%%%%%%%%%%%
m %%%%%%%%%%%%%%%%%%%...%%........%%%........................%%%........%%...%%%%%%%%%%%%%%%%%%%
m %%%%%%%%%%%%%%%%%%%...%%........%.%..%..................%..%.%........%%...%%%%%%%%%%%%%%%%%%%
m %%%%%%%%%%%%%%%%%%%%.......%......................................%.......%%%%%%%%%%%%%%%%%%%%
m %%%%%%%%%%%%%%%%%%%%......................................................%%%%%%%%%%%%%%%%%%%%
m %%%%%%%%%%%%%%%%%%%%................%....................%................%%%%%%%%%%%%%%%%%%%%
m %%%%%%%%%%%%%%%%%%%..............%..%....................%..%..............%%%%%%%%%%%%%%%%%%%
m %%%%%%%%%%%%%%%%%%%........................................................%%%%%%%%%%%%%%%%%%%
m %%%%%%%%%%%%%%%%%%%%.........%..................................%.........%%%%%%%%%%%%%%%%%%%%
m %%%%%%%%%%%%%%%%%%%%%%%%.%..........................................%.%%%%%%%%%%%%%%%%%%%%%%%%
m %%%%%%%%%%%%%%%%%%%%%%%%%............................................%%%%%%%%%%%%%%%%%%%%%%%%%
m %%%%%%%%%%%%%%%%%%%%%%%%..............................................%%%%%%%%%%%%%%%%%%%%%%%%
m %%%%%%%%%%%%%%%%%%%%%%%%..............................................%%%%%%%%%%%%%%%%%%%%%%%%
m %%%%%%%%%%%%%%%%%%%%%%%%..............................................%%%%%%%%%%%%%%%%%%%%%%%%
m %%%%%%%%%%%%%%%%%%%%%....................................................%%%%%%%%%%%%%%%%%%%%%
m %%%%%%%%%%%%%%%%%%%%...%..............................................%...%%%%%%%%%%%%%%%%%%%%
m %%%%%%%%%%%%%%%%%............................................................%%%%%%%%%%%%%%%%%
m %%%%%%%%%%%%%%%%..............................................................%%%%%%%%%%%%%%%%
m %%%%%%%%%%%%%%%%..............................................................%%%%%%%%%%%%%%%%
m %..%%%..%%%%%%%%..............................................................%%%%%%%%..%%%..%
m %........%%%%%%.......%................................................%.......%%%%%%........%
m %........%%%%%.......%%%%............................................%%%%.......%%%%%........%
m %%%......%%%%%......%%%%..............................................%%%%......%%%%%......%%%
m %%%......%%%%%.%.....%%.......a................................a.......%%.....%.%%%%%......%%%
m %.........%..........%..................................................%..........%.........%
m %........%..........................................................................%........%
m %............................................................................................%
m %..%......................................................................................%..%
m %............................................................................................%
m %.......%............................................................................%.......%
m %......................a..............................................a......................%
m %............................................................................................%
m %%%........................................................................................%%%
m %%....%................................................................................%....%%
m %%%........................................................................................%%%
m %............................................................................................%
m %....%%................................................................................%%....%
m %.%........................................................................................%.%
m %............................................................................................%
m %............................................................................................%
m %.............................................%%.............................................%
m %............................................................................................%
m %............................................................................................%
m %............................................................................................%
m %............................................................................................%
m %............................................................................................%
m %.......................................%............%.......................................%
m %.......................................%............%.......................................%
m %............................................................................................%
m %............................................................................................%
m %............................................................................................%
m %............................................................................................%
m %............................................................................................%
m %.............................................%%.............................................%
m %............................................................................................%
m %............................................................................................%
m %.%........................................................................................%.%
m %....%%................................................................................%%....%
m %............................................................................................%
m %%%........................................................................................%%%
m %%....%................................................................................%....%%
m %%%........................................................................................%%%
m %............................................................................................%
m %......................b..............................................b......................%
m %.......%............................................................................%.......%
m %............................................................................................%
m %..%......................................................................................%..%
m %............................................................................................%
m %........%..........................................................................%........%
m %.........%..........%..................................................%..........%.........%
m %%%......%%%%%.%.....%%.......b................................b.......%%.....%.%%%%%......%%%
m %%%......%%%%%......%%%%..............................................%%%%......%%%%%......%%%
m %........%%%%%.......%%%%............................................%%%%.......%%%%%........%
m %........%%%%%%.......%................................................%.......%%%%%%........%
m %..%%%..%%%%%%%%..............................................................%%%%%%%%..%%%..%
m %%%%%%%%%%%%%%%%..............................................................%%%%%%%%%%%%%%%%
m %%%%%%%%%%%%%%%%..............................................................%%%%%%%%%%%%%%%%
m %%%%%%%%%%%%%%%%%............................................................%%%%%%%%%%%%%%%%%
m %%%%%%%%%%%%%%%%%%%%...%..............................................%...%%%%%%%%%%%%%%%%%%%%
m %%%%%%%%%%%%%%%%%%%%%....................................................%%%%%%%%%%%%%%%%%%%%%
m %%%%%%%%%%%%%%%%%%%%%%%%..............................................%%%%%%%%%%%%%%%%%%%%%%%%
m %%%%%%%%%%%%%%%%%%%%%%%%..............................................%%%%%%%%%%%%%%%%%%%%%%%%
m %%%%%%%%%%%%%%%%%%%%%%%%..............................................%%%%%%%%%%%%%%%%%%%%%%%%
m %%%%%%%%%%%%%%%%%%%%%%%%%............................................%%%%%%%%%%%%%%%%%%%%%%%%%
m %%%%%%%%%%%%%%%%%%%%%%%%.%..........................................%.%%%%%%%%%%%%%%%%%%%%%%%%
m %%%%%%%%%%%%%%%%%%%%.........%..................................%.........%%%%%%%%%%%%%%%%%%%%
m %%%%%%%%%%%%%%%%%%%........................................................%%%%%%%%%%%%%%%%%%%
m %%%%%%%%%%%%%%%%%%%..............%..%....................%..%..............%%%%%%%%%%%%%%%%%%%
m %%%%%%%%%%%%%%%%%%%%................%....................%................%%%%%%%%%%%%%%%%%%%%
m %%%%%%%%%%%%%%%%%%%%......................................................%%%%%%%%%%%%%%%%%%%%
m %%%%%%%%%%%%%%%%%%%%.......%......................................%.......%%%%%%%%%%%%%%%%%%%%
m %%%%%%%%%%%%%%%%%%%...%%........%.%..%..................%..%.%........%%...%%%%%%%%%%%%%%%%%%%
m %%%%%%%%%%%%%%%%%%%...%%........%%%........................%%%........%%...%%%%%%%%%%%%%%%%%%%
m %%%%%%%%%%%%%%%%%%%%%%%%%%%%%%%%%%%%%%%%%%%%%%%%%%%%%%%%%%%%%%%%%%%%%%%%%%%%%%%%%%%%%%%%%%%%%%

