players 4
rows 90
cols 90
m %%%%%%%%%%%%%%%%%%%%%%%%%%%%%%%%%%%%%%%%%%%%%%%%%%%%%%%%%%%%%%%%%%%%%%%%%%%%%%%%%%%%%%%%%%
m %%%%%%%%%%%%%%%%..........................%%%%%%..........................%%%%%%%%%%%%%%%%
m %%%%%%%%%%%%%%%...........................%%%%%%...........................%%%%%%%%%%%%%%%
m %%%%%%%%%%%%%%%...........................%%%%%%...........................%%%%%%%%%%%%%%%
m %%%%%%%%%%%%%%%%..........................%%%%%%..........................%%%%%%%%%%%%%%%%
m %%%%%%%%%%%%%%%%%%%........................%%%%........................%%%%%%%%%%%%%%%%%%%
m %%%%%%%%%%%%%%%%%%%%.......................%..%.......................%%%%%%%%%%%%%%%%%%%%
m %%%%%%%%%%%%%%%%%%%%..................................................%%%%%%%%%%%%%%%%%%%%
m %%%%%%%%%%%%%%%%%%%%%%..................%........%..................%%%%%%%%%%%%%%%%%%%%%%
m %%%%%%%%%%%%%%%%%%%%%.............%........%..%........%.............%%%%%%%%%%%%%%%%%%%%%
m %%%%%%%%%%%%%%%%%%%%....%...%%%%%%%%%%.....%%%%.....%%%%%%%%%%...%....%%%%%%%%%%%%%%%%%%%%
m %%%%%%%%%%%%%%%%%%%%%......%%%%%%%%%%..%.%%%%%%%%.%..%%%%%%%%%%......%%%%%%%%%%%%%%%%%%%%%
m %%%%%%%%%%%%%%%%%%%%%.%%.....%%%%%%%%%%%.%%%%%%%%.%%%%%%%%%%%.....%%.%%%%%%%%%%%%%%%%%%%%%
m %%%%%%%%%%%%%%%%%%%%%.%%....%%.%%%%%%%%%%%%%%%%%%%%%%%%%%%%.%%....%%.%%%%%%%%%%%%%%%%%%%%%
m %%%%%%%%%%%%%%%%%%%%..%%.......%%%%%%%%%%%%%%%%%%%%%%%%%%%%.......%%..%%%%%%%%%%%%%%%%%%%%
m %%..%%%%%%%%%%%%%.......%%...%.%%%%%%%%%%%%%%%%%%%%%%%%%%%%.%...%%.......%%%%%%%%%%%%%..%%
m %....%%%%%%%%%%%%%...%.........%%%%%%%%%%%%%%%%%%%%%%%%%%%%.........%...%%%%%%%%%%%%%....%
m %....%%%%%%%%%%.%%..%%........%%%%%%%%%%%%%%%%%%%%%%%%%%%%%%........%%..%%.%%%%%%%%%%....%
m %....%%%%%%%%%%......%%........%%a%%%%%%%%%%%%%%%%%%%%%%a%%........%%......%%%%%%%%%%....%
m %.....%%%%%%%%%......%%....%......%%%%%............%%%%%......%....%%......%%%%%%%%%.....%
m %.......%%.%%%...%...%%...%.......%%%%%....%..%....%%%%%.......%...%%...%...%%%.%%.......%
m %.......%.......%%%%%.%%%...%....%%%%%..............%%%%%....%...%%%.%%%%%.......%.......%
m %...........%%%...%%%%%%%.......%%%....................%%%.......%%%%%%%...%%%...........%
m %...........%%%......%%%%%%%%...%%.........%..%.........%%...%%%%%%%%......%%%...........%
m %.........%....%.....%%%%%%%%%........%............%........%%%%%%%%%.....%....%.........%
m %..............%.......%%%%%.%...........%......%...........%.%%%%%.......%..............%
m %...................%..%%%%.............%%.%%%%.%%.............%%%%..%...................%
m %..........%.......%...%%%...........%%%%%%%%%%%%%%%%...........%%%...%.......%..........%
m %.........%%.%.......%.%%............%%%%%%%%%%%%%%%%............%%.%.......%.%%.........%
m %.........%%%%.%........%%..........%%%%%%%%%%%%%%%%%%..........%%........%.%%%%.........%
m %.........%%%....%..................%%%%%%..%%..%%%%%%..................%....%%%.........%
m %.........%%%%%%%%%................%%%%%%%..%%..%%%%%%%................%%%%%%%%%.........%
m %.........%%%%%%%%%...%%..............%%....%%....%%..............%%...%%%%%%%%%.........%
m %.........%%%%%%%%b..%%%...........%..%%%........%%%..%...........%%%..c%%%%%%%%.........%
m %........%%%%%%%%%%%%%%............%..................%............%%%%%%%%%%%%%%........%
m %.........%%%%%%%%%%%%.........%.%%%..................%%%.%.........%%%%%%%%%%%%.........%
m %.........%%%%%%%%%%%%.......%%%........%........%........%%%.......%%%%%%%%%%%%.........%
m %.........%.%%%%%%%%%%.....%%%%%.......%%.%....%.%%.......%%%%%.....%%%%%%%%%%.%.........%
m %...........%%%%%%%%%...%..%%%%%%%.....%%........%%.....%%%%%%%..%...%%%%%%%%%...........%
m %..........%%%%%%%%........%%%%%%%...%%%%%%....%%%%%%...%%%%%%%........%%%%%%%%..........%
m %.......%....%%%%%%.......%%%%%%.%..%%%%%%%%%%%%%%%%%%..%.%%%%%%.......%%%%%%....%.......%
m %..........%%%%%%%%......%%%%%%%.......%%%%%%%%%%%%.......%%%%%%%......%%%%%%%%..........%
m %%%%%......%%%%%%%%........%%%.......%.%%%%%%%%%%%%.%.......%%%........%%%%%%%%......%%%%%
m %%%%%%%..%%%%%%%%%%.%..%..%%%%..........%%%%%%%%%%..........%%%%..%..%.%%%%%%%%%%..%%%%%%%
m %%%%%%....%%%%%%%%%.......%%%%%%%.......%%%%%%%%%%.......%%%%%%%.......%%%%%%%%%....%%%%%%
m %%%%%%....%%%%%%%%%.......%%%%%%%.......%%%%%%%%%%.......%%%%%%%.......%%%%%%%%%....%%%%%%
m %%%%%%%..%%%%%%%%%%.%..%..%%%%..........%%%%%%%%%%..........%%%%..%..%.%%%%%%%%%%..%%%%%%%
m %%%%%......%%%%%%%%........%%%.......%.%%%%%%%%%%%%.%.......%%%........%%%%%%%%......%%%%%
m %..........%%%%%%%%......%%%%%%%.......%%%%%%%%%%%%.......%%%%%%%......%%%%%%%%..........%
m %.......%....%%%%%%.......%%%%%%.%..%%%%%%%%%%%%%%%%%%..%.%%%%%%.......%%%%%%....%.......%
m %..........%%%%%%%%........%%%%%%%...%%%%%%....%%%%%%...%%%%%%%........%%%%%%%%..........%
m %...........%%%%%%%%%...%..%%%%%%%.....%%........%%.....%%%%%%%..%...%%%%%%%%%...........%
m %.........%.%%%%%%%%%%.....%%%%%.......%%.%....%.%%.......%%%%%.....%%%%%%%%%%.%.........%
m %.........%%%%%%%%%%%%.......%%%........%........%........%%%.......%%%%%%%%%%%%.........%
m %.........%%%%%%%%%%%%.........%.%%%..................%%%.%.........%%%%%%%%%%%%.........%
m %........%%%%%%%%%%%%%%............%..................%............%%%%%%%%%%%%%%........%
m %.........%%%%%%%%b..%%%...........%..%%%........%%%..%...........%%%..c%%%%%%%%.........%
m %.........%%%%%%%%%...%%..............%%....%%....%%..............%%...%%%%%%%%%.........%
m %.........%%%%%%%%%................%%%%%%%..%%..%%%%%%%................%%%%%%%%%.........%
m %.........%%%....%..................%%%%%%..%%..%%%%%%..................%....%%%.........%
m %.........%%%%.%........%%..........%%%%%%%%%%%%%%%%%%..........%%........%.%%%%.........%
m %.........%%.%.......%.%%............%%%%%%%%%%%%%%%%............%%.%.......%.%%.........%
m %..........%.......%...%%%...........%%%%%%%%%%%%%%%%...........%%%...%.......%..........%
m %...................%..%%%%.............%%.%%%%.%%.............%%%%..%...................%
m %..............%.......%%%%%.%...........%......%...........%.%%%%%.......%..............%
m %.........%....%.....%%%%%%%%%........%............%........%%%%%%%%%.....%....%.........%
m %...........%%%......%%%%%%%%...%%.........%..%.........%%...%%%%%%%%......%%%...........%
m %...........%%%...%%%%%%%.......%%%....................%%%.......%%%%%%%...%%%...........%
m %.......%.......%%%%%.%%%...%....%%%%%..............%%%%%....%...%%%.%%%%%.......%.......%
m %.......%%.%%%...%...%%...%.......%%%%%....%..%....%%%%%.......%...%%...%...%%%.%%.......%
m %.....%%%%%%%%%......%%....%......%%%%%............%%%%%......%....%%......%%%%%%%%%.....%
m %....%%%%%%%%%%......%%........%%d%%%%%%%%%%%%%%%%%%%%%%d%%........%%......%%%%%%%%%%....%
m %....%%%%%%%%%%.%%..%%........%%%%%%%%%%%%%%%%%%%%%%%%%%%%%%........%%..%%.%%%%%%%%%%....%
m %....%%%%%%%%%%%%%...%.........%%%%%%%%%%%%%%%%%%%%%%%%%%%%.........%...%%%%%%%%%%%%%....%
m %%..%%%%%%%%%%%%%.......%%...%.%%%%%%%%%%%%%%%%%%%%%%%%%%%%.%...%%.......%%%%%%%%%%%%%..%%
m %%%%%%%%%%%%%%%%%%%%..%%.......%%%%%%%%%%%%%%%%%%%%%%%%%%%%.......%%..%%%%%%%%%%%%%%%%%%%%
m %%%%%%%%%%%%%%%%%%%%%.%%....%%.%%%%%%%%%%%%%%%%%%%%%%%%%%%%.%%....%%.%%%%%%%%%%%%%%%%%%%%%
m %%%%%%%%%%%%%%%%%%%%%.%%.....%%%%%%%%%%%.%%%%%%%%.%%%%%%%%%%%.....%%.%%%%%%%%%%%%%%%%%%%%%
m %%%%%%%%%%%%%%%%%%%%%......%%%%%%%%%%..%.%%%%%%%%.%..%%%%%%%%%%......%%%%%%%%%%%%%%%%%%%%%
m %%%%%%%%%%%%%%%%%%%%....%...%%%%%%%%%%.....%%%%.....%%%%%%%%%%...%....%%%%%%%%%%%%%%%%%%%%
m %%%%%%%%%%%%%%%%%%%%%.............%........%..%........%.............%%%%%%%%%%%%%%%%%%%%%
m %%%%%%%%%%%%%%%%%%%%%%..................%........%..................%%%%%%%%%%%%%%%%%%%%%%
m %%%%%%%%%%%%%%%%%%%%..................................................%%%%%%%%%%%%%%%%%%%%
m %%%%%%%%%%%%%%%%%%%%.......................%..%.......................%%%%%%%%%%%%%%%%%%%%
m %%%%%%%%%%%%%%%%%%%........................%%%%........................%%%%%%%%%%%%%%%%%%%
m %%%%%%%%%%%%%%%%..........................%%%%%%..........................%%%%%%%%%%%%%%%%
m %%%%%%%%%%%%%%%...........................%%%%%%...........................%%%%%%%%%%%%%%%
m %%%%%%%%%%%%%%%...........................%%%%%%...........................%%%%%%%%%%%%%%%
m %%%%%%%%%%%%%%%%..........................%%%%%%..........................%%%%%%%%%%%%%%%%
m %%%%%%%%%%%%%%%%%%%%%%%%%%%%%%%%%%%%%%%%%%%%%%%%%%%%%%%%%%%%%%%%%%%%%%%%%%%%%%%%%%%%%%%%%%

