players 8
rows 116
cols 116
m %%%%%%%%%%%%%%%%%%%%%%%%%%%%%%%%%%%%%%%%%%%%%%%%%%%%%%%%%%%%%%%%%%%%%%%%%%%%%%%%%%%%%%%%%%%%%%%%%%%%%%%%%%%%%%%%%%%%
m %%%%%%%.%%%.......%%%...%%%%%%%%.....%%%%%%%%%%.%%................%%.%%%%%%%%%%.....%%%%%%%%...%%%.......%%%.%%%%%%%
m %%%%%....................%%%%%%%....%%%%%%%%%%%......................%%%%%%%%%%%....%%%%%%%....................%%%%%
m %%%%%.....................%%%%%%%.%...%%%%....%%....................%%....%%%%...%.%%%%%%%.....................%%%%%
m %%%%%...%%................%%%%%%%.%...%%%%....%......................%....%%%%...%.%%%%%%%................%%...%%%%%
m %%.......%....%.......%..%%%%%%%%.%%....%%................................%%....%%.%%%%%%%%..%.......%....%.......%%
m %%.............%...........%%%%%%..................................................%%%%%%...........%.............%%
m %........%%%...............%%%%%%%.a............................................a.%%%%%%%...............%%%........%
m %%..%....%%%..........%%...%%%%%%%................................................%%%%%%%...%%..........%%%....%..%%
m %%..%%.%%%%...........%%%...%%%%%%..%.........%%%..................%%%.........%..%%%%%%...%%%...........%%%%.%%..%%
m %%.....%%%%...........%%%...%%%%%%..%..........%%..................%%..........%..%%%%%%...%%%...........%%%%.....%%
m %......%%.......................%%%.%.%....%..%%%..................%%%..%....%.%.%%%.......................%%......%
m %.................................%..%%.......%%%..................%%%.......%%..%.................................%
m %..............%..........................%%..%%%%%..............%%%%%..%%..........................%..............%
m %....%........................%%%%.......%%%...%%%%..............%%%%...%%%.......%%%%........................%....%
m %.....%......%.......%........%%%%%.%%%%.%%%...%....................%...%%%.%%%%.%%%%%........%.......%......%.....%
m %......................%.......%%%..%%%...%..............................%...%%%..%%%.......%......................%
m %...................%%.%......%%%..%%%%......................................%%%%..%%%......%.%%...................%
m %%...........................%%%..%%%%%.%..................................%.%%%%%..%%%...........................%%
m %%....................%%...%..%%.....%............%..............%............%.....%%..%...%%....................%%
m %%...............%.....%...%%..%....%%.%%..................................%%.%%....%..%%...%.....%...............%%
m %..............%.%....%%..%%%%.....%%%%%%%%..............................%%%%%%%%.....%%%%..%%....%.%..............%
m %....%..%%%........%.%%..%%%%%%...%%%%%%%%%%..%......................%..%%%%%%%%%%...%%%%%%..%%.%........%%%..%....%
m %.......%%%.....%%.%%%...%...%%%..%%%%%%%%%%............%%%%............%%%%%%%%%%..%%%...%...%%%.%%.....%%%.......%
m %%.......%%...................%%..%%%%%%%%%%.............%%.............%%%%%%%%%%..%%...................%%.......%%
m %%%..%................%%......%%%%%%%%%%%%%%%.....%%%..........%%%.....%%%%%%%%%%%%%%%......%%................%..%%%
m %%%%%%...............%%.....%%%%%%%%%%%%%%%%%.....%%%%%......%%%%%.....%%%%%%%%%%%%%%%%%.....%%...............%%%%%%
m %%%%%%%%%..........%%%%.....%%%%%%%%%%%%%%%%%%....%%%..........%%%....%%%%%%%%%%%%%%%%%%.....%%%%..........%%%%%%%%%
m %%%%%%%%%%%.........%%%...%%%%%%%%%%%%%%%%%%%%..%..................%..%%%%%%%%%%%%%%%%%%%%...%%%.........%%%%%%%%%%%
m %%%%%%%%%%%.......%..%%%..%%%%%%%%%%%%%%%%%%%%...%%%.....%%.....%%%...%%%%%%%%%%%%%%%%%%%%..%%%..%.......%%%%%%%%%%%
m %%%%%%%%%%%...%%.%%%..%%%%%%%%%%%%%%%%%%%%%%%....%%%.%%%%%%%%%%.%%%....%%%%%%%%%%%%%%%%%%%%%%%..%%%.%%...%%%%%%%%%%%
m %%%%%%%%%%%...%%%%%%%..%%%%%%%%%%%%%%%%%%%%%%...%%%%...%%%%%%...%%%%...%%%%%%%%%%%%%%%%%%%%%%..%%%%%%%...%%%%%%%%%%%
m %..%%%%%%%%%..%%%%.......%%%%%%%%%%%%%%%%%%%....%%%%..%%%%%%%%..%%%%....%%%%%%%%%%%%%%%%%%%.......%%%%..%%%%%%%%%..%
m %......%%%%%..%%%........%%%%%%%%%%%%%%%%%%%....%%....%%%%%%%%....%%....%%%%%%%%%%%%%%%%%%%........%%%..%%%%%......%
m %..%%%.....%%..%..%...%%%%%%%%%%%%%%%%%%%%%%%....%....%%%%%%%%....%....%%%%%%%%%%%%%%%%%%%%%%%...%..%..%%.....%%%..%
m %....%.b.........%%..%%%%%%%%%%%%%%%%%%%%%%%%.........%%%%%%%%.........%%%%%%%%%%%%%%%%%%%%%%%%..%%.........c.%....%
m %.%......%%%...%%%%.%%%%%%%%%%%%%%%%%%%%%%%...........%%%%%%%%...........%%%%%%%%%%%%%%%%%%%%%%%.%%%%...%%%......%.%
m %%%.........%..%%%%%%%%%%%%%%%%%%%%%%%%%%..............%%%%%%..............%%%%%%%%%%%%%%%%%%%%%%%%%%..%.........%%%
m %%%%%......%%..%%%%..%%%%%%%%%%%%%%%%%%......................................%%%%%%%%%%%%%%%%%%..%%%%..%%......%%%%%
m %%%%%..........%....%%%%%%%%%%%%%%%%%%.....%............................%.....%%%%%%%%%%%%%%%%%%....%..........%%%%%
m %%%%%%............%.%%%%%%%%%%%%%%%%%%........................................%%%%%%%%%%%%%%%%%%.%............%%%%%%
m %%%%%%........%%.....%%%%%%%%%%%%%%%%..................%%%%%%..................%%%%%%%%%%%%%%%%.....%%........%%%%%%
m %%%..........%%%%....%%%%%%%%%%%%%%%%............%.....%%%%%%.....%............%%%%%%%%%%%%%%%%....%%%%..........%%%
m %%%........%.%%%......%%%%%%%%%%%%%%...%........%......%%%%%%......%........%...%%%%%%%%%%%%%%......%%%.%........%%%
m %%%......................%%%%%%%..%%...................%%%%%%...................%%..%%%%%%%......................%%%
m %%%........................%%%.....................%%%%%%%%%%%%%%.....................%%%........................%%%
m %%%%%....%.%%%........%........................%%%%%%%%%%%%%%%%%%%%%%........................%........%%%.%....%%%%%
m %..%.....%%%%%%%..............................%%%%%%%%%%%%%%%%%%%%%%%%..............................%%%%%%%.....%..%
m %%.......%%%%%%.............%..%%%.........%..%%%%%%%%%%%%%%%%%%%%%%%%..%.........%%%..%.............%%%%%%.......%%
m %%...........%%..............%%%%%%.......%...%%%%%%%%%%%%%%%%%%%%%%%%...%.......%%%%%%..............%%...........%%
m %............%%....%.....%%%.%%%%.............%%%%%%%%%%%%%%%%%%%%%%%%.............%%%%.%%%.....%....%%............%
m %........................%%%.%%%%............%%%%%%%%%%%%%%%%%%%%%%%%%%............%%%%.%%%........................%
m %........................%%%.................%%%%%%%%%%%%%%%%%%%%%%%%%%.................%%%........................%
m %.........................%...%..............%%%%%%%%%%%%%%%%%%%%%%%%%%..............%...%.........................%
m %.........................%...%.%%%%%........%%%%%%%%%%%%%%%%%%%%%%%%%%........%%%%%.%...%.........................%
m %.............................%%%%%%%%...%%%%%%%%%%%%%%%%%%%%%%%%%%%%%%%%%%...%%%%%%%%.............................%
m %......................%......%%%%%%%%...%%%%%%%%%%%%%%%%%%%%%%%%%%%%%%%%%%...%%%%%%%%......%......................%
m %......................%%....%%%%%%%%%...%%%%%%%%%%%%%%%%%%%%%%%%%%%%%%%%%%...%%%%%%%%%....%%......................%
m %......................%%....%%%%%%%%%...%%%%%%%%%%%%%%%%%%%%%%%%%%%%%%%%%%...%%%%%%%%%....%%......................%
m %......................%......%%%%%%%%...%%%%%%%%%%%%%%%%%%%%%%%%%%%%%%%%%%...%%%%%%%%......%......................%
m %.............................%%%%%%%%...%%%%%%%%%%%%%%%%%%%%%%%%%%%%%%%%%%...%%%%%%%%.............................%
m %.........................%...%.%%%%%........%%%%%%%%%%%%%%%%%%%%%%%%%%........%%%%%.%...%.........................%
m %.........................%...%..............%%%%%%%%%%%%%%%%%%%%%%%%%%..............%...%.........................%
m %........................%%%.................%%%%%%%%%%%%%%%%%%%%%%%%%%.................%%%........................%
m %........................%%%.%%%%............%%%%%%%%%%%%%%%%%%%%%%%%%%............%%%%.%%%........................%
m %............%%....%.....%%%.%%%%.............%%%%%%%%%%%%%%%%%%%%%%%%.............%%%%.%%%.....%....%%............%
m %%...........%%..............%%%%%%.......%...%%%%%%%%%%%%%%%%%%%%%%%%...%.......%%%%%%..............%%...........%%
m %%.......%%%%%%.............%..%%%.........%..%%%%%%%%%%%%%%%%%%%%%%%%..%.........%%%..%.............%%%%%%.......%%
m %..%.....%%%%%%%..............................%%%%%%%%%%%%%%%%%%%%%%%%..............................%%%%%%%.....%..%
m %%%%%....%.%%%........%........................%%%%%%%%%%%%%%%%%%%%%%........................%........%%%.%....%%%%%
m %%%........................%%%.....................%%%%%%%%%%%%%%.....................%%%........................%%%
m %%%......................%%%%%%%..%%...................%%%%%%...................%%..%%%%%%%......................%%%
m %%%........%.%%%......%%%%%%%%%%%%%%...%........%......%%%%%%......%........%...%%%%%%%%%%%%%%......%%%.%........%%%
m %%%..........%%%%....%%%%%%%%%%%%%%%%............%.....%%%%%%.....%............%%%%%%%%%%%%%%%%....%%%%..........%%%
m %%%%%%........%%.....%%%%%%%%%%%%%%%%..................%%%%%%..................%%%%%%%%%%%%%%%%.....%%........%%%%%%
m %%%%%%............%.%%%%%%%%%%%%%%%%%%........................................%%%%%%%%%%%%%%%%%%.%............%%%%%%
m %%%%%..........%....%%%%%%%%%%%%%%%%%%.....%............................%.....%%%%%%%%%%%%%%%%%%....%..........%%%%%
m %%%%%......%%..%%%%..%%%%%%%%%%%%%%%%%%......................................%%%%%%%%%%%%%%%%%%..%%%%..%%......%%%%%
m %%%.........%..%%%%%%%%%%%%%%%%%%%%%%%%%%..............%%%%%%..............%%%%%%%%%%%%%%%%%%%%%%%%%%..%.........%%%
m %.%......%%%...%%%%.%%%%%%%%%%%%%%%%%%%%%%%...........%%%%%%%%...........%%%%%%%%%%%%%%%%%%%%%%%.%%%%...%%%......%.%
m %....%.b.........%%..%%%%%%%%%%%%%%%%%%%%%%%%.........%%%%%%%%.........%%%%%%%%%%%%%%%%%%%%%%%%..%%.........c.%....%
m %..%%%.....%%..%..%...%%%%%%%%%%%%%%%%%%%%%%%....%....%%%%%%%%....%....%%%%%%%%%%%%%%%%%%%%%%%...%..%..%%.....%%%..%
m %......%%%%%..%%%........%%%%%%%%%%%%%%%%%%%....%%....%%%%%%%%....%%....%%%%%%%%%%%%%%%%%%%........%%%..%%%%%......%
m %..%%%%%%%%%..%%%%.......%%%%%%%%%%%%%%%%%%%....%%%%..%%%%%%%%..%%%%....%%%%%%%%%%%%%%%%%%%.......%%%%..%%%%%%%%%..%
m %%%%%%%%%%%...%%%%%%%..%%%%%%%%%%%%%%%%%%%%%%...%%%%...%%%%%%...%%%%...%%%%%%%%%%%%%%%%%%%%%%..%%%%%%%...%%%%%%%%%%%
m %%%%%%%%%%%...%%.%%%..%%%%%%%%%%%%%%%%%%%%%%%....%%%.%%%%%%%%%%.%%%....%%%%%%%%%%%%%%%%%%%%%%%..%%%.%%...%%%%%%%%%%%
m %%%%%%%%%%%.......%..%%%..%%%%%%%%%%%%%%%%%%%%...%%%.....%%.....%%%...%%%%%%%%%%%%%%%%%%%%..%%%..%.......%%%%%%%%%%%
m %%%%%%%%%%%.........%%%...%%%%%%%%%%%%%%%%%%%%..%..................%..%%%%%%%%%%%%%%%%%%%%...%%%.........%%%%%%%%%%%
m %%%%%%%%%..........%%%%.....%%%%%%%%%%%%%%%%%%....%%%..........%%%....%%%%%%%%%%%%%%%%%%.....%%%%..........%%%%%%%%%
m %%%%%%...............%%.....%%%%%%%%%%%%%%%%%.....%%%%%......%%%%%.....%%%%%%%%%%%%%%%%%.....%%...............%%%%%%
m %%%..%................%%......%%%%%%%%%%%%%%%.....%%%..........%%%.....%%%%%%%%%%%%%%%......%%................%..%%%
m %%.......%%...................%%..%%%%%%%%%%.............%%.............%%%%%%%%%%..%%...................%%.......%%
m %.......%%%.....%%.%%%...%...%%%..%%%%%%%%%%............%%%%............%%%%%%%%%%..%%%...%...%%%.%%.....%%%.......%
m %....%..%%%........%.%%..%%%%%%...%%%%%%%%%%..%......................%..%%%%%%%%%%...%%%%%%..%%.%........%%%..%....%
m %..............%.%....%%..%%%%.....%%%%%%%%..............................%%%%%%%%.....%%%%..%%....%.%..............%
m %%...............%.....%...%%..%....%%.%%..................................%%.%%....%..%%...%.....%...............%%
m %%....................%%...%..%%.....%............%..............%............%.....%%..%...%%....................%%
m %%...........................%%%..%%%%%.%..................................%.%%%%%..%%%...........................%%
m %...................%%.%......%%%..%%%%......................................%%%%..%%%......%.%%...................%
m %......................%.......%%%..%%%...%..............................%...%%%..%%%.......%......................%
m %.....%......%.......%........%%%%%.%%%%.%%%...%....................%...%%%.%%%%.%%%%%........%.......%......%.....%
m %....%........................%%%%.......%%%...%%%%..............%%%%...%%%.......%%%%........................%....%
m %..............%..........................%%..%%%%%..............%%%%%..%%..........................%..............%
m %.................................%..%%.......%%%..................%%%.......%%..%.................................%
m %......%%.......................%%%.%.%....%..%%%..................%%%..%....%.%.%%%.......................%%......%
m %%.....%%%%...........%%%...%%%%%%..%..........%%..................%%..........%..%%%%%%...%%%...........%%%%.....%%
m %%..%%.%%%%...........%%%...%%%%%%..%.........%%%..................%%%.........%..%%%%%%...%%%...........%%%%.%%..%%
m %%..%....%%%..........%%...%%%%%%%................................................%%%%%%%...%%..........%%%....%..%%
m %........%%%...............%%%%%%%.d............................................d.%%%%%%%...............%%%........%
m %%.............%...........%%%%%%..................................................%%%%%%...........%.............%%
m %%.......%....%.......%..%%%%%%%%.%%....%%................................%%....%%.%%%%%%%%..%.......%....%.......%%
m %%%%%...%%................%%%%%%%.%...%%%%....%......................%....%%%%...%.%%%%%%%................%%...%%%%%
m %%%%%.....................%%%%%%%.%...%%%%....%%....................%%....%%%%...%.%%%%%%%.....................%%%%%
m %%%%%....................%%%%%%%....%%%%%%%%%%%......................%%%%%%%%%%%....%%%%%%%....................%%%%%
m %%%%%%%.%%%.......%%%...%%%%%%%%.....%%%%%%%%%%.%%................%%.%%%%%%%%%%.....%%%%%%%%...%%%.......%%%.%%%%%%%
m %%%%%%%%%%%%%%%%%%%%%%%%%%%%%%%%%%%%%%%%%%%%%%%%%%%%%%%%%%%%%%%%%%%%%%%%%%%%%%%%%%%%%%%%%%%%%%%%%%%%%%%%%%%%%%%%%%%%

