players 8
rows 92
cols 92
m %%%%%%%%%%%%%%%%%%%%%%%%%%%%%%%%%%%%%%%%%%%%%%%%%%%%%%%%%%%%%%%%%%%%%%%%%%%%%%%%%%%%%%%%%%%%
m %......................%.....%%%%%%%%%%%%%%%%%%%%%%%%%%%%%%%%%%.....%......................%
m %............................%%%%%%%%%%%%%%%%%%%%%%%%%%%%%%%%%%............................%
m %..........................%%%%%%%%%%%%%%%%%%%%%%%%%%%%%%%%%%%%%%..........................%
m %...........................%%%%%%%%%%%%%%%%%%%%%%%%%%%%%%%%%%%%...........................%
m %.............................%..%%%%%%%%%%%%%%%%%%%%%%%%%%..%.............................%
m %.............................%..%%%%%%%%%%%%%%%%%%%%%%%%%%..%.............................%
m %................................%%%%%%%%%%%%%%%%%%%%%%%%%%................................%
m %..................................%%%%%%%%%%%%%%%%%%%%%%..................................%
m %.........................%......%....%%%%%%%%%%%%%%%%....%......%.........................%
m %.........................%%.......%.%%%%%%%%%%%%%%%%%%.%.......%%.........................%
m %......................%...%%%.%.%...%%%%%%%%%%%%%%%%%%...%.%.%%%...%......................%
m %.....................%......%%%%...%%%%%%%%%%%%%%%%%%%%...%%%%......%.....................%
m %.....................%%......%%%..%%%%%%%%%%%%%%%%%%%%%%..%%%......%%.....................%
m %.............................%%%...%%%%%%%%%%%%%%%%%%%%...%%%.............................%
m %........................%....%%%%%%%%%.%%%%%%%%%%%%.%%%%%%%%%....%........................%
m %............................%%%%%..%...%%%%%%%%%%%%...%..%%%%%............................%
m %.............................%%%........%%%%%%%%%%........%%%.............................%
m %..............................%.........%%%%%%%%%%.........%..............................%
m %..............................%.......%%%%%%%%%%%%%%.......%..............................%
m %..............................%%......%%%%%%%%%%%%%%......%%..............................%
m %.............................%%%a.....%%%%%%%%%%%%%%.....b%%%.............................%
m %...........%%..................%.....%%%%%%%%%%%%%%%%.....%..................%%...........%
m %%.........%.%..........%.............%.%%%%%%%%%%%%.%.............%..........%.%.........%%
m %......................%.................%%%%%%%%%%.................%......................%
m %..............%..........................%%%%%%%%..........................%..............%
m %........%%...............................%%%%%%%%...............................%%........%
m %..%......%%..........................%%..%%%%%%%%..%%..........................%%......%..%
m %..%%......%.................%...........%%%%%%%%%%...........%.................%......%%..%
m %%%%%......%%...%...........%%...%%%%.%%%%%%%%%%%%%%%%.%%%%...%%...........%...%%......%%%%%
m %%%%%%%.....%%%%%%...%..........%%%%...%%%%%%%%%%%%%%...%%%%..........%...%%%%%%.....%%%%%%%
m %%%%%......%%%%%%%%%%%..........%%%%%%.%%%%%.%%.%%%%%.%%%%%%..........%%%%%%%%%%%......%%%%%
m %%%%%.......%%%%%%..%%%.......%%%%%%%..%%....%%....%%..%%%%%%%.......%%%..%%%%%%.......%%%%%
m %%%%%%%%.%.%...%%....b.......%%%%%%%%........%%........%%%%%%%%.......a....%%...%.%.%%%%%%%%
m %%%%%%%%.......%.............%%%%%...%................%...%%%%%.............%.......%%%%%%%%
m %%%%%%%%%.%..%.%.............%%%%%...%................%...%%%%%.............%.%..%.%%%%%%%%%
m %%%%%%%%%...%%%%%............%.%%%........................%%%.%............%%%%%...%%%%%%%%%
m %%%%%%%%%.%%%%%%...............%..%%....................%%..%...............%%%%%%.%%%%%%%%%
m %%%%%%%%%%%%%%%%......%%...%.%................................%.%...%%......%%%%%%%%%%%%%%%%
m %%%%%%%%%%%%%%%....%%%%....%.%%%%..........................%%%%.%....%%%%....%%%%%%%%%%%%%%%
m %%%%%%%%%%%%%%%%%..%%%%%.....%%%%..........................%%%%.....%%%%%..%%%%%%%%%%%%%%%%%
m %%%%%%%%%%%%%%%%%%%%%%%%%...%%%%............................%%%%...%%%%%%%%%%%%%%%%%%%%%%%%%
m %%%%%%%%%%%%%%%%%%%%%%%%%%%%%%%%............................%%%%%%%%%%%%%%%%%%%%%%%%%%%%%%%%
m %%%%%%%%%%%%%%%%%%%%%%%%%%%%%%%%............................%%%%%%%%%%%%%%%%%%%%%%%%%%%%%%%%
m %%%%%%%%%%%%%%%%%%%%%%%%%%%%%%%..............................%%%%%%%%%%%%%%%%%%%%%%%%%%%%%%%
m %%%%%%%%%%%%%%%%%%%%%%%%%%%%%%%%%%........................%%%%%%%%%%%%%%%%%%%%%%%%%%%%%%%%%%
m %%%%%%%%%%%%%%%%%%%%%%%%%%%%%%%%%%........................%%%%%%%%%%%%%%%%%%%%%%%%%%%%%%%%%%
m %%%%%%%%%%%%%%%%%%%%%%%%%%%%%%%..............................%%%%%%%%%%%%%%%%%%%%%%%%%%%%%%%
m %%%%%%%%%%%%%%%%%%%%%%%%%%%%%%%%............................%%%%%%%%%%%%%%%%%%%%%%%%%%%%%%%%
m %%%%%%%%%%%%%%%%%%%%%%%%%%%%%%%%............................%%%%%%%%%%%%%%%%%%%%%%%%%%%%%%%%
m %%%%%%%%%%%%%%%%%%%%%%%%%...%%%%............................%%%%...%%%%%%%%%%%%%%%%%%%%%%%%%
m %%%%%%%%%%%%%%%%%..%%%%%.....%%%%..........................%%%%.....%%%%%..%%%%%%%%%%%%%%%%%
m %%%%%%%%%%%%%%%....%%%%....%.%%%%..........................%%%%.%....%%%%....%%%%%%%%%%%%%%%
m %%%%%%%%%%%%%%%%......%%...%.%................................%.%...%%......%%%%%%%%%%%%%%%%
m %%%%%%%%%.%%%%%%...............%..%%....................%%..%...............%%%%%%.%%%%%%%%%
m %%%%%%%%%...%%%%%............%.%%%........................%%%.%............%%%%%...%%%%%%%%%
m %%%%%%%%%.%..%.%.............%%%%%...%................%...%%%%%.............%.%..%.%%%%%%%%%
m %%%%%%%%.......%.............%%%%%...%................%...%%%%%.............%.......%%%%%%%%
m %%%%%%%%.%.%...%%....a.......%%%%%%%%........%%........%%%%%%%%.......b....%%...%.%.%%%%%%%%
m %%%%%.......%%%%%%..%%%.......%%%%%%%..%%....%%....%%..%%%%%%%.......%%%..%%%%%%.......%%%%%
m %%%%%......%%%%%%%%%%%..........%%%%%%.%%%%%.%%.%%%%%.%%%%%%..........%%%%%%%%%%%......%%%%%
m %%%%%%%.....%%%%%%...%..........%%%%...%%%%%%%%%%%%%%...%%%%..........%...%%%%%%.....%%%%%%%
m %%%%%......%%...%...........%%...%%%%.%%%%%%%%%%%%%%%%.%%%%...%%...........%...%%......%%%%%
m %..%%......%.................%...........%%%%%%%%%%...........%.................%......%%..%
m %..%......%%..........................%%..%%%%%%%%..%%..........................%%......%..%
m %........%%...............................%%%%%%%%...............................%%........%
m %..............%..........................%%%%%%%%..........................%..............%
m %......................%.................%%%%%%%%%%.................%......................%
m %%.........%.%..........%.............%.%%%%%%%%%%%%.%.............%..........%.%.........%%
m %...........%%..................%.....%%%%%%%%%%%%%%%%.....%..................%%...........%
m %.............................%%%b.....%%%%%%%%%%%%%%.....a%%%.............................%
m %..............................%%......%%%%%%%%%%%%%%......%%..............................%
m %..............................%.......%%%%%%%%%%%%%%.......%..............................%
m %..............................%.........%%%%%%%%%%.........%..............................%
m %.............................%%%........%%%%%%%%%%........%%%.............................%
m %............................%%%%%..%...%%%%%%%%%%%%...%..%%%%%............................%
m %........................%....%%%%%%%%%.%%%%%%%%%%%%.%%%%%%%%%....%........................%
m %.............................%%%...%%%%%%%%%%%%%%%%%%%%...%%%.............................%
m %.....................%%......%%%..%%%%%%%%%%%%%%%%%%%%%%..%%%......%%.....................%
m %.....................%......%%%%...%%%%%%%%%%%%%%%%%%%%...%%%%......%.....................%
m %......................%...%%%.%.%...%%%%%%%%%%%%%%%%%%...%.%.%%%...%......................%
m %.........................%%.......%.%%%%%%%%%%%%%%%%%%.%.......%%.........................%
m %.........................%......%....%%%%%%%%%%%%%%%%....%......%.........................%
m %..................................%%%%%%%%%%%%%%%%%%%%%%..................................%
m %................................%%%%%%%%%%%%%%%%%%%%%%%%%%................................%
m %.............................%..%%%%%%%%%%%%%%%%%%%%%%%%%%..%.............................%
m %.............................%..%%%%%%%%%%%%%%%%%%%%%%%%%%..%.............................%
m %...........................%%%%%%%%%%%%%%%%%%%%%%%%%%%%%%%%%%%%...........................%
m %..........................%%%%%%%%%%%%%%%%%%%%%%%%%%%%%%%%%%%%%%..........................%
m %............................%%%%%%%%%%%%%%%%%%%%%%%%%%%%%%%%%%............................%
m %......................%.....%%%%%%%%%%%%%%%%%%%%%%%%%%%%%%%%%%.....%......................%
m %%%%%%%%%%%%%%%%%%%%%%%%%%%%%%%%%%%%%%%%%%%%%%%%%%%%%%%%%%%%%%%%%%%%%%%%%%%%%%%%%%%%%%%%%%%%

