players 2
rows 110
cols 110
m %%%%%%%%%%%%%%%%%%%%%%%%%%%%%%%%%%%%%%%%%%%%%%%%%%%%%%%%%%%%%%%%%%%%%%%%%%%%%%%%%%%%%%%%%%%%%%%%%%%%%%%%%%%%%%
m %%%%%%%%%%%%%%................%%....%%%%..............................%%%%....%%................%%%%%%%%%%%%%%
m %%%%%%%%%%%%%%%..................%..........................................%..................%%%%%%%%%%%%%%%
m %%%%%%%%%%%%%%%%..............................................................................%%%%%%%%%%%%%%%%
m %%%%%%%%%%%%%%%%...........%.....%..........................................%.....%...........%%%%%%%%%%%%%%%%
m %%%%%%%%%%%%%%%%..............................................................................%%%%%%%%%%%%%%%%
m %%%%%%%%%%%%%%%%%%%%............%%%........................................%%%............%%%%%%%%%%%%%%%%%%%%
m %%%%%%%%%%%%%%%%%.........%%.....%%...........a................b...........%%.....%%.........%%%%%%%%%%%%%%%%%
m %%%%%%%%%%%%%%%%%.........%%%....................................................%%%.........%%%%%%%%%%%%%%%%%
m %%%%%%%%%%%%%%%%%.%%.....%%%........%....................................%........%%%.....%%.%%%%%%%%%%%%%%%%%
m %%%%%%%%%%%%%%%%%%%......%%%.....%...%..................................%...%.....%%%......%%%%%%%%%%%%%%%%%%%
m %%%%%%%%%%%%%%%%%%%%%....%%%%....%%..%...%..........................%...%..%%....%%%%....%%%%%%%%%%%%%%%%%%%%%
m %%%%%%%%%%%%%%%%%%%%%%.........%%%%.%%%..............%%%%..............%%%.%%%%.........%%%%%%%%%%%%%%%%%%%%%%
m %%%%%%%%%%%%%%%%%%%%%%%%%.%...%%%%%.%%...............%%%%...............%%.%%%%%...%.%%%%%%%%%%%%%%%%%%%%%%%%%
m %.%%%%%%%%%%%%%%%%%%%%%%%%%.....%%%..................%%%%..................%%%.....%%%%%%%%%%%%%%%%%%%%%%%%%.%
m %..%%%%%%%%%%%%%%%%%%%%%%%%%%%...%%......%...........%%%%...........%......%%...%%%%%%%%%%%%%%%%%%%%%%%%%%%..%
m %.....%%%%%%%%%%%%%%%%%%%%%%%%%%%%%........................................%%%%%%%%%%%%%%%%%%%%%%%%%%%%%.....%
m %.....%...%%%%%%%%%%%%%%%%%%%%%%%%%%...........%%%..........%%%...........%%%%%%%%%%%%%%%%%%%%%%%%%%...%.....%
m %.....%..%%%%%%%%%%%%%%%%%%%%%%%%%%..%..........%%..........%%..........%..%%%%%%%%%%%%%%%%%%%%%%%%%%..%.....%
m %.....%..%.%%%%%%%%%%%%%%%%%%%%%%%........%%....%%..........%%....%%........%%%%%%%%%%%%%%%%%%%%%%%.%..%.....%
m %..........%%%%%%%%%%%%%%%%%%%%%%%.%%%%...%....%%%.%%....%%.%%%....%...%%%%.%%%%%%%%%%%%%%%%%%%%%%%..........%
m %...........%%%%%%%%%%%%%%%%%%%%%%.%%%%%%............................%%%%%%.%%%%%%%%%%%%%%%%%%%%%%...........%
m %............%%%%%%%%%%%%%%%%%%%%..%%%%%..............................%%%%%..%%%%%%%%%%%%%%%%%%%%............%
m %............%%%%%%%%%%%%%%%%%%%%.%%%%%%........%............%........%%%%%%.%%%%%%%%%%%%%%%%%%%%............%
m %............%%%%%%%%%%%%%%%%%%%%..%%%%%........%............%........%%%%%..%%%%%%%%%%%%%%%%%%%%............%
m %........%%%..%%%%%%%%%%%%%%%%%%....%%%%%%......%%..........%%......%%%%%%....%%%%%%%%%%%%%%%%%%..%%%........%
m %......%%%%%.%%%%%%%%%%%%%%%%%%%%%...%%............%%%..%%%............%%...%%%%%%%%%%%%%%%%%%%%%.%%%%%......%
m %...%..%%%%%...%%%%%%%%%%%%%%%%%%%%..%%.%.........%%%%%%%%%%.........%.%%..%%%%%%%%%%%%%%%%%%%%...%%%%%..%...%
m %.......%..%...%%%%%%%%%%%%%%%%%%%%.....%.......%%%%%%%%%%%%%%.......%.....%%%%%%%%%%%%%%%%%%%%...%..%.......%
m %..............%%%%%%%%%%%%%%%%%%%........%%..........%%..........%%........%%%%%%%%%%%%%%%%%%%..............%
m %%...........%..%%%%%%%%%%%%%%%%%%......%.%%%...%%....%%....%%...%%%.%......%%%%%%%%%%%%%%%%%%..%...........%%
m %%..........%%..%%%%%%%%%%%%%%%%%%%........................................%%%%%%%%%%%%%%%%%%%..%%..........%%
m %.....%.....%%%.%%%%%%%%%.%%%%%%%....%..................................%....%%%%%%%.%%%%%%%%%.%%%.....%.....%
m %.%.%.%%..%%%%%%%%%%%%....%%%%%%...%%%..................................%%%...%%%%%%....%%%%%%%%%%%%..%%.%.%.%
m %.....%%...%%%%%%%%....%...%%..%...%.....%..........................%.....%...%..%%...%....%%%%%%%%...%%.....%
m %................%..%%%%%........%%...%%%..%......................%..%%%...%%........%%%%%..%................%
m %%.......%..%%......%%%%%%.......%.....%%............................%%.....%.......%%%%%%......%%..%.......%%
m %%........%%%%....%.%%%%%%%%....%%.......%..%....................%..%.......%%....%%%%%%%%.%....%%%%........%%
m %%..........%.......%%%%%%%%.......%........%%..................%%........%.......%%%%%%%%.......%..........%%
m %%...................%%%%%.........%%....................................%%.........%%%%%...................%%
m %....................%...%.%%.%....%%....................................%%....%.%%.%...%....................%
m %..........%...%.........%........%..%.....%%....................%%.....%..%........%.........%...%..........%
m %..................%%........%%................................................%%........%%..................%
m %..................%.........%%....%.....%..........................%.....%....%%.........%..................%
m %.............................%......%%..%..........................%..%%......%.............................%
m %.....................................%..........%%%......%%%..........%.....................................%
m %......b..............................................................................................a......%
m %................%..%....................................................................%..%................%
m %................%%%%..%%%..%.%................................................%.%..%%%..%%%%................%
m %................%%%%....%..%.%..............%..................%..............%.%..%....%%%%................%
m %..........................%%................%..................%................%%..........................%
m %...................%.....%%%................%..................%................%%%.....%...................%
m %...................%.....%%%....................................................%%%.....%...................%
m %...........%%%%..........%%%....................................................%%%..........%%%%...........%
m %...........%%%%...........%%%%................................................%%%%...........%%%%...........%
m %...........%%%%...........%%%%................................................%%%%...........%%%%...........%
m %...........%%%%..........%%%....................................................%%%..........%%%%...........%
m %...................%.....%%%....................................................%%%.....%...................%
m %...................%.....%%%................%..................%................%%%.....%...................%
m %..........................%%................%..................%................%%..........................%
m %................%%%%....%..%.%..............%..................%..............%.%..%....%%%%................%
m %................%%%%..%%%..%.%................................................%.%..%%%..%%%%................%
m %................%..%....................................................................%..%................%
m %......a..............................................................................................b......%
m %.....................................%..........%%%......%%%..........%.....................................%
m %.............................%......%%..%..........................%..%%......%.............................%
m %..................%.........%%....%.....%..........................%.....%....%%.........%..................%
m %..................%%........%%................................................%%........%%..................%
m %..........%...%.........%........%..%.....%%....................%%.....%..%........%.........%...%..........%
m %....................%...%.%%.%....%%....................................%%....%.%%.%...%....................%
m %%...................%%%%%.........%%....................................%%.........%%%%%...................%%
m %%..........%.......%%%%%%%%.......%........%%..................%%........%.......%%%%%%%%.......%..........%%
m %%........%%%%....%.%%%%%%%%....%%.......%..%....................%..%.......%%....%%%%%%%%.%....%%%%........%%
m %%.......%..%%......%%%%%%.......%.....%%............................%%.....%.......%%%%%%......%%..%.......%%
m %................%..%%%%%........%%...%%%..%......................%..%%%...%%........%%%%%..%................%
m %.....%%...%%%%%%%%....%...%%..%...%.....%..........................%.....%...%..%%...%....%%%%%%%%...%%.....%
m %.%.%.%%..%%%%%%%%%%%%....%%%%%%...%%%..................................%%%...%%%%%%....%%%%%%%%%%%%..%%.%.%.%
m %.....%.....%%%.%%%%%%%%%.%%%%%%%....%..................................%....%%%%%%%.%%%%%%%%%.%%%.....%.....%
m %%..........%%..%%%%%%%%%%%%%%%%%%%........................................%%%%%%%%%%%%%%%%%%%..%%..........%%
m %%...........%..%%%%%%%%%%%%%%%%%%......%.%%%...%%....%%....%%...%%%.%......%%%%%%%%%%%%%%%%%%..%...........%%
m %..............%%%%%%%%%%%%%%%%%%%........%%..........%%..........%%........%%%%%%%%%%%%%%%%%%%..............%
m %.......%..%...%%%%%%%%%%%%%%%%%%%%.....%.......%%%%%%%%%%%%%%.......%.....%%%%%%%%%%%%%%%%%%%%...%..%.......%
m %...%..%%%%%...%%%%%%%%%%%%%%%%%%%%..%%.%.........%%%%%%%%%%.........%.%%..%%%%%%%%%%%%%%%%%%%%...%%%%%..%...%
m %......%%%%%.%%%%%%%%%%%%%%%%%%%%%...%%............%%%..%%%............%%...%%%%%%%%%%%%%%%%%%%%%.%%%%%......%
m %........%%%..%%%%%%%%%%%%%%%%%%....%%%%%%......%%..........%%......%%%%%%....%%%%%%%%%%%%%%%%%%..%%%........%
m %............%%%%%%%%%%%%%%%%%%%%..%%%%%........%............%........%%%%%..%%%%%%%%%%%%%%%%%%%%............%
m %............%%%%%%%%%%%%%%%%%%%%.%%%%%%........%............%........%%%%%%.%%%%%%%%%%%%%%%%%%%%............%
m %............%%%%%%%%%%%%%%%%%%%%..%%%%%..............................%%%%%..%%%%%%%%%%%%%%%%%%%%............%
m %...........%%%%%%%%%%%%%%%%%%%%%%.%%%%%%............................%%%%%%.%%%%%%%%%%%%%%%%%%%%%%...........%
m %..........%%%%%%%%%%%%%%%%%%%%%%%.%%%%...%....%%%.%%....%%.%%%....%...%%%%.%%%%%%%%%%%%%%%%%%%%%%%..........%
m %.....%..%.%%%%%%%%%%%%%%%%%%%%%%%........%%....%%..........%%....%%........%%%%%%%%%%%%%%%%%%%%%%%.%..%.....%
m %.....%..%%%%%%%%%%%%%%%%%%%%%%%%%%..%..........%%..........%%..........%..%%%%%%%%%%%%%%%%%%%%%%%%%%..%.....%
m %.....%...%%%%%%%%%%%%%%%%%%%%%%%%%%...........%%%..........%%%...........%%%%%%%%%%%%%%%%%%%%%%%%%%...%.....%
m %.....%%%%%%%%%%%%%%%%%%%%%%%%%%%%%........................................%%%%%%%%%%%%%%%%%%%%%%%%%%%%%.....%
m %..%%%%%%%%%%%%%%%%%%%%%%%%%%%...%%......%...........%%%%...........%......%%...%%%%%%%%%%%%%%%%%%%%%%%%%%%..%
m %.%%%%%%%%%%%%%%%%%%%%%%%%%.....%%%..................%%%%..................%%%.....%%%%%%%%%%%%%%%%%%%%%%%%%.%
m %%%%%%%%%%%%%%%%%%%%%%%%%.%...%%%%%.%%...............%%%%...............%%.%%%%%...%.%%%%%%%%%%%%%%%%%%%%%%%%%
m %%%%%%%%%%%%%%%%%%%%%%.........%%%%.%%%..............%%%%..............%%%.%%%%.........%%%%%%%%%%%%%%%%%%%%%%
m %%%%%%%%%%%%%%%%%%%%%....%%%%....%%..%...%..........................%...%..%%....%%%%....%%%%%%%%%%%%%%%%%%%%%
m %%%%%%%%%%%%%%%%%%%......%%%.....%...%..................................%...%.....%%%......%%%%%%%%%%%%%%%%%%%
m %%%%%%%%%%%%%%%%%.%%.....%%%........%....................................%........%%%.....%%.%%%%%%%%%%%%%%%%%
m %%%%%%%%%%%%%%%%%.........%%%....................................................%%%.........%%%%%%%%%%%%%%%%%
m %%%%%%%%%%%%%%%%%.........%%.....%%...........b................a...........%%.....%%.........%%%%%%%%%%%%%%%%%
m %%%%%%%%%%%%%%%%%%%%............%%%........................................%%%............%%%%%%%%%%%%%%%%%%%%
m %%%%%%%%%%%%%%%%..............................................................................%%%%%%%%%%%%%%%%
m %%%%%%%%%%%%%%%%...........%.....%..........................................%.....%...........%%%%%%%%%%%%%%%%
m %%%%%%%%%%%%%%%%..............................................................................%%%%%%%%%%%%%%%%
m %%%%%%%%%%%%%%%..................%..........................................%..................%%%%%%%%%%%%%%%
m %%%%%%%%%%%%%%................%%....%%%%..............................%%%%....%%................%%%%%%%%%%%%%%
m %%%%%%%%%%%%%%%%%%%%%%%%%%%%%%%%%%%%%%%%%%%%%%%%%%%%%%%%%%%%%%%%%%%%%%%%%%%%%%%%%%%%%%%%%%%%%%%%%%%%%%%%%%%%%%

