players 2
rows 104
cols 104
m %%%%%%%%%%%%%%%%%%%%%%%%%%%%%%%%%%%%%%%%%%%%%%%%%%%%%%%%%%%%%%%%%%%%%%%%%%%%%%%%%%%%%%%%%%%%%%%%%%%%%%%%
m %%%%%.....%......%..........%%......%...%...%%%%%%....%%%%%%...%...%......%%..........%......%.....%%%%%
m %%%%%%%%............%.....%..%......%.......%%%.%%....%%.%%%.......%......%..%.....%............%%%%%%%%
m %%%%%%%%.....%%..............%%..........................................%%..............%%.....%%%%%%%%
m %%%%%%%%.%...%%%%.............%...........%%%..............%%%...........%.............%%%%...%.%%%%%%%%
m %.%%%%%%%%....%%................%.%%......%..................%......%%.%................%%....%%%%%%%%.%
m %.%%%%%%%%....%%..................%......%%..................%%......%..................%%....%%%%%%%%.%
m %.%%%%%%......%%%...........%...........%%....................%%...........%...........%%%......%%%%%%.%
m %....%%.....%.%..........................................................................%.%.....%%....%
m %...%%%.....%..............%............%.....%%........%%.....%............%..............%.....%%%...%
m %%..........%.........%..%............%........%%%....%%%........%............%..%.........%..........%%
m %..........%%.........%...........%%.............%....%.............%%...........%.........%%..........%
m %.......%%%%%%.......%%..%%%.%%%..%%%%%.........%%%%%%%%.........%%%%%..%%%.%%%..%%.......%%%%%%.......%
m %..%%.......%%.%%%%%.....%%%%%%%...%%%%........%%%%%%%%%%........%%%%...%%%%%%%.....%%%%%.%%.......%%..%
m %..%%%%%%......%%%%%.....%.%%%%%%%...%%.........%%%%%%%%.........%%...%%%%%%%.%.....%%%%%......%%%%%%..%
m %...%%%%.....%%%%%%%%.......%%%.%....%%%.........%%%%%%.........%%%....%.%%%.......%%%%%%%%.....%%%%...%
m %...%..%.....%%%%%%%%%......%%.......%%%........%%%%%%%%........%%%.......%%......%%%%%%%%%.....%..%...%
m %%...........%%%%%%%%%%%........%.%%%%%%%%%...%.%.%%%%.%.%...%%%%%%%%%.%........%%%%%%%%%%%...........%%
m %............%%%%%%%%%%%........%.%%%%%%%%%..................%%%%%%%%%.%........%%%%%%%%%%%............%
m %............%%%%%%%%%%%%..........%%%%%%%%%%..............%%%%%%%%%%..........%%%%%%%%%%%%............%
m %.%............%%%%%%%%%.........%%%%%%%%%%..................%%%%%%%%%%.........%%%%%%%%%............%.%
m %...........%...%%%%%%%%........%%%%%..%%%%.....%......%.....%%%%..%%%%%........%%%%%%%%...%...........%
m %.........%%%....%%%%%%%.......%%%%%...%%.......%......%.......%%...%%%%%.......%%%%%%%....%%%.........%
m %................%%%%%%%.......%%%%.......%..................%.......%%%%.......%%%%%%%................%
m %..................%.....%.....%%%%..............%....%..............%%%%.....%.....%..................%
m %.........%.%%%.........%%%.%%.%%%%%....%%....................%%....%%%%%.%%.%%%.........%%%.%.........%
m %.%.........%%...........%%....%%%%................%%................%%%%....%%...........%%.........%.%
m %........%..%%%..............%%%%...........%..............%...........%%%%..............%%%..%........%
m %%.....%.....%%%%........%....%..........................................%....%........%%%%.....%.....%%
m %%%%........%%%%%........%.%.......................%%.......................%.%........%%%%%........%%%%
m %..%%.......%%%%...........%%....................%%%%%%....................%%...........%%%%.......%%..%
m %...........%%%.......%%%%%%................................................%%%%%%.......%%%...........%
m %....%........%%.%%..%%%%%%%................................................%%%%%%%..%%.%%........%....%
m %.............%.....%%%%%%%..................................................%%%%%%%.....%.............%
m %....%%....%%....%%.%%%%%%%........................%%........................%%%%%%%.%%....%%....%%....%
m %....%.....%%%...%%%%%%..%..............a......................b..............%..%%%%%%...%%%.....%....%
m %%%.........%%...%%%%%.............................%%.............................%%%%%...%%.........%%%
m %...........%%%%%%%%%..............................................................%%%%%%%%%...........%
m %.........%.%%%%%%%%%..............................................................%%%%%%%%%.%.........%
m %..............%%%%%%%%..........................................................%%%%%%%%..............%
m %%.....%.%.......%%%%%%..%.........b................................a.........%..%%%%%%.......%.%.....%%
m %.....%%.........%%%%%...%....................................................%...%%%%%.........%%.....%
m %...%%%..........%%%%%.%........................................................%.%%%%%..........%%%...%
m %...%..............%..............................%%%%..............................%..............%...%
m %%%.%..............%.......%......................%%%%......................%.......%..............%.%%%
m %%%..............................................%%%%%%..............................................%%%
m %%%......%.......%.................................%%.................................%.......%......%%%
m %%.......%%..%.....................................%%.....................................%..%%.......%%
m %%%.......%.%%%.%%...%%..........................................................%%...%%.%%%.%.......%%%
m %%%.......%%%%%%%.......%.....%..............%............%..............%.....%.......%%%%%%%.......%%%
m %...........%%%%%%............%............%%%............%%%............%............%%%%%%...........%
m %...........%%%%%%........%..%%...%.%......%%%%%........%%%%%......%.%...%%..%........%%%%%%...........%
m %...........%%%%%%........%..%%...%.%......%%%%%........%%%%%......%.%...%%..%........%%%%%%...........%
m %...........%%%%%%............%............%%%............%%%............%............%%%%%%...........%
m %%%.......%%%%%%%.......%.....%..............%............%..............%.....%.......%%%%%%%.......%%%
m %%%.......%.%%%.%%...%%..........................................................%%...%%.%%%.%.......%%%
m %%.......%%..%.....................................%%.....................................%..%%.......%%
m %%%......%.......%.................................%%.................................%.......%......%%%
m %%%..............................................%%%%%%..............................................%%%
m %%%.%..............%.......%......................%%%%......................%.......%..............%.%%%
m %...%..............%..............................%%%%..............................%..............%...%
m %...%%%..........%%%%%.%........................................................%.%%%%%..........%%%...%
m %.....%%.........%%%%%...%....................................................%...%%%%%.........%%.....%
m %%.....%.%.......%%%%%%..%.........a................................b.........%..%%%%%%.......%.%.....%%
m %..............%%%%%%%%..........................................................%%%%%%%%..............%
m %.........%.%%%%%%%%%..............................................................%%%%%%%%%.%.........%
m %...........%%%%%%%%%..............................................................%%%%%%%%%...........%
m %%%.........%%...%%%%%.............................%%.............................%%%%%...%%.........%%%
m %....%.....%%%...%%%%%%..%..............b......................a..............%..%%%%%%...%%%.....%....%
m %....%%....%%....%%.%%%%%%%........................%%........................%%%%%%%.%%....%%....%%....%
m %.............%.....%%%%%%%..................................................%%%%%%%.....%.............%
m %....%........%%.%%..%%%%%%%................................................%%%%%%%..%%.%%........%....%
m %...........%%%.......%%%%%%................................................%%%%%%.......%%%...........%
m %..%%.......%%%%...........%%....................%%%%%%....................%%...........%%%%.......%%..%
m %%%%........%%%%%........%.%.......................%%.......................%.%........%%%%%........%%%%
m %%.....%.....%%%%........%....%..........................................%....%........%%%%.....%.....%%
m %........%..%%%..............%%%%...........%..............%...........%%%%..............%%%..%........%
m %.%.........%%...........%%....%%%%................%%................%%%%....%%...........%%.........%.%
m %.........%.%%%.........%%%.%%.%%%%%....%%....................%%....%%%%%.%%.%%%.........%%%.%.........%
m %..................%.....%.....%%%%..............%....%..............%%%%.....%.....%..................%
m %................%%%%%%%.......%%%%.......%..................%.......%%%%.......%%%%%%%................%
m %.........%%%....%%%%%%%.......%%%%%...%%.......%......%.......%%...%%%%%.......%%%%%%%....%%%.........%
m %...........%...%%%%%%%%........%%%%%..%%%%.....%......%.....%%%%..%%%%%........%%%%%%%%...%...........%
m %.%............%%%%%%%%%.........%%%%%%%%%%..................%%%%%%%%%%.........%%%%%%%%%............%.%
m %............%%%%%%%%%%%%..........%%%%%%%%%%..............%%%%%%%%%%..........%%%%%%%%%%%%............%
m %............%%%%%%%%%%%........%.%%%%%%%%%..................%%%%%%%%%.%........%%%%%%%%%%%............%
m %%...........%%%%%%%%%%%........%.%%%%%%%%%...%.%.%%%%.%.%...%%%%%%%%%.%........%%%%%%%%%%%...........%%
m %...%..%.....%%%%%%%%%......%%.......%%%........%%%%%%%%........%%%.......%%......%%%%%%%%%.....%..%...%
m %...%%%%.....%%%%%%%%.......%%%.%....%%%.........%%%%%%.........%%%....%.%%%.......%%%%%%%%.....%%%%...%
m %..%%%%%%......%%%%%.....%.%%%%%%%...%%.........%%%%%%%%.........%%...%%%%%%%.%.....%%%%%......%%%%%%..%
m %..%%.......%%.%%%%%.....%%%%%%%...%%%%........%%%%%%%%%%........%%%%...%%%%%%%.....%%%%%.%%.......%%..%
m %.......%%%%%%.......%%..%%%.%%%..%%%%%.........%%%%%%%%.........%%%%%..%%%.%%%..%%.......%%%%%%.......%
m %..........%%.........%...........%%.............%....%.............%%...........%.........%%..........%
m %%..........%.........%..%............%........%%%....%%%........%............%..%.........%..........%%
m %...%%%.....%..............%............%.....%%........%%.....%............%..............%.....%%%...%
m %....%%.....%.%..........................................................................%.%.....%%....%
m %.%%%%%%......%%%...........%...........%%....................%%...........%...........%%%......%%%%%%.%
m %.%%%%%%%%....%%..................%......%%..................%%......%..................%%....%%%%%%%%.%
m %.%%%%%%%%....%%................%.%%......%..................%......%%.%................%%....%%%%%%%%.%
m %%%%%%%%.%...%%%%.............%...........%%%..............%%%...........%.............%%%%...%.%%%%%%%%
m %%%%%%%%.....%%..............%%..........................................%%..............%%.....%%%%%%%%
m %%%%%%%%............%.....%..%......%.......%%%.%%....%%.%%%.......%......%..%.....%............%%%%%%%%
m %%%%%.....%......%..........%%......%...%...%%%%%%....%%%%%%...%...%......%%..........%......%.....%%%%%
m %%%%%%%%%%%%%%%%%%%%%%%%%%%%%%%%%%%%%%%%%%%%%%%%%%%%%%%%%%%%%%%%%%%%%%%%%%%%%%%%%%%%%%%%%%%%%%%%%%%%%%%%

