players 8
rows 110
cols 110
m %%%%%%%%%%%%%%%%%%%%%%%%%%%%%%%%%%%%%%%%%%%%%%%%%%%%%%%%%%%%%%%%%%%%%%%%%%%%%%%%%%%%%%%%%%%%%%%%%%%%%%%%%%%%%%
m %%%%%%%%%%%%%%......%%...%.......%...%...%%%%%......%%%%%%......%%%%%...%...%.......%...%%......%%%%%%%%%%%%%%
m %%%%%%%%%%%%%%.............................%%%%..%....%%....%..%%%%.............................%%%%%%%%%%%%%%
m %%%%%%%%%%%%%%...................%..%%%%%..%%%%................%%%%..%%%%%..%...................%%%%%%%%%%%%%%
m %%%%%%%%%%%%%.......................%%.%%%..%%%................%%%..%%%.%%.......................%%%%%%%%%%%%%
m %%%%%%%%%%%%%..........................%%...%%%................%%%...%%..........................%%%%%%%%%%%%%
m %%%%%%%%%%%%%%%..........%..................%....................%..................%..........%%%%%%%%%%%%%%%
m %%%%%%%%%%%%%%%%........a%%...%.%%..........................................%%.%...%%b........%%%%%%%%%%%%%%%%
m %%%%%%%%%%%%%%%%........%....%%%%............................................%%%%....%........%%%%%%%%%%%%%%%%
m %%%%%%%%%%%%..................%%%..%......................................%..%%%..................%%%%%%%%%%%%
m %%%%%%%%%%%%..................%%%..%......................................%..%%%..................%%%%%%%%%%%%
m %%%%%%%%%%%%..%.....................%...%........%..........%........%...%.....................%..%%%%%%%%%%%%
m %%%%%%%%%........................%%........................................%%........................%%%%%%%%%
m %%%%..%%%......................%%%%.............%............%.............%%%%......................%%%..%%%%
m %.....%%%..%...................%%%..........................................%%%...................%..%%%.....%
m %......%%.....................%%%............................................%%%.....................%%......%
m %............................................................................................................%
m %.........................%........................................................%.........................%
m %...............................................%............%...............................................%
m %.........................%.....................%............%.....................%.........................%
m %%........................%%......................................................%%........................%%
m %%..........................................................................................................%%
m %............................................................................................................%
m %............................................................................................................%
m %......c%............................................................................................%c......%
m %%....%%...........................................%......%...........................................%%....%%
m %......%.........%.%%....................%..........%....%..........%....................%%.%.........%......%
m %...................%..............%................%.%%.%................%..............%...................%
m %..................................%%..%%...%.......%%%%%%.......%...%%..%%..................................%
m %.......%..........................%%%%%%...%%....%.%%%%%%.%....%%...%%%%%%..........................%.......%
m %......%%%%....%...................%%%%%.............%%%%.............%%%%%...................%....%%%%......%
m %.......%%%..%%%...................%%%%%...........%..%%..%...........%%%%%...................%%%..%%%.......%
m %......%%%%..%%%...................%%%%%%%.......%....%%....%.......%%%%%%%...................%%%..%%%%......%
m %%.%...%....%%%...................%%%%%%%%%%...%..............%...%%%%%%%%%%...................%%%....%...%.%%
m %...........%%...................%%%%%%%%%%%......................%%%%%%%%%%%...................%%...........%
m %........%%................%%%%%%%%%%%%%%%%%.....%%........%%.....%%%%%%%%%%%%%%%%%................%%........%
m %..%%......%................%%%%%%%%%%%%%%%%%%%.%%%%......%%%%.%%%%%%%%%%%%%%%%%%%................%......%%..%
m %%.%%........................%%%%%%%%%%%%%%%%%%%%%%%......%%%%%%%%%%%%%%%%%%%%%%%........................%%.%%
m %..%.........................%%%%%%%%%%%%%%%%%%%%%%%%%..%%%%%%%%%%%%%%%%%%%%%%%%%.........................%..%
m %..%%%......................%%%%%%%%%%%%%%%%%%%%%%%%%%%%%%%%%%%%%%%%%%%%%%%%%%%%%%......................%%%..%
m %..%%%.....%................%%..%%%%%%%%%%%%%%%%%%%%%%%%%%%%%%%%%%%%%%%%%%%%%%..%%................%.....%%%..%
m %%..%.....................%.....%%%%%%%%%%%%%%%%%%%%%%%%%%%%%%%%%%%%%%%%%%%%%%.....%.....................%..%%
m %%...............................%%%%%%%%%%%%%%%%%%%%%%%%%%%%%%%%%%%%%%%%%%%%...............................%%
m %%%%.............................%%%%%%%%%%%%%%%%%%%%%%%%%%%%%%%%%%%%%%%%%%%%.............................%%%%
m %%%%%%%.....................%%......%%%%%%%%%%%%%%%%%%%%%%%%%%%%%%%%%%%%%%......%%.....................%%%%%%%
m %%%%%%.......................%......%%%%%%%%%%%%%%%%%%%%%%%%%%%%%%%%%%%%%%......%.......................%%%%%%
m %.%%%%..............................%%%%%%%%%%%%%%%%%%%%%%%%%%%%%%%%%%%%%%..............................%%%%.%
m %................................%...%%%%%%%%%%%%%%%%%%%%%%%%%%%%%%%%%%%%...%................................%
m %............%....%%................%%%%%%%%%%%%%%%%%%%%%%%%%%%%%%%%%%%%%%................%%....%............%
m %.%........%....................%..%%%%%%%%%%%%%%%%%%%%%%%%%%%%%%%%%%%%%%%%..%....................%........%.%
m %............................%.....%%%%%%%%%%%%%%%%%%%%%%%%%%%%%%%%%%%%%%%%.....%............................%
m %........................%.....%....%%%%%%%%%%%%%%%%%%%%%%%%%%%%%%%%%%%%%%....%.....%........................%
m %%........................%%%%........%%%%%%%%%%%%%%%%%%%%%%%%%%%%%%%%%%........%%%%........................%%
m %%..........................%%%.......%%%%%%%%%%%%%%%%%%%%%%%%%%%%%%%%%%.......%%%..........................%%
m %%%........................%%%%%%......%%%%%%%%%%%%%%%%%%%%%%%%%%%%%%%%......%%%%%%........................%%%
m %%%........................%%%%%%......%%%%%%%%%%%%%%%%%%%%%%%%%%%%%%%%......%%%%%%........................%%%
m %%..........................%%%.......%%%%%%%%%%%%%%%%%%%%%%%%%%%%%%%%%%.......%%%..........................%%
m %%........................%%%%........%%%%%%%%%%%%%%%%%%%%%%%%%%%%%%%%%%........%%%%........................%%
m %........................%.....%....%%%%%%%%%%%%%%%%%%%%%%%%%%%%%%%%%%%%%%....%.....%........................%
m %............................%.....%%%%%%%%%%%%%%%%%%%%%%%%%%%%%%%%%%%%%%%%.....%............................%
m %.%........%....................%..%%%%%%%%%%%%%%%%%%%%%%%%%%%%%%%%%%%%%%%%..%....................%........%.%
m %............%....%%................%%%%%%%%%%%%%%%%%%%%%%%%%%%%%%%%%%%%%%................%%....%............%
m %................................%...%%%%%%%%%%%%%%%%%%%%%%%%%%%%%%%%%%%%...%................................%
m %.%%%%..............................%%%%%%%%%%%%%%%%%%%%%%%%%%%%%%%%%%%%%%..............................%%%%.%
m %%%%%%.......................%......%%%%%%%%%%%%%%%%%%%%%%%%%%%%%%%%%%%%%%......%.......................%%%%%%
m %%%%%%%.....................%%......%%%%%%%%%%%%%%%%%%%%%%%%%%%%%%%%%%%%%%......%%.....................%%%%%%%
m %%%%.............................%%%%%%%%%%%%%%%%%%%%%%%%%%%%%%%%%%%%%%%%%%%%.............................%%%%
m %%...............................%%%%%%%%%%%%%%%%%%%%%%%%%%%%%%%%%%%%%%%%%%%%...............................%%
m %%..%.....................%.....%%%%%%%%%%%%%%%%%%%%%%%%%%%%%%%%%%%%%%%%%%%%%%.....%.....................%..%%
m %..%%%.....%................%%..%%%%%%%%%%%%%%%%%%%%%%%%%%%%%%%%%%%%%%%%%%%%%%..%%................%.....%%%..%
m %..%%%......................%%%%%%%%%%%%%%%%%%%%%%%%%%%%%%%%%%%%%%%%%%%%%%%%%%%%%%......................%%%..%
m %..%.........................%%%%%%%%%%%%%%%%%%%%%%%%%..%%%%%%%%%%%%%%%%%%%%%%%%%.........................%..%
m %%.%%........................%%%%%%%%%%%%%%%%%%%%%%%......%%%%%%%%%%%%%%%%%%%%%%%........................%%.%%
m %..%%......%................%%%%%%%%%%%%%%%%%%%.%%%%......%%%%.%%%%%%%%%%%%%%%%%%%................%......%%..%
m %........%%................%%%%%%%%%%%%%%%%%.....%%........%%.....%%%%%%%%%%%%%%%%%................%%........%
m %...........%%...................%%%%%%%%%%%......................%%%%%%%%%%%...................%%...........%
m %%.%...%....%%%...................%%%%%%%%%%...%..............%...%%%%%%%%%%...................%%%....%...%.%%
m %......%%%%..%%%...................%%%%%%%.......%....%%....%.......%%%%%%%...................%%%..%%%%......%
m %.......%%%..%%%...................%%%%%...........%..%%..%...........%%%%%...................%%%..%%%.......%
m %......%%%%....%...................%%%%%.............%%%%.............%%%%%...................%....%%%%......%
m %.......%..........................%%%%%%...%%....%.%%%%%%.%....%%...%%%%%%..........................%.......%
m %..................................%%..%%...%.......%%%%%%.......%...%%..%%..................................%
m %...................%..............%................%.%%.%................%..............%...................%
m %......%.........%.%%....................%..........%....%..........%....................%%.%.........%......%
m %%....%%...........................................%......%...........................................%%....%%
m %......d%............................................................................................%d......%
m %............................................................................................................%
m %............................................................................................................%
m %%..........................................................................................................%%
m %%........................%%......................................................%%........................%%
m %.........................%.....................%............%.....................%.........................%
m %...............................................%............%...............................................%
m %.........................%........................................................%.........................%
m %............................................................................................................%
m %......%%.....................%%%............................................%%%.....................%%......%
m %.....%%%..%...................%%%..........................................%%%...................%..%%%.....%
m %%%%..%%%......................%%%%.............%............%.............%%%%......................%%%..%%%%
m %%%%%%%%%........................%%........................................%%........................%%%%%%%%%
m %%%%%%%%%%%%..%.....................%...%........%..........%........%...%.....................%..%%%%%%%%%%%%
m %%%%%%%%%%%%..................%%%..%......................................%..%%%..................%%%%%%%%%%%%
m %%%%%%%%%%%%..................%%%..%......................................%..%%%..................%%%%%%%%%%%%
m %%%%%%%%%%%%%%%%........%....%%%%............................................%%%%....%........%%%%%%%%%%%%%%%%
m %%%%%%%%%%%%%%%%........a%%...%.%%..........................................%%.%...%%b........%%%%%%%%%%%%%%%%
m %%%%%%%%%%%%%%%..........%..................%....................%..................%..........%%%%%%%%%%%%%%%
m %%%%%%%%%%%%%..........................%%...%%%................%%%...%%..........................%%%%%%%%%%%%%
m %%%%%%%%%%%%%.......................%%.%%%..%%%................%%%..%%%.%%.......................%%%%%%%%%%%%%
m %%%%%%%%%%%%%%...................%..%%%%%..%%%%................%%%%..%%%%%..%...................%%%%%%%%%%%%%%
m %%%%%%%%%%%%%%.............................%%%%..%....%%....%..%%%%.............................%%%%%%%%%%%%%%
m %%%%%%%%%%%%%%......%%...%.......%...%...%%%%%......%%%%%%......%%%%%...%...%.......%...%%......%%%%%%%%%%%%%%
m %%%%%%%%%%%%%%%%%%%%%%%%%%%%%%%%%%%%%%%%%%%%%%%%%%%%%%%%%%%%%%%%%%%%%%%%%%%%%%%%%%%%%%%%%%%%%%%%%%%%%%%%%%%%%%

