players 4
rows 94
cols 94
m %%%%%%%%%%%%%%%%%%%%%%%%%%%%%%%%%%%%%%%%%%%%%%%%%%%%%%%%%%%%%%%%%%%%%%%%%%%%%%%%%%%%%%%%%%%%%%
m %%%%%%%%%%%%%%%%%...%.............%........................%.............%...%%%%%%%%%%%%%%%%%
m %%%%%%%%%%%%%.%%%............................................................%%%.%%%%%%%%%%%%%
m %%%%%%%%%%%..................%%%..............................%%%..................%%%%%%%%%%%
m %%%%%%%%%%%..................%%%%............................%%%%..................%%%%%%%%%%%
m %%%%%%%%%%%%.%%..............%%................................%%..............%%.%%%%%%%%%%%%
m %%%%%%%%%%%%%%%.....%.............%%.%........%%........%.%%.............%.....%%%%%%%%%%%%%%%
m %%%%%%%%%%%%%%%...%%%.....%............a..............b............%.....%%%...%%%%%%%%%%%%%%%
m %%%%%%%%%%%%%%%.%%%%%.....%........................................%.....%%%%%.%%%%%%%%%%%%%%%
m %%%%%%%%%%%%%%%.%%%%%%..%%%........................................%%%..%%%%%%.%%%%%%%%%%%%%%%
m %%%%%%%%%%%%%%%%%%%%%%%%%%%........................................%%%%%%%%%%%%%%%%%%%%%%%%%%%
m %%%..%%%%%%%%%%%%%%%%%%%%%...%%....%......................%....%%...%%%%%%%%%%%%%%%%%%%%%..%%%
m %%%...%%%%%%%%%%%%%%%%%%%%..%%%................................%%%..%%%%%%%%%%%%%%%%%%%%...%%%
m %%...%%%%%%%%%%%%%%%%%%%%%.%......................................%.%%%%%%%%%%%%%%%%%%%%%...%%
m %%%..%%%%%%%%%%%%%%%%%%%%%...%%%..............................%%%...%%%%%%%%%%%%%%%%%%%%%..%%%
m %%%.......%%%%%%%%%%%%%%.....%%................................%%.....%%%%%%%%%%%%%%.......%%%
m %%%.....%%%%%%%%%%%%%%%........%.....%..%.%........%.%..%.....%........%%%%%%%%%%%%%%%.....%%%
m %.......%%%%%%%%%%%%%%%..%................%%......%%................%..%%%%%%%%%%%%%%%.......%
m %......%%%%%%%%%%%%%%%%..%..........................................%..%%%%%%%%%%%%%%%%......%
m %......%%%%%%%%%%%%%.......%......................................%.......%%%%%%%%%%%%%......%
m %%....%%%%%%%%%%%%%.......%%%....................................%%%.......%%%%%%%%%%%%%....%%
m %........%%%%%%%%%%........%%%..........%............%..........%%%........%%%%%%%%%%........%
m %.........%%%%%%%%%.....%%.%%%...........%....%%....%...........%%%.%%.....%%%%%%%%%.........%
m %.........%%%%%%........%%.%%%%......%%%.%...%%%%...%.%%%......%%%%.%%........%%%%%%.........%
m %........%%%%%%.......%%...%%%%.....%%%%.....%%%%.....%%%%.....%%%%...%%.......%%%%%%........%
m %........%%%%%%..%%...%%.%.%%%%%%....%%%%.....%%.....%%%%....%%%%%%.%.%%...%%..%%%%%%........%
m %......%%%%.........%.....%%%%%%%...%%%%%....%%%%....%%%%%...%%%%%%%.....%.........%%%%......%
m %............%.....%%%%%%%%%%%%%%....%%%%%....%%....%%%%%....%%%%%%%%%%%%%%.....%............%
m %...........%.......%%%%%%%%%%%%%.%..%%%%%..........%%%%%..%.%%%%%%%%%%%%%.......%...........%
m %..%%%.....%%.%%.....%%%%%%%%%%%%.%...%%%............%%%...%.%%%%%%%%%%%%.....%%.%%.....%%%..%
m %..%%%.....%%.%%.......%%%%%%%%%........%............%........%%%%%%%%%.......%%.%%.....%%%..%
m %..%%.........%.%........%%%%%%.........%............%.........%%%%%%........%.%.........%%..%
m %...%....................%%%%%..........%............%..........%%%%%....................%...%
m %..................................%%.........%%.........%%..................................%
m %%....%.....................%%.....%%.........%%.........%%.....%%.....................%....%%
m %.....%....%.....................%%%.........%%%%.........%%%.....................%....%.....%
m %.......................%.%......%%.%...%.....%%.....%...%.%%......%.%.......................%
m %.....%.........%......%%%%%%...........%...%....%...%...........%%%%%%......%.........%.....%
m %......................%%%%%%%........%.%%.%%....%%.%%.%........%%%%%%%......................%
m %......c...............%%%%%%%..........%%%........%%%..........%%%%%%%...............c......%
m %...............%....%...%%%%%%%%...%%%%..............%%%%...%%%%%%%%...%....%...............%
m %.....................%%...%%.........%%..............%%.........%%...%%.....................%
m %...............%%.....................%..............%.....................%%...............%
m %................%....................%................%....................%................%
m %....................................%%................%%....................................%
m %......................%%.%........%......................%........%.%%......................%
m %.....%...............%%%%%%.....%%%%....................%%%%.....%%%%%%...............%.....%
m %.....%...............%%%%%%.....%%%%....................%%%%.....%%%%%%...............%.....%
m %......................%%.%........%......................%........%.%%......................%
m %....................................%%................%%....................................%
m %................%....................%................%....................%................%
m %...............%%.....................%..............%.....................%%...............%
m %.....................%%...%%.........%%..............%%.........%%...%%.....................%
m %...............%....%...%%%%%%%%...%%%%..............%%%%...%%%%%%%%...%....%...............%
m %......d...............%%%%%%%..........%%%........%%%..........%%%%%%%...............d......%
m %......................%%%%%%%........%.%%.%%....%%.%%.%........%%%%%%%......................%
m %.....%.........%......%%%%%%...........%...%....%...%...........%%%%%%......%.........%.....%
m %.......................%.%......%%.%...%.....%%.....%...%.%%......%.%.......................%
m %.....%....%.....................%%%.........%%%%.........%%%.....................%....%.....%
m %%....%.....................%%.....%%.........%%.........%%.....%%.....................%....%%
m %..................................%%.........%%.........%%..................................%
m %...%....................%%%%%..........%............%..........%%%%%....................%...%
m %..%%.........%.%........%%%%%%.........%............%.........%%%%%%........%.%.........%%..%
m %..%%%.....%%.%%.......%%%%%%%%%........%............%........%%%%%%%%%.......%%.%%.....%%%..%
m %..%%%.....%%.%%.....%%%%%%%%%%%%.%...%%%............%%%...%.%%%%%%%%%%%%.....%%.%%.....%%%..%
m %...........%.......%%%%%%%%%%%%%.%..%%%%%..........%%%%%..%.%%%%%%%%%%%%%.......%...........%
m %............%.....%%%%%%%%%%%%%%....%%%%%....%%....%%%%%....%%%%%%%%%%%%%%.....%............%
m %......%%%%.........%.....%%%%%%%...%%%%%....%%%%....%%%%%...%%%%%%%.....%.........%%%%......%
m %........%%%%%%..%%...%%.%.%%%%%%....%%%%.....%%.....%%%%....%%%%%%.%.%%...%%..%%%%%%........%
m %........%%%%%%.......%%...%%%%.....%%%%.....%%%%.....%%%%.....%%%%...%%.......%%%%%%........%
m %.........%%%%%%........%%.%%%%......%%%.%...%%%%...%.%%%......%%%%.%%........%%%%%%.........%
m %.........%%%%%%%%%.....%%.%%%...........%....%%....%...........%%%.%%.....%%%%%%%%%.........%
m %........%%%%%%%%%%........%%%..........%............%..........%%%........%%%%%%%%%%........%
m %%....%%%%%%%%%%%%%.......%%%....................................%%%.......%%%%%%%%%%%%%....%%
m %......%%%%%%%%%%%%%.......%......................................%.......%%%%%%%%%%%%%......%
m %......%%%%%%%%%%%%%%%%..%..........................................%..%%%%%%%%%%%%%%%%......%
m %.......%%%%%%%%%%%%%%%..%................%%......%%................%..%%%%%%%%%%%%%%%.......%
m %%%.....%%%%%%%%%%%%%%%........%.....%..%.%........%.%..%.....%........%%%%%%%%%%%%%%%.....%%%
m %%%.......%%%%%%%%%%%%%%.....%%................................%%.....%%%%%%%%%%%%%%.......%%%
m %%%..%%%%%%%%%%%%%%%%%%%%%...%%%..............................%%%...%%%%%%%%%%%%%%%%%%%%%..%%%
m %%...%%%%%%%%%%%%%%%%%%%%%.%......................................%.%%%%%%%%%%%%%%%%%%%%%...%%
m %%%...%%%%%%%%%%%%%%%%%%%%..%%%................................%%%..%%%%%%%%%%%%%%%%%%%%...%%%
m %%%..%%%%%%%%%%%%%%%%%%%%%...%%....%......................%....%%...%%%%%%%%%%%%%%%%%%%%%..%%%
m %%%%%%%%%%%%%%%%%%%%%%%%%%%........................................%%%%%%%%%%%%%%%%%%%%%%%%%%%
m %%%%%%%%%%%%%%%.%%%%%%..%%%........................................%%%..%%%%%%.%%%%%%%%%%%%%%%
m %%%%%%%%%%%%%%%.%%%%%.....%........................................%.....%%%%%.%%%%%%%%%%%%%%%
m %%%%%%%%%%%%%%%...%%%.....%............a..............b............%.....%%%...%%%%%%%%%%%%%%%
m %%%%%%%%%%%%%%%.....%.............%%.%........%%........%.%%.............%.....%%%%%%%%%%%%%%%
m %%%%%%%%%%%%.%%..............%%................................%%..............%%.%%%%%%%%%%%%
m %%%%%%%%%%%..................%%%%............................%%%%..................%%%%%%%%%%%
m %%%%%%%%%%%..................%%%..............................%%%..................%%%%%%%%%%%
m %%%%%%%%%%%%%.%%%............................................................%%%.%%%%%%%%%%%%%
m %%%%%%%%%%%%%%%%%...%.............%........................%.............%...%%%%%%%%%%%%%%%%%
m %%%%%%%%%%%%%%%%%%%%%%%%%%%%%%%%%%%%%%%%%%%%%%%%%%%%%%%%%%%%%%%%%%%%%%%%%%%%%%%%%%%%%%%%%%%%%%

