players 2
rows 106
cols 106
m %%%%%%%%%%%%%%%%%%%%%%%%%%%%%%%%%%%%%%%%%%%%%%%%%%%%%%%%%%%%%%%%%%%%%%%%%%%%%%%%%%%%%%%%%%%%%%%%%%%%%%%%%%
m %%%%%%%%%%%%%%%%%%%%%%%%%%%%%%%%%%....%.....%%%%%%%%%%%%%%%%%%.....%....%%%%%%%%%%%%%%%%%%%%%%%%%%%%%%%%%%
m %%%%%%%%%%%%%%%%%%%%%%%%%%%%%%%%%%..........%%%%%%%%%%%%%%%%%%..........%%%%%%%%%%%%%%%%%%%%%%%%%%%%%%%%%%
m %%%%%%%%%%%%%%%%%%%%%%%%%%.%%%%%............%%.%..%%%%%%..%.%%............%%%%%.%%%%%%%%%%%%%%%%%%%%%%%%%%
m %%%%%%%%%%%%%%%%%%..%%%%%..%%%%..............%....%%%%%%....%..............%%%%..%%%%%..%%%%%%%%%%%%%%%%%%
m %%%%%%%%%%%%%%%%..........%%%%%.....%%............%%%%%%............%%.....%%%%%..........%%%%%%%%%%%%%%%%
m %%%%%%%%%%%%%.........%%%......%...%%%%%........%%%%%%%%%%........%%%%%...%......%%%.........%%%%%%%%%%%%%
m %%%%%%%%%%%%.......a.%%%%......%%..%%%%%........%%%%%%%%%%........%%%%%..%%......%%%%.b.......%%%%%%%%%%%%
m %%%%%%%%%%%%.........%%%%%%..%.%%..%%%%%........%%%%%%%%%%........%%%%%..%%.%..%%%%%%.........%%%%%%%%%%%%
m %%%%%%%%%%%%..........%%%%...%...%%%%%%%%%.......%%%%%%%%.......%%%%%%%%%...%...%%%%..........%%%%%%%%%%%%
m %%%%%%%%%%%%..........%%%%%%%%%%.%%%%%%%%........%%%%%%%%........%%%%%%%%.%%%%%%%%%%..........%%%%%%%%%%%%
m %%%%%%%%%%%%..........%%.%%%%%%.....%%..%..%....%%%%%%%%%%....%..%..%%.....%%%%%%.%%..........%%%%%%%%%%%%
m %%%%%%%...................%%%%%%%.........%%.%..%%%%%%%%%%..%.%%.........%%%%%%%...................%%%%%%%
m %%%%%%.....................%%%%%%....%%%%%...%%%%%%%%%%%%%%%%...%%%%%....%%%%%%.....................%%%%%%
m %%%%%%.......................%%%%%%%.%%%%%..%%%%%%%%%%%%%%%%%%..%%%%%.%%%%%%%.......................%%%%%%
m %%%%%%....................%%..%%%%%%%%%%%%%.......%....%.......%%%%%%%%%%%%%..%%....................%%%%%%
m %%%%%.........................%%%%%%%%%%%%%%%%%%%........%%%%%%%%%%%%%%%%%%%.........................%%%%%
m %%%%%..................%.....%%%%%%%%%%%%%%%%%%%%........%%%%%%%%%%%%%%%%%%%%.....%..................%%%%%
m %%%%.....................%....%%%%%%%%%%%%%%%%%%%%%....%%%%%%%%%%%%%%%%%%%%%....%.....................%%%%
m %%%%...b................%%..%%%%%%%%%%%%%%%%%%%%%%%%..%%%%%%%%%%%%%%%%%%%%%%%%..%%................a...%%%%
m %%%%%...............%.%.....%%%%%%%%%%%%%%%%%%%%%%%%..%%%%%%%%%%%%%%%%%%%%%%%%.....%.%...............%%%%%
m %%%%%..%%..................%%%%%%%%%.%%%%%%%%%...%......%...%%%%%%%%%.%%%%%%%%%..................%%..%%%%%
m %%%%%.%%%%%%........%......%%%%%%%%%...%%........%......%........%%...%%%%%%%%%......%........%%%%%%.%%%%%
m %%%%%.%%%%%%.....%........%%%%%%%%%.....%.%.....%%%....%%%.....%.%.....%%%%%%%%%........%.....%%%%%%.%%%%%
m %%%%%.%%%%%........%........%%%%%%........%.....%%......%%.....%........%%%%%%........%........%%%%%.%%%%%
m %%%%....%%%%......%%......%....%%%......................................%%%....%......%%......%%%%....%%%%
m %%%..%..%.%%%..%.......%.%%......%......................................%......%%.%.......%..%%%.%..%..%%%
m %%%%%%....%%%%.%.....%%%..........%....................................%..........%%%.....%.%%%%....%%%%%%
m %%%%%%....%%%%.....%%%%%%........................%......%........................%%%%%%.....%%%%....%%%%%%
m %%%%%%..%%%%%%%..%.%%%%%%.......%........................................%.......%%%%%%.%..%%%%%%%..%%%%%%
m %%%%%%....%%%%%%%%%%%%%%%.......%.%..%%%..........................%%%..%.%.......%%%%%%%%%%%%%%%....%%%%%%
m %%%%..%%%.%.%%%%%%%%%%%%%%........%....%..........................%....%........%%%%%%%%%%%%%%.%.%%%..%%%%
m %%%....%%...%%%%%%%%%%%%%%...%%......%...%%.%................%.%%...%......%%...%%%%%%%%%%%%%%...%%....%%%
m %%%......%%...%%%%%%%%%%%%%.......%.%%%%.%%....................%%.%%%%.%.......%%%%%%%%%%%%%...%%......%%%
m %........%%...%%%%%%%%%%...%..%%.%..%%%..%%....................%%..%%%..%.%%..%...%%%%%%%%%%...%%........%
m %.....%%%%%...%%%%%%%%%............................................................%%%%%%%%%...%%%%%.....%
m %....%%%%%%%...%%%%%%............%%....................................%%............%%%%%%...%%%%%%%....%
m %....%%%%%%%.%%%%%%%%%........%.%%%....................................%%%.%........%%%%%%%%%.%%%%%%%....%
m %%....%%%%%..%%%%%%%%%........%..%%....%..........................%....%%..%........%%%%%%%%%..%%%%%....%%
m %.....%%%%%..%%%%%%%%%%.......%%.%....%............................%....%.%%.......%%%%%%%%%%..%%%%%.....%
m %........%%%.%%%%%%%%%%%..........................................................%%%%%%%%%%%.%%%........%
m %........%...%%%%%%%%%..........%%%......%..........%%..........%......%%%..........%%%%%%%%%...%........%
m %...........%..%%%%%%%.%%.......%%%.................%%.................%%%.......%%.%%%%%%%..%...........%
m %..........%%...%%%%%%.....................%..................%.....................%%%%%%...%%..........%
m %%%%..........%.%%%%%%..........%........................................%..........%%%%%%.%..........%%%%
m %%%%%.......%%%.%%%%%%..............................................................%%%%%%.%%%.......%%%%%
m %%%..........%%.%%%%%................................................................%%%%%.%%..........%%%
m %%%%.........%%.%%%%%................................................................%%%%%.%%.........%%%%
m %%%...%%%..%%%%.%%%%%..%%........................................................%%..%%%%%.%%%%..%%%...%%%
m %%%...%%%%%%%%%...%%%%%%%...%................................................%...%%%%%%%...%%%%%%%%%...%%%
m %%%%%%%%%%%%%%%%..%%%..%..........................................................%..%%%..%%%%%%%%%%%%%%%%
m %%%%%%%%%%%%%%%....%%................................................................%%....%%%%%%%%%%%%%%%
m %%%%%%%%%%%%%%%..........................%%....................%%..........................%%%%%%%%%%%%%%%
m %%%%%%%%%%%%%%%..........................%%....................%%..........................%%%%%%%%%%%%%%%
m %%%%%%%%%%%%%%%....%%................................................................%%....%%%%%%%%%%%%%%%
m %%%%%%%%%%%%%%%%..%%%..%..........................................................%..%%%..%%%%%%%%%%%%%%%%
m %%%...%%%%%%%%%...%%%%%%%...%................................................%...%%%%%%%...%%%%%%%%%...%%%
m %%%...%%%..%%%%.%%%%%..%%........................................................%%..%%%%%.%%%%..%%%...%%%
m %%%%.........%%.%%%%%................................................................%%%%%.%%.........%%%%
m %%%..........%%.%%%%%................................................................%%%%%.%%..........%%%
m %%%%%.......%%%.%%%%%%..............................................................%%%%%%.%%%.......%%%%%
m %%%%..........%.%%%%%%..........%........................................%..........%%%%%%.%..........%%%%
m %..........%%...%%%%%%.....................%..................%.....................%%%%%%...%%..........%
m %...........%..%%%%%%%.%%.......%%%.................%%.................%%%.......%%.%%%%%%%..%...........%
m %........%...%%%%%%%%%..........%%%......%..........%%..........%......%%%..........%%%%%%%%%...%........%
m %........%%%.%%%%%%%%%%%..........................................................%%%%%%%%%%%.%%%........%
m %.....%%%%%..%%%%%%%%%%.......%%.%....%............................%....%.%%.......%%%%%%%%%%..%%%%%.....%
m %%....%%%%%..%%%%%%%%%........%..%%....%..........................%....%%..%........%%%%%%%%%..%%%%%....%%
m %....%%%%%%%.%%%%%%%%%........%.%%%....................................%%%.%........%%%%%%%%%.%%%%%%%....%
m %....%%%%%%%...%%%%%%............%%....................................%%............%%%%%%...%%%%%%%....%
m %.....%%%%%...%%%%%%%%%............................................................%%%%%%%%%...%%%%%.....%
m %........%%...%%%%%%%%%%...%..%%.%..%%%..%%....................%%..%%%..%.%%..%...%%%%%%%%%%...%%........%
m %%%......%%...%%%%%%%%%%%%%.......%.%%%%.%%....................%%.%%%%.%.......%%%%%%%%%%%%%...%%......%%%
m %%%....%%...%%%%%%%%%%%%%%...%%......%...%%.%................%.%%...%......%%...%%%%%%%%%%%%%%...%%....%%%
m %%%%..%%%.%.%%%%%%%%%%%%%%........%....%..........................%....%........%%%%%%%%%%%%%%.%.%%%..%%%%
m %%%%%%....%%%%%%%%%%%%%%%.......%.%..%%%..........................%%%..%.%.......%%%%%%%%%%%%%%%....%%%%%%
m %%%%%%..%%%%%%%..%.%%%%%%.......%........................................%.......%%%%%%.%..%%%%%%%..%%%%%%
m %%%%%%....%%%%.....%%%%%%........................%......%........................%%%%%%.....%%%%....%%%%%%
m %%%%%%....%%%%.%.....%%%..........%....................................%..........%%%.....%.%%%%....%%%%%%
m %%%..%..%.%%%..%.......%.%%......%......................................%......%%.%.......%..%%%.%..%..%%%
m %%%%....%%%%......%%......%....%%%......................................%%%....%......%%......%%%%....%%%%
m %%%%%.%%%%%........%........%%%%%%........%.....%%......%%.....%........%%%%%%........%........%%%%%.%%%%%
m %%%%%.%%%%%%.....%........%%%%%%%%%.....%.%.....%%%....%%%.....%.%.....%%%%%%%%%........%.....%%%%%%.%%%%%
m %%%%%.%%%%%%........%......%%%%%%%%%...%%........%......%........%%...%%%%%%%%%......%........%%%%%%.%%%%%
m %%%%%..%%..................%%%%%%%%%.%%%%%%%%%...%......%...%%%%%%%%%.%%%%%%%%%..................%%..%%%%%
m %%%%%...............%.%.....%%%%%%%%%%%%%%%%%%%%%%%%..%%%%%%%%%%%%%%%%%%%%%%%%.....%.%...............%%%%%
m %%%%...a................%%..%%%%%%%%%%%%%%%%%%%%%%%%..%%%%%%%%%%%%%%%%%%%%%%%%..%%................b...%%%%
m %%%%.....................%....%%%%%%%%%%%%%%%%%%%%%....%%%%%%%%%%%%%%%%%%%%%....%.....................%%%%
m %%%%%..................%.....%%%%%%%%%%%%%%%%%%%%........%%%%%%%%%%%%%%%%%%%%.....%..................%%%%%
m %%%%%.........................%%%%%%%%%%%%%%%%%%%........%%%%%%%%%%%%%%%%%%%.........................%%%%%
m %%%%%%....................%%..%%%%%%%%%%%%%.......%....%.......%%%%%%%%%%%%%..%%....................%%%%%%
m %%%%%%.......................%%%%%%%.%%%%%..%%%%%%%%%%%%%%%%%%..%%%%%.%%%%%%%.......................%%%%%%
m %%%%%%.....................%%%%%%....%%%%%...%%%%%%%%%%%%%%%%...%%%%%....%%%%%%.....................%%%%%%
m %%%%%%%...................%%%%%%%.........%%.%..%%%%%%%%%%..%.%%.........%%%%%%%...................%%%%%%%
m %%%%%%%%%%%%..........%%.%%%%%%.....%%..%..%....%%%%%%%%%%....%..%..%%.....%%%%%%.%%..........%%%%%%%%%%%%
m %%%%%%%%%%%%..........%%%%%%%%%%.%%%%%%%%........%%%%%%%%........%%%%%%%%.%%%%%%%%%%..........%%%%%%%%%%%%
m %%%%%%%%%%%%..........%%%%...%...%%%%%%%%%.......%%%%%%%%.......%%%%%%%%%...%...%%%%..........%%%%%%%%%%%%
m %%%%%%%%%%%%.........%%%%%%..%.%%..%%%%%........%%%%%%%%%%........%%%%%..%%.%..%%%%%%.........%%%%%%%%%%%%
m %%%%%%%%%%%%.......b.%%%%......%%..%%%%%........%%%%%%%%%%........%%%%%..%%......%%%%.a.......%%%%%%%%%%%%
m %%%%%%%%%%%%%.........%%%......%...%%%%%........%%%%%%%%%%........%%%%%...%......%%%.........%%%%%%%%%%%%%
m %%%%%%%%%%%%%%%%..........%%%%%.....%%............%%%%%%............%%.....%%%%%..........%%%%%%%%%%%%%%%%
m %%%%%%%%%%%%%%%%%%..%%%%%..%%%%..............%....%%%%%%....%..............%%%%..%%%%%..%%%%%%%%%%%%%%%%%%
m %%%%%%%%%%%%%%%%%%%%%%%%%%.%%%%%............%%.%..%%%%%%..%.%%............%%%%%.%%%%%%%%%%%%%%%%%%%%%%%%%%
m %%%%%%%%%%%%%%%%%%%%%%%%%%%%%%%%%%..........%%%%%%%%%%%%%%%%%%..........%%%%%%%%%%%%%%%%%%%%%%%%%%%%%%%%%%
m %%%%%%%%%%%%%%%%%%%%%%%%%%%%%%%%%%....%.....%%%%%%%%%%%%%%%%%%.....%....%%%%%%%%%%%%%%%%%%%%%%%%%%%%%%%%%%
m %%%%%%%%%%%%%%%%%%%%%%%%%%%%%%%%%%%%%%%%%%%%%%%%%%%%%%%%%%%%%%%%%%%%%%%%%%%%%%%%%%%%%%%%%%%%%%%%%%%%%%%%%%

