players 4
rows 90
cols 90
m %%%%%%%%%%%%%%%%%%%%%%%%%%%%%%%%%%%%%%%%%%%%%%%%%%%%%%%%%%%%%%%%%%%%%%%%%%%%%%%%%%%%%%%%%%
m %%%%%%%%...........%.%%%%%%%%%%%%%%%%%%%%%..%%..%%%%%%%%%%%%%%%%%%%%%.%...........%%%%%%%%
m %%%%%%%%%.............%%%%%%%%%%%%%%%.......%%.......%%%%%%%%%%%%%%%.............%%%%%%%%%
m %%%%%%%%%%............%%%%%%%%%%%%%%%..%....%%....%..%%%%%%%%%%%%%%%............%%%%%%%%%%
m %%%%%%%%%..%..............%%%%%%%%%%%.%%%..%%%%..%%%.%%%%%%%%%%%..............%..%%%%%%%%%
m %%%%%%.....%........%.%%%..%%%%%%%%%a.%%%..%%%%..%%%.b%%%%%%%%%..%%%.%........%.....%%%%%%
m %%%%%...............%.%%....%%%%%%%%%%%%%..%%%%..%%%%%%%%%%%%%....%%.%...............%%%%%
m %%%%%...............%..%....%.%%%%%%%%%%%..%%%%..%%%%%%%%%%%.%....%..%...............%%%%%
m %.%%%.........................%%%%%%%%%%%..%%%%..%%%%%%%%%%%.........................%%%.%
m %..%...................%%.....%%%%%%%%%............%%%%%%%%%.....%%...................%..%
m %......................%......%%%%%%%%%............%%%%%%%%%......%......................%
m %...%%...................%.....%%%%%%%%............%%%%%%%%.....%...................%%...%
m %....................%%%%%....%%%%%%%%..............%%%%%%%%....%%%%%....................%
m %.....................%%%%....%%%%%%%................%%%%%%%....%%%%.....................%
m %.......................%%....%%%%%%...%%%......%%%...%%%%%%....%%.......................%
m %.......................%%.....%%%%%...%...%%%%...%...%%%%%.....%%.......................%
m %......................%.....%.%%%%%.%..............%.%%%%%.%.....%......................%
m %.....................%..........%%....................%%..........%.....................%
m %.................%%%%....%%%.....%....................%.....%%%....%%%%.................%
m %%................%%...%..%%%%...........%..%%..%...........%%%%..%...%%................%%
m %....%%%..........%....%...%%%...%%%.....%..%%..%.....%%%...%%%...%....%..........%%%....%
m %%..........%.....%....%......%..%%.........%%.........%%..%......%....%.....%..........%%
m %%%%.%%.....%%...%......%.....%%.%%........%%%%........%%.%%.....%......%...%%.....%%.%%%%
m %%%%.%%%.%%.%%..%..%%%..%......%%%..........%%..........%%%......%..%%%..%..%%.%%.%%%.%%%%
m %%%%.%...%..%%%%......%%%...................%%...................%%%......%%%%..%...%.%%%%
m %%%%.......%%%%%..........................................................%%%%%.......%%%%
m %%%%%.............%%..................................................%%.............%%%%%
m %%%%%%............%%%................................................%%%............%%%%%%
m %%%%%%%%..........%%%......................%..%......................%%%..........%%%%%%%%
m %%%%%%%.........%..%%................................................%%..%.........%%%%%%%
m %%%%%%%%%%%.%%%......%%............................................%%......%%%.%%%%%%%%%%%
m %%%%%%%%%%%%%%%%%.....%%.........%%.........%%.........%%.........%%.....%%%%%%%%%%%%%%%%%
m %%%%%%%%%%%%%%%%%......%........%%%........%%%%........%%%........%......%%%%%%%%%%%%%%%%%
m %%%%%%%%%%%%%%%%%%..%%%%.......%%%.......%%%%%%%%.......%%%.......%%%%..%%%%%%%%%%%%%%%%%%
m %%%%%%%%%%%%%%%%%%%.%%%........%%........%%%%%%%%........%%........%%%.%%%%%%%%%%%%%%%%%%%
m %%%%%%%%%%%%%%%%%...%....................%%.%%.%%....................%...%%%%%%%%%%%%%%%%%
m %%%%%a%%%%%%%%..............................................................%%%%%%%%b%%%%%
m %%....%%%%%%%...%........................................................%...%%%%%%%....%%
m %%..%%%%%%%%..................................................................%%%%%%%%..%%
m %%.%%%%%%.....%%..........................................................%%.....%%%%%%.%%
m %%..%%%%%.....%............................................................%.....%%%%%..%%
m %%............%....%%............%%%..................%%%............%%....%............%%
m %................................%%%..................%%%................................%
m %...%%%%%......%......%.....%...%%%....................%%%...%.....%......%......%%%%%...%
m %%%%%%%%%......%...%%%%%%......%%%%%..................%%%%%......%%%%%%...%......%%%%%%%%%
m %%%%%%%%%......%...%%%%%%......%%%%%..................%%%%%......%%%%%%...%......%%%%%%%%%
m %...%%%%%......%......%.....%...%%%....................%%%...%.....%......%......%%%%%...%
m %................................%%%..................%%%................................%
m %%............%....%%............%%%..................%%%............%%....%............%%
m %%..%%%%%.....%............................................................%.....%%%%%..%%
m %%.%%%%%%.....%%..........................................................%%.....%%%%%%.%%
m %%..%%%%%%%%..................................................................%%%%%%%%..%%
m %%....%%%%%%%...%........................................................%...%%%%%%%....%%
m %%%%%c%%%%%%%%..............................................................%%%%%%%%d%%%%%
m %%%%%%%%%%%%%%%%%...%....................%%.%%.%%....................%...%%%%%%%%%%%%%%%%%
m %%%%%%%%%%%%%%%%%%%.%%%........%%........%%%%%%%%........%%........%%%.%%%%%%%%%%%%%%%%%%%
m %%%%%%%%%%%%%%%%%%..%%%%.......%%%.......%%%%%%%%.......%%%.......%%%%..%%%%%%%%%%%%%%%%%%
m %%%%%%%%%%%%%%%%%......%........%%%........%%%%........%%%........%......%%%%%%%%%%%%%%%%%
m %%%%%%%%%%%%%%%%%.....%%.........%%.........%%.........%%.........%%.....%%%%%%%%%%%%%%%%%
m %%%%%%%%%%%.%%%......%%............................................%%......%%%.%%%%%%%%%%%
m %%%%%%%.........%..%%................................................%%..%.........%%%%%%%
m %%%%%%%%..........%%%......................%..%......................%%%..........%%%%%%%%
m %%%%%%............%%%................................................%%%............%%%%%%
m %%%%%.............%%..................................................%%.............%%%%%
m %%%%.......%%%%%..........................................................%%%%%.......%%%%
m %%%%.%...%..%%%%......%%%...................%%...................%%%......%%%%..%...%.%%%%
m %%%%.%%%.%%.%%..%..%%%..%......%%%..........%%..........%%%......%..%%%..%..%%.%%.%%%.%%%%
m %%%%.%%.....%%...%......%.....%%.%%........%%%%........%%.%%.....%......%...%%.....%%.%%%%
m %%..........%.....%....%......%..%%.........%%.........%%..%......%....%.....%..........%%
m %....%%%..........%....%...%%%...%%%.....%..%%..%.....%%%...%%%...%....%..........%%%....%
m %%................%%...%..%%%%...........%..%%..%...........%%%%..%...%%................%%
m %.................%%%%....%%%.....%....................%.....%%%....%%%%.................%
m %.....................%..........%%....................%%..........%.....................%
m %......................%.....%.%%%%%.%..............%.%%%%%.%.....%......................%
m %.......................%%.....%%%%%...%...%%%%...%...%%%%%.....%%.......................%
m %.......................%%....%%%%%%...%%%......%%%...%%%%%%....%%.......................%
m %.....................%%%%....%%%%%%%................%%%%%%%....%%%%.....................%
m %....................%%%%%....%%%%%%%%..............%%%%%%%%....%%%%%....................%
m %...%%...................%.....%%%%%%%%............%%%%%%%%.....%...................%%...%
m %......................%......%%%%%%%%%............%%%%%%%%%......%......................%
m %..%...................%%.....%%%%%%%%%............%%%%%%%%%.....%%...................%..%
m %.%%%.........................%%%%%%%%%%%..%%%%..%%%%%%%%%%%.........................%%%.%
m %%%%%...............%..%....%.%%%%%%%%%%%..%%%%..%%%%%%%%%%%.%....%..%...............%%%%%
m %%%%%...............%.%%....%%%%%%%%%%%%%..%%%%..%%%%%%%%%%%%%....%%.%...............%%%%%
m %%%%%%.....%........%.%%%..%%%%%%%%%c.%%%..%%%%..%%%.d%%%%%%%%%..%%%.%........%.....%%%%%%
m %%%%%%%%%..%..............%%%%%%%%%%%.%%%..%%%%..%%%.%%%%%%%%%%%..............%..%%%%%%%%%
m %%%%%%%%%%............%%%%%%%%%%%%%%%..%....%%....%..%%%%%%%%%%%%%%%............%%%%%%%%%%
m %%%%%%%%%.............%%%%%%%%%%%%%%%.......%%.......%%%%%%%%%%%%%%%.............%%%%%%%%%
m %%%%%%%%...........%.%%%%%%%%%%%%%%%%%%%%%..%%..%%%%%%%%%%%%%%%%%%%%%.%...........%%%%%%%%
m %%%%%%%%%%%%%%%%%%%%%%%%%%%%%%%%%%%%%%%%%%%%%%%%%%%%%%%%%%%%%%%%%%%%%%%%%%%%%%%%%%%%%%%%%%

