players 8
rows 106
cols 106
m %%%%%%%%%%%%%%%%%%%%%%%%%%%%%%%%%%%%%%%%%%%%%%%%%%%%%%%%%%%%%%%%%%%%%%%%%%%%%%%%%%%%%%%%%%%%%%%%%%%%%%%%%%
m %%%%%%%%......%%.....%%%%.....%%%.....%%%%%%%%%%%%%%%%%%%%%%%%%%%%%%.....%%%.....%%%%.....%%......%%%%%%%%
m %%%%%%%%%.............%%...%...%%.....%%.%%%%%%%%%%%%%%%%%%%%%%%%.%%.....%%...%...%%.............%%%%%%%%%
m %%%%%%%%%%%............%.............%%%...%%%%%%%%%%%%%%%%%%%%...%%%.............%............%%%%%%%%%%%
m %%%%%%%%%%....................%......%....%%%%%%%%%%%%%%%%%%%%%%....%......%....................%%%%%%%%%%
m %%%%%%%%%..%..............%.%.................%%%%%%%%%%%%%%.................%.%..............%..%%%%%%%%%
m %%%%%%%%%....................................%%%%%%%%%%%%%%%%....................................%%%%%%%%%
m %%%%%%%%%%%.....................%............%%%.%%%%%%%%.%%%............%.....................%%%%%%%%%%%
m %.%%%%%%%%%......................................%%%%%%%%......................................%%%%%%%%%.%
m %..%%..%%%%......................................%%%%%%%%......................................%%%%..%%..%
m %..%...%%%%%.....................................%%%%%%%%.....................................%%%%%...%..%
m %....%....%......................................%%%%%%%%......................................%....%....%
m %..............%......................%%......%.....%%.....%......%%......................%..............%
m %............%%%%%.............................%....%%....%.............................%%%%%............%
m %%...........%%%%........................................................................%%%%...........%%
m %%..........%%%%%.%a..................%%.......%%........%%.......%%..................a%.%%%%%..........%%
m %............%%%%%%.....................%........................%.....................%%%%%%............%
m %............%..%%%%........%%...................%%....%%...................%%........%%%%..%............%
m %..............%%%%.......%.......................%....%.......................%.......%%%%..............%
m %..............b.%........%..%..............................................%..%........%.c..............%
m %....................%%%..%%%%......................%%......................%%%%..%%%....................%
m %%..................%%%%%%%%%%%.....................%%.....................%%%%%%%%%%%..................%%
m %%%.................%%%%%%%%%%%%....................%%....................%%%%%%%%%%%%.................%%%
m %%%%................%%%%%%%%%%%%....................%%....................%%%%%%%%%%%%................%%%%
m %%...................%%%%%%%%%%%...................%%%%...................%%%%%%%%%%%...................%%
m %....................%%%%%%%%%%%%..................%%%%..................%%%%%%%%%%%%....................%
m %....%............%%%%%%%%%%%%%%%..%.%.............%%%%.............%.%..%%%%%%%%%%%%%%%............%....%
m %.%.................%%%%%%%%%%%%%............%%%%%%%%%%%%%%%%............%%%%%%%%%%%%%.................%.%
m %....%...........%..%%%%%%%%%%%%%%%..%%%.%%..%%%%%%%%%%%%%%%%..%%.%%%..%%%%%%%%%%%%%%%..%...........%....%
m %................%.%%%%%%%%%%%%%%%%%%%%%%%%%%%%%%%%%%%%%%%%%%%%%%%%%%%%%%%%%%%%%%%%%%%%.%................%
m %%..%................%%%%%%%%%%%%%%%%%%%%%%%%%%%%%%%%%%%%%%%%%%%%%%%%%%%%%%%%%%%%%%%%................%..%%
m %%%...................%%%%%%%%%%%%%%%%%%%%%%%%%%%%%%%%%%%%%%%%%%%%%%%%%%%%%%%%%%%%%%...................%%%
m %%%....%.................%%%%%%%%%%%%%%%%%%%%%%%%%%%%%%%%%%%%%%%%%%%%%%%%%%%%%%%%.................%....%%%
m %...........................%%%%%%%%%%%%%%%%%%%%%%%%%%%%%%%%%%%%%%%%%%%%%%%%%%...........................%
m %...........................%%%%%%%%%%%%%%%%%%%%%%%%%%%%%%%%%%%%%%%%%%%%%%%%%%...........................%
m %.........................%..%%%%%%%%%%%%%%%%%%%%%%%%%%%%%%%%%%%%%%%%%%%%%%%%..%.........................%
m %............................%%%%%%%%%%%%%%%%%%%%%%%%%%%%%%%%%%%%%%%%%%%%%%%%............................%
m %..%%.....................%.%%%%%%%%%%%%%%%%%%%%%%%%%%%%%%%%%%%%%%%%%%%%%%%%%%.%.....................%%..%
m %%%%........%..%............%%%%%%%%%%%%%%%%%%%%%%%%%%%%%%%%%%%%%%%%%%%%%%%%%%............%..%........%%%%
m %%%%........%..%............%%%%%%%%%%%%%%%%%%%%%%%%%%%%%%%%%%%%%%%%%%%%%%%%%%............%..%........%%%%
m %%..............%............%%%%%%%%%%%%%%%%%%%%%%%%%%%%%%%%%%%%%%%%%%%%%%%%............%..............%%
m %%%.........................%%%%%%%%%%%%%%%%%%%%%%%%%%%%%%%%%%%%%%%%%%%%%%%%%%.........................%%%
m %%%.%.......................%%%%%%%%%%%%%%%%%%%%%%%%%%%%%%%%%%%%%%%%%%%%%%%%%%.......................%.%%%
m %%%%%........................%%%%%%%%%%%%%%%%%%%%%%%%%%%%%%%%%%%%%%%%%%%%%%%%........................%%%%%
m %%%%%........................%%%%%%%%%%%%%%%%%%%%%%%%%%%%%%%%%%%%%%%%%%%%%%%%........................%%%%%
m %%%%%.%%...................%%%%%%%%%%%%%%%%%%%%%%%%%%%%%%%%%%%%%%%%%%%%%%%%%%%%...................%%.%%%%%
m %%%%%%%%....%..............%%%%%%%%%%%%%%%%%%%%%%%%%%%%%%%%%%%%%%%%%%%%%%%%%%%%..............%....%%%%%%%%
m %%%%%%%%.....%.%...........%%%%%%%%%%%%%%%%%%%%%%%%%%%%%%%%%%%%%%%%%%%%%%%%%%%%...........%.%.....%%%%%%%%
m %%%%%%%........%...........%%%%%%%%%%%%%%%%%%%%%%%%%%%%%%%%%%%%%%%%%%%%%%%%%%%%...........%........%%%%%%%
m %%%%%%%%%%%%.....%.........%%%%%%%%%%%%%%%%%%%%%%%%%%%%%%%%%%%%%%%%%%%%%%%%%%%%.........%.....%%%%%%%%%%%%
m %%%%%%%%%%%%.....%%........%%%%%%%%%%%%%%%%%%%%%%%%%%%%%%%%%%%%%%%%%%%%%%%%%%%%........%%.....%%%%%%%%%%%%
m %%%%%%%%%%%%............%%%%%%%%%%%%%%%%%%%%%%%%%%%%%%%%%%%%%%%%%%%%%%%%%%%%%%%%%%............%%%%%%%%%%%%
m %%%%%%%%%%%%%%......%%%%%%%%%%%%%%%%%%%%%%%%%%%%%%%%%%%%%%%%%%%%%%%%%%%%%%%%%%%%%%%%%%......%%%%%%%%%%%%%%
m %%%%%%%%%%%%%%......%%%%%%%%%%%%%%%%%%%%%%%%%%%%%%%%%%%%%%%%%%%%%%%%%%%%%%%%%%%%%%%%%%......%%%%%%%%%%%%%%
m %%%%%%%%%%%%............%%%%%%%%%%%%%%%%%%%%%%%%%%%%%%%%%%%%%%%%%%%%%%%%%%%%%%%%%%............%%%%%%%%%%%%
m %%%%%%%%%%%%.....%%........%%%%%%%%%%%%%%%%%%%%%%%%%%%%%%%%%%%%%%%%%%%%%%%%%%%%........%%.....%%%%%%%%%%%%
m %%%%%%%%%%%%.....%.........%%%%%%%%%%%%%%%%%%%%%%%%%%%%%%%%%%%%%%%%%%%%%%%%%%%%.........%.....%%%%%%%%%%%%
m %%%%%%%........%...........%%%%%%%%%%%%%%%%%%%%%%%%%%%%%%%%%%%%%%%%%%%%%%%%%%%%...........%........%%%%%%%
m %%%%%%%%.....%.%...........%%%%%%%%%%%%%%%%%%%%%%%%%%%%%%%%%%%%%%%%%%%%%%%%%%%%...........%.%.....%%%%%%%%
m %%%%%%%%....%..............%%%%%%%%%%%%%%%%%%%%%%%%%%%%%%%%%%%%%%%%%%%%%%%%%%%%..............%....%%%%%%%%
m %%%%%.%%...................%%%%%%%%%%%%%%%%%%%%%%%%%%%%%%%%%%%%%%%%%%%%%%%%%%%%...................%%.%%%%%
m %%%%%........................%%%%%%%%%%%%%%%%%%%%%%%%%%%%%%%%%%%%%%%%%%%%%%%%........................%%%%%
m %%%%%........................%%%%%%%%%%%%%%%%%%%%%%%%%%%%%%%%%%%%%%%%%%%%%%%%........................%%%%%
m %%%.%.......................%%%%%%%%%%%%%%%%%%%%%%%%%%%%%%%%%%%%%%%%%%%%%%%%%%.......................%.%%%
m %%%.........................%%%%%%%%%%%%%%%%%%%%%%%%%%%%%%%%%%%%%%%%%%%%%%%%%%.........................%%%
m %%..............%............%%%%%%%%%%%%%%%%%%%%%%%%%%%%%%%%%%%%%%%%%%%%%%%%............%..............%%
m %%%%........%..%............%%%%%%%%%%%%%%%%%%%%%%%%%%%%%%%%%%%%%%%%%%%%%%%%%%............%..%........%%%%
m %%%%........%..%............%%%%%%%%%%%%%%%%%%%%%%%%%%%%%%%%%%%%%%%%%%%%%%%%%%............%..%........%%%%
m %..%%.....................%.%%%%%%%%%%%%%%%%%%%%%%%%%%%%%%%%%%%%%%%%%%%%%%%%%%.%.....................%%..%
m %............................%%%%%%%%%%%%%%%%%%%%%%%%%%%%%%%%%%%%%%%%%%%%%%%%............................%
m %.........................%..%%%%%%%%%%%%%%%%%%%%%%%%%%%%%%%%%%%%%%%%%%%%%%%%..%.........................%
m %...........................%%%%%%%%%%%%%%%%%%%%%%%%%%%%%%%%%%%%%%%%%%%%%%%%%%...........................%
m %...........................%%%%%%%%%%%%%%%%%%%%%%%%%%%%%%%%%%%%%%%%%%%%%%%%%%...........................%
m %%%....%.................%%%%%%%%%%%%%%%%%%%%%%%%%%%%%%%%%%%%%%%%%%%%%%%%%%%%%%%%.................%....%%%
m %%%...................%%%%%%%%%%%%%%%%%%%%%%%%%%%%%%%%%%%%%%%%%%%%%%%%%%%%%%%%%%%%%%...................%%%
m %%..%................%%%%%%%%%%%%%%%%%%%%%%%%%%%%%%%%%%%%%%%%%%%%%%%%%%%%%%%%%%%%%%%%................%..%%
m %................%.%%%%%%%%%%%%%%%%%%%%%%%%%%%%%%%%%%%%%%%%%%%%%%%%%%%%%%%%%%%%%%%%%%%%.%................%
m %....%...........%..%%%%%%%%%%%%%%%..%%%.%%..%%%%%%%%%%%%%%%%..%%.%%%..%%%%%%%%%%%%%%%..%...........%....%
m %.%.................%%%%%%%%%%%%%............%%%%%%%%%%%%%%%%............%%%%%%%%%%%%%.................%.%
m %....%............%%%%%%%%%%%%%%%..%.%.............%%%%.............%.%..%%%%%%%%%%%%%%%............%....%
m %....................%%%%%%%%%%%%..................%%%%..................%%%%%%%%%%%%....................%
m %%...................%%%%%%%%%%%...................%%%%...................%%%%%%%%%%%...................%%
m %%%%................%%%%%%%%%%%%....................%%....................%%%%%%%%%%%%................%%%%
m %%%.................%%%%%%%%%%%%....................%%....................%%%%%%%%%%%%.................%%%
m %%..................%%%%%%%%%%%.....................%%.....................%%%%%%%%%%%..................%%
m %....................%%%..%%%%......................%%......................%%%%..%%%....................%
m %..............b.%........%..%..............................................%..%........%.c..............%
m %..............%%%%.......%.......................%....%.......................%.......%%%%..............%
m %............%..%%%%........%%...................%%....%%...................%%........%%%%..%............%
m %............%%%%%%.....................%........................%.....................%%%%%%............%
m %%..........%%%%%.%d..................%%.......%%........%%.......%%..................d%.%%%%%..........%%
m %%...........%%%%........................................................................%%%%...........%%
m %............%%%%%.............................%....%%....%.............................%%%%%............%
m %..............%......................%%......%.....%%.....%......%%......................%..............%
m %....%....%......................................%%%%%%%%......................................%....%....%
m %..%...%%%%%.....................................%%%%%%%%.....................................%%%%%...%..%
m %..%%..%%%%......................................%%%%%%%%......................................%%%%..%%..%
m %.%%%%%%%%%......................................%%%%%%%%......................................%%%%%%%%%.%
m %%%%%%%%%%%.....................%............%%%.%%%%%%%%.%%%............%.....................%%%%%%%%%%%
m %%%%%%%%%....................................%%%%%%%%%%%%%%%%....................................%%%%%%%%%
m %%%%%%%%%..%..............%.%.................%%%%%%%%%%%%%%.................%.%..............%..%%%%%%%%%
m %%%%%%%%%%....................%......%....%%%%%%%%%%%%%%%%%%%%%%....%......%....................%%%%%%%%%%
m %%%%%%%%%%%............%.............%%%...%%%%%%%%%%%%%%%%%%%%...%%%.............%............%%%%%%%%%%%
m %%%%%%%%%.............%%...%...%%.....%%.%%%%%%%%%%%%%%%%%%%%%%%%.%%.....%%...%...%%.............%%%%%%%%%
m %%%%%%%%......%%.....%%%%.....%%%.....%%%%%%%%%%%%%%%%%%%%%%%%%%%%%%.....%%%.....%%%%.....%%......%%%%%%%%
m %%%%%%%%%%%%%%%%%%%%%%%%%%%%%%%%%%%%%%%%%%%%%%%%%%%%%%%%%%%%%%%%%%%%%%%%%%%%%%%%%%%%%%%%%%%%%%%%%%%%%%%%%%

