players 8
rows 80
cols 80
m %%%%%%%%%%%%%%%%%%%%%%%%%%%%%%%%%%%%%%%%%%%%%%%%%%%%%%%%%%%%%%%%%%%%%%%%%%%%%%%%
m %.......................%%.....%%%%%%%%%%%%%%%%%%.....%%.......................%
m %...............................%%%%%%%%%%%%%%%%...............................%
m %...........................%%.%%%%%%%%%%%%%%%%%%.%%...........................%
m %............................%%%%%%%%%%%%%%%%%%%%%%............................%
m %............................%%%%%%%%%%%%%%%%%%%%%%............................%
m %...................a........%%%%%%%%%%%%%%%%%%%%%%........a...................%
m %.........................%%%%%%%%%%%%%%%%%%%%%%%%%%%%.........................%
m %........................%%%%%%%%%%%%%%%%%%%%%%%%%%%%%%........................%
m %........................%%%%%%%%%%%%%%%%%%%%%%%%%%%%%%........................%
m %....................%....%%%%%%%%%%%%%%%%%%%%%%%%%%%%....%....................%
m %............%............%%%%%%%%%%%%%%%%%%%%%%%%%%%%............%............%
m %...............%%%.%%%%....%%%%%%%%%%%%%%%%%%%%%%%%....%%%%.%%%...............%
m %..........%...%..%..%%%%..%%%%%%%%%%%%%%%%%%%%%%%%%%..%%%%..%..%...%..........%
m %........................%%%%%%%%%%%%%%%%%%%%%%%%%%%%%%........................%
m %............%...........%%%%%%%%%%%%%%%%%%%%%%%%%%%%%%...........%............%
m %...........%.............%%%.%%%..%%%%%%%%%%..%%%.%%%.............%...........%
m %...........%.....%%%.....%%%..%%..%%%%%%%%%%..%%..%%%.....%%%.....%...........%
m %...........%%...%.............%...%%%%%%%%%%...%.............%...%%...........%
m %................%..................%%%%%%%%..................%................%
m %.....a.....%....%.............%....%%%%%%%%....%.............%....%.....a.....%
m %.........%.%%......................%%%%%%%%......................%%.%.........%
m %...........%%................%.%.....%%%%.....%.%................%%...........%
m %...........%%.........................%%.........................%%...........%
m %%...........%......................%%....%%......................%...........%%
m %%......%%....%%....................%%%..%%%....................%%....%%......%%
m %......%%%%%..%%%%..................%%....%%..................%%%%..%%%%%......%
m %......%%%%%.%%%%%................%%%%.%%.%%%%................%%%%%.%%%%%......%
m %..%...%%%%%%%%%%%.................%%..%%..%%.................%%%%%%%%%%%...%..%
m %..%%%%%%%%%%%%%...................%%.%%%%.%%...................%%%%%%%%%%%%%..%
m %...%%%%%%%%%%%%%.....%................%%................%.....%%%%%%%%%%%%%...%
m %%.%%%%%%%%%%%%%%%%.%......................................%.%%%%%%%%%%%%%%%%.%%
m %%%%%%%%%%%%%%%%%%....%.........%%...%.%%.%...%%.........%....%%%%%%%%%%%%%%%%%%
m %%%%%%%%%%%%%%%%................%%.....%%.....%%................%%%%%%%%%%%%%%%%
m %%%%%%%%%%%%%%%%...........%......%..........%......%...........%%%%%%%%%%%%%%%%
m %%%%%%%%%%%%%%%%%%%........%%%.....%%......%%.....%%%........%%%%%%%%%%%%%%%%%%%
m %%%%%%%%%%%%%%%%%%%%%%..%%%%%%.....%........%.....%%%%%%..%%%%%%%%%%%%%%%%%%%%%%
m %%%%%%%%%%%%%%%%%%%%%%..%%%%....%.....%%%%.....%....%%%%..%%%%%%%%%%%%%%%%%%%%%%
m %%%%%%%%%%%%%%%%%%%%%%%..%...%.......%%%%%%.......%...%..%%%%%%%%%%%%%%%%%%%%%%%
m %%%%%%%%%%%%%%%%%%%%%%%%...%%%%.%%...%%%%%%...%%.%%%%...%%%%%%%%%%%%%%%%%%%%%%%%
m %%%%%%%%%%%%%%%%%%%%%%%%...%%%%.%%...%%%%%%...%%.%%%%...%%%%%%%%%%%%%%%%%%%%%%%%
m %%%%%%%%%%%%%%%%%%%%%%%..%...%.......%%%%%%.......%...%..%%%%%%%%%%%%%%%%%%%%%%%
m %%%%%%%%%%%%%%%%%%%%%%..%%%%....%.....%%%%.....%....%%%%..%%%%%%%%%%%%%%%%%%%%%%
m %%%%%%%%%%%%%%%%%%%%%%..%%%%%%.....%........%.....%%%%%%..%%%%%%%%%%%%%%%%%%%%%%
m %%%%%%%%%%%%%%%%%%%........%%%.....%%......%%.....%%%........%%%%%%%%%%%%%%%%%%%
m %%%%%%%%%%%%%%%%...........%......%..........%......%...........%%%%%%%%%%%%%%%%
m %%%%%%%%%%%%%%%%................%%.....%%.....%%................%%%%%%%%%%%%%%%%
m %%%%%%%%%%%%%%%%%%....%.........%%...%.%%.%...%%.........%....%%%%%%%%%%%%%%%%%%
m %%.%%%%%%%%%%%%%%%%.%......................................%.%%%%%%%%%%%%%%%%.%%
m %...%%%%%%%%%%%%%.....%................%%................%.....%%%%%%%%%%%%%...%
m %..%%%%%%%%%%%%%...................%%.%%%%.%%...................%%%%%%%%%%%%%..%
m %..%...%%%%%%%%%%%.................%%..%%..%%.................%%%%%%%%%%%...%..%
m %......%%%%%.%%%%%................%%%%.%%.%%%%................%%%%%.%%%%%......%
m %......%%%%%..%%%%..................%%....%%..................%%%%..%%%%%......%
m %%......%%....%%....................%%%..%%%....................%%....%%......%%
m %%...........%......................%%....%%......................%...........%%
m %...........%%.........................%%.........................%%...........%
m %...........%%................%.%.....%%%%.....%.%................%%...........%
m %.........%.%%......................%%%%%%%%......................%%.%.........%
m %.....b.....%....%.............%....%%%%%%%%....%.............%....%.....b.....%
m %................%..................%%%%%%%%..................%................%
m %...........%%...%.............%...%%%%%%%%%%...%.............%...%%...........%
m %...........%.....%%%.....%%%..%%..%%%%%%%%%%..%%..%%%.....%%%.....%...........%
m %...........%.............%%%.%%%..%%%%%%%%%%..%%%.%%%.............%...........%
m %............%...........%%%%%%%%%%%%%%%%%%%%%%%%%%%%%%...........%............%
m %........................%%%%%%%%%%%%%%%%%%%%%%%%%%%%%%........................%
m %..........%...%..%..%%%%..%%%%%%%%%%%%%%%%%%%%%%%%%%..%%%%..%..%...%..........%
m %...............%%%.%%%%....%%%%%%%%%%%%%%%%%%%%%%%%....%%%%.%%%...............%
m %............%............%%%%%%%%%%%%%%%%%%%%%%%%%%%%............%............%
m %....................%....%%%%%%%%%%%%%%%%%%%%%%%%%%%%....%....................%
m %........................%%%%%%%%%%%%%%%%%%%%%%%%%%%%%%........................%
m %........................%%%%%%%%%%%%%%%%%%%%%%%%%%%%%%........................%
m %.........................%%%%%%%%%%%%%%%%%%%%%%%%%%%%.........................%
m %...................b........%%%%%%%%%%%%%%%%%%%%%%........b...................%
m %............................%%%%%%%%%%%%%%%%%%%%%%............................%
m %............................%%%%%%%%%%%%%%%%%%%%%%............................%
m %...........................%%.%%%%%%%%%%%%%%%%%%.%%...........................%
m %...............................%%%%%%%%%%%%%%%%...............................%
m %.......................%%.....%%%%%%%%%%%%%%%%%%.....%%.......................%
m %%%%%%%%%%%%%%%%%%%%%%%%%%%%%%%%%%%%%%%%%%%%%%%%%%%%%%%%%%%%%%%%%%%%%%%%%%%%%%%%

