players 4
rows 116
cols 116
m %%%%%%%%%%%%%%%%%%%%%%%%%%%%%%%%%%%%%%%%%%%%%%%%%%%%%%%%%%%%%%%%%%%%%%%%%%%%%%%%%%%%%%%%%%%%%%%%%%%%%%%%%%%%%%%%%%%%
m %%%%%%%%%%%%%%%.......%%%%....%%%%%%.%.%%%%%%%%%%%%%%%%%%%%%%%%%%%%%%%%%%%%%%.%.%%%%%%....%%%%.......%%%%%%%%%%%%%%%
m %%%%%%%%%%%%%%%........%%%......%.%%...%..%%%%%%%%%%%%%%%%%%%%%%%%%%%%%%%%..%...%%.%......%%%........%%%%%%%%%%%%%%%
m %%%%%%%%%%%%%%.........%%%.............%..%%%%%%%%%%%%%%%%%%%%%%%%%%%%%%%%..%.............%%%.........%%%%%%%%%%%%%%
m %%%%%%%%%%%%%%........%%%%.............%..%..%%%%%%%%%%%%%%%%%%%%%%%%%%..%..%.............%%%%........%%%%%%%%%%%%%%
m %%%%%%%%%%%%%.%%%......%%%................%..%%%%%..%%%%%%%%%%%%..%%%%%..%................%%%......%%%.%%%%%%%%%%%%%
m %%%%%%%%%%%%%..%..%%%%....................%..%%%%%....%%%%%%%%....%%%%%..%....................%%%%..%..%%%%%%%%%%%%%
m %%%%%%%%%%%%.......%%%%%.....%...............%%....%...%%%%%%...%....%%...............%.....%%%%%.......%%%%%%%%%%%%
m %%%%%%%%%%%%........%%%%.................%..%%%....%...%%%%%%...%....%%%..%.................%%%%........%%%%%%%%%%%%
m %%%%%%%%%%%%....%%..%.%.....................%.........%%%%%%%%.........%.....................%.%..%%....%%%%%%%%%%%%
m %%%%%%%%%%%.....%%%.%..............................%%%%%%%%%%%%%%..............................%.%%%.....%%%%%%%%%%%
m %%%%%%%%%%.%%%%%%%%.%..................%..............%%%%%%%%..............%..................%.%%%%%%%%.%%%%%%%%%%
m %%%%%%%....%%%%%%%%...%%...............................%%%%%%...............................%%...%%%%%%%%....%%%%%%%
m %%%%%......%%%%%%%%%%%%%%%%.......................%%%...%%%%...%%%.......................%%%%%%%%%%%%%%%%......%%%%%
m %%%..%.....%%%%%%%%%%%%%%%%......................%%%%.%%%%%%%%.%%%%......................%%%%%%%%%%%%%%%%.....%..%%%
m %....%%....%%%%%%%%%%%%%%%........................%%..%%%%%%%%..%%........................%%%%%%%%%%%%%%%....%%....%
m %....%...%%%%%%%%%%%%%%%%%.................%.......%.%%%%%%%%%%.%.......%.................%%%%%%%%%%%%%%%%%...%....%
m %........%%%%%%%%%%%%%%%%%.........%..............%..%%%%%%%%%%..%..............%.........%%%%%%%%%%%%%%%%%........%
m %.....%...%%%%%%%%%%%%%%%%.........%.........%........%%%%%%%%........%.........%.........%%%%%%%%%%%%%%%%...%.....%
m %.....%%.....%%%%%%%%%%%%%...........%%%.%...%........%%%%%%%%........%...%.%%%...........%%%%%%%%%%%%%.....%%.....%
m %.....%%%%%%.%%%%%%%%%%%%%%...%.......%%%%...%.....%...%%%%%%...%.....%...%%%%.......%...%%%%%%%%%%%%%%.%%%%%%.....%
m %.....%%%....%%%%%%%%%%%%%%...%%.....%%%%%%%..%%..%%%%%%%%%%%%%%%%..%%..%%%%%%%.....%%...%%%%%%%%%%%%%%....%%%.....%
m %%..%..%%%..%%%%%%%%%%%%%%%....%..%.%%%%%%%%%....%%%%%%%%%%%%%%%%%%....%%%%%%%%%.%..%....%%%%%%%%%%%%%%%..%%%..%..%%
m %%%%%%.%%...%%%%%%%%%%%%%...%..%%.%%%%%%%%%%%%.......%%%%%%%%%%.......%%%%%%%%%%%%.%%..%...%%%%%%%%%%%%%...%%.%%%%%%
m %%%%%%.......%%%%%%%%%%%..........%%%%%%%%%%%%%%.....%%%%%%%%%%.....%%%%%%%%%%%%%%..........%%%%%%%%%%%.......%%%%%%
m %%%%%%.......%%%%%%%%%%.........%%%%%%%%%%%%%%.......%%%%%%%%%%.......%%%%%%%%%%%%%%.........%%%%%%%%%%.......%%%%%%
m %............%%.....%%%.......%%%%%%%%%%%%%%%%.......%%%%%%%%%%.......%%%%%%%%%%%%%%%%.......%%%.....%%............%
m %.............................%%%%..%%%%%%%%%......%%%%%%%%%%%%%%......%%%%%%%%%..%%%%.............................%
m %......................%....%%%%%%..%%.........%%..%%%%%%%%%%%%%%..%%.........%%..%%%%%%....%......................%
m %......%....................%%%%%%..%%%........%%%%%%%%%%%%%%%%%%%%%%........%%%..%%%%%%....................%......%
m %%..................%%....%%%%.................%%%%.%%%%%%%%%%%%.%%%%.................%%%%....%%..................%%
m %%...................%%%..%%%%........a..........%..%%%%%%%%%%%%..%..........b........%%%%..%%%...................%%
m %%%....................%.%%%%%...................%....%%%%%%%%....%...................%%%%%.%....................%%%
m %%.......................%%%%%...................%.%...%%%%%%...%.%...................%%%%%.......................%%
m %%%...................%%%%%............................%%%%%%............................%%%%%...................%%%
m %%%..............%%....%%%%................%.........%%%%%%%%%%.........%................%%%%....%%..............%%%
m %.....................%%%%%%%%...........%%%...%.%%%..%%%%%%%%..%%%.%...%%%...........%%%%%%%%.....................%
m %%.................%.%%%%%%%%%...........%%%.....%.%..%%%%%%%%..%.%.....%%%...........%%%%%%%%%.%.................%%
m %..................%%%%%%%%%.%.c.........%%%...........%%%%%%...........%%%.........c.%.%%%%%%%%%..................%
m %%%%%......%.......%%%%%%%%%...........%%%%%%%..%......%%%%%%......%..%%%%%%%...........%%%%%%%%%.......%......%%%%%
m %%..................%%%%%%%%...........%%%%%%%%%%...%%.%%%%%%.%%...%%%%%%%%%%...........%%%%%%%%..................%%
m %%......%..........%%%%%%%%%........%%%%%%%%%%%%%....%........%....%%%%%%%%%%%%%........%%%%%%%%%..........%......%%
m %%%%%%%..............%%%%%%%........%%%%%%%%%%%%%..................%%%%%%%%%%%%%........%%%%%%%..............%%%%%%%
m %%%%............%....%%%%%%%.......%%%%%%%%%%%%......................%%%%%%%%%%%%.......%%%%%%%....%............%%%%
m %%%%....%%............%%%%%%...........%%%%%.........%........%.........%%%%%...........%%%%%%............%%....%%%%
m %%%%%%%%%.........%%%..%%%%............%%%%%............................%%%%%............%%%%..%%%.........%%%%%%%%%
m %%%%%%%%%............%..%...............%%%%.............%%.............%%%%...............%..%............%%%%%%%%%
m %%%%%%%..............%..%...%%%.....%...%%%..............................%%%...%.....%%%...%..%..............%%%%%%%
m %%%%%%%.....................%%%........%%%%..............................%%%%........%%%.....................%%%%%%%
m %%%%%%%.......%.......%......%%%%%..%%........................................%%..%%%%%......%.......%.......%%%%%%%
m %%%%%........%%%.%...%%......%%.....%....................%%....................%.....%%......%%...%.%%%........%%%%%
m %%%%%..%%.%..%%%%...%%%....%%%...%..%%........................................%%..%...%%%....%%%...%%%%..%.%%..%%%%%
m %%%%%%....%..%%......%%....%%%%%........%..................................%........%%%%%....%%......%%..%....%%%%%%
m %%%%%%....%.....%%...%%%%%%%%%%%...%....%%..%..........................%..%%....%...%%%%%%%%%%%...%%.....%....%%%%%%
m %%%%%%%..%%%..%%%%%%.%%%%%%%%%%%%..%%%................%......%................%%%..%%%%%%%%%%%%.%%%%%%..%%%..%%%%%%%
m %%%%%%%%%%%%%.%%%%%%%%%%%%%%%%%%%%%%%%%%%..................................%%%%%%%%%%%%%%%%%%%%%%%%%%%.%%%%%%%%%%%%%
m %%%%%%%%%%%%%%%%%%%%%%%%%%%%%%%%%%%%%%%%%..................................%%%%%%%%%%%%%%%%%%%%%%%%%%%%%%%%%%%%%%%%%
m %%%%%%%%%%%%%%%%%%%%%%%%%%%%%%%%%%%%%%%%%.....%...%......%%......%...%.....%%%%%%%%%%%%%%%%%%%%%%%%%%%%%%%%%%%%%%%%%
m %%%%%%%%%%%%%%%%%%%%%%%%%%%%%%%%%%%%%%%%%.....%...%......%%......%...%.....%%%%%%%%%%%%%%%%%%%%%%%%%%%%%%%%%%%%%%%%%
m %%%%%%%%%%%%%%%%%%%%%%%%%%%%%%%%%%%%%%%%%..................................%%%%%%%%%%%%%%%%%%%%%%%%%%%%%%%%%%%%%%%%%
m %%%%%%%%%%%%%.%%%%%%%%%%%%%%%%%%%%%%%%%%%..................................%%%%%%%%%%%%%%%%%%%%%%%%%%%.%%%%%%%%%%%%%
m %%%%%%%..%%%..%%%%%%.%%%%%%%%%%%%..%%%................%......%................%%%..%%%%%%%%%%%%.%%%%%%..%%%..%%%%%%%
m %%%%%%....%.....%%...%%%%%%%%%%%...%....%%..%..........................%..%%....%...%%%%%%%%%%%...%%.....%....%%%%%%
m %%%%%%....%..%%......%%....%%%%%........%..................................%........%%%%%....%%......%%..%....%%%%%%
m %%%%%..%%.%..%%%%...%%%....%%%...%..%%........................................%%..%...%%%....%%%...%%%%..%.%%..%%%%%
m %%%%%........%%%.%...%%......%%.....%....................%%....................%.....%%......%%...%.%%%........%%%%%
m %%%%%%%.......%.......%......%%%%%..%%........................................%%..%%%%%......%.......%.......%%%%%%%
m %%%%%%%.....................%%%........%%%%..............................%%%%........%%%.....................%%%%%%%
m %%%%%%%..............%..%...%%%.....%...%%%..............................%%%...%.....%%%...%..%..............%%%%%%%
m %%%%%%%%%............%..%...............%%%%.............%%.............%%%%...............%..%............%%%%%%%%%
m %%%%%%%%%.........%%%..%%%%............%%%%%............................%%%%%............%%%%..%%%.........%%%%%%%%%
m %%%%....%%............%%%%%%...........%%%%%.........%........%.........%%%%%...........%%%%%%............%%....%%%%
m %%%%............%....%%%%%%%.......%%%%%%%%%%%%......................%%%%%%%%%%%%.......%%%%%%%....%............%%%%
m %%%%%%%..............%%%%%%%........%%%%%%%%%%%%%..................%%%%%%%%%%%%%........%%%%%%%..............%%%%%%%
m %%......%..........%%%%%%%%%........%%%%%%%%%%%%%....%........%....%%%%%%%%%%%%%........%%%%%%%%%..........%......%%
m %%..................%%%%%%%%...........%%%%%%%%%%...%%.%%%%%%.%%...%%%%%%%%%%...........%%%%%%%%..................%%
m %%%%%......%.......%%%%%%%%%...........%%%%%%%..%......%%%%%%......%..%%%%%%%...........%%%%%%%%%.......%......%%%%%
m %..................%%%%%%%%%.%.d.........%%%...........%%%%%%...........%%%.........d.%.%%%%%%%%%..................%
m %%.................%.%%%%%%%%%...........%%%.....%.%..%%%%%%%%..%.%.....%%%...........%%%%%%%%%.%.................%%
m %.....................%%%%%%%%...........%%%...%.%%%..%%%%%%%%..%%%.%...%%%...........%%%%%%%%.....................%
m %%%..............%%....%%%%................%.........%%%%%%%%%%.........%................%%%%....%%..............%%%
m %%%...................%%%%%............................%%%%%%............................%%%%%...................%%%
m %%.......................%%%%%...................%.%...%%%%%%...%.%...................%%%%%.......................%%
m %%%....................%.%%%%%...................%....%%%%%%%%....%...................%%%%%.%....................%%%
m %%...................%%%..%%%%........a..........%..%%%%%%%%%%%%..%..........b........%%%%..%%%...................%%
m %%..................%%....%%%%.................%%%%.%%%%%%%%%%%%.%%%%.................%%%%....%%..................%%
m %......%....................%%%%%%..%%%........%%%%%%%%%%%%%%%%%%%%%%........%%%..%%%%%%....................%......%
m %......................%....%%%%%%..%%.........%%..%%%%%%%%%%%%%%..%%.........%%..%%%%%%....%......................%
m %.............................%%%%..%%%%%%%%%......%%%%%%%%%%%%%%......%%%%%%%%%..%%%%.............................%
m %............%%.....%%%.......%%%%%%%%%%%%%%%%.......%%%%%%%%%%.......%%%%%%%%%%%%%%%%.......%%%.....%%............%
m %%%%%%.......%%%%%%%%%%.........%%%%%%%%%%%%%%.......%%%%%%%%%%.......%%%%%%%%%%%%%%.........%%%%%%%%%%.......%%%%%%
m %%%%%%.......%%%%%%%%%%%..........%%%%%%%%%%%%%%.....%%%%%%%%%%.....%%%%%%%%%%%%%%..........%%%%%%%%%%%.......%%%%%%
m %%%%%%.%%...%%%%%%%%%%%%%...%..%%.%%%%%%%%%%%%.......%%%%%%%%%%.......%%%%%%%%%%%%.%%..%...%%%%%%%%%%%%%...%%.%%%%%%
m %%..%..%%%..%%%%%%%%%%%%%%%....%..%.%%%%%%%%%....%%%%%%%%%%%%%%%%%%....%%%%%%%%%.%..%....%%%%%%%%%%%%%%%..%%%..%..%%
m %.....%%%....%%%%%%%%%%%%%%...%%.....%%%%%%%..%%..%%%%%%%%%%%%%%%%..%%..%%%%%%%.....%%...%%%%%%%%%%%%%%....%%%.....%
m %.....%%%%%%.%%%%%%%%%%%%%%...%.......%%%%...%.....%...%%%%%%...%.....%...%%%%.......%...%%%%%%%%%%%%%%.%%%%%%.....%
m %.....%%.....%%%%%%%%%%%%%...........%%%.%...%........%%%%%%%%........%...%.%%%...........%%%%%%%%%%%%%.....%%.....%
m %.....%...%%%%%%%%%%%%%%%%.........%.........%........%%%%%%%%........%.........%.........%%%%%%%%%%%%%%%%...%.....%
m %........%%%%%%%%%%%%%%%%%.........%..............%..%%%%%%%%%%..%..............%.........%%%%%%%%%%%%%%%%%........%
m %....%...%%%%%%%%%%%%%%%%%.................%.......%.%%%%%%%%%%.%.......%.................%%%%%%%%%%%%%%%%%...%....%
m %....%%....%%%%%%%%%%%%%%%........................%%..%%%%%%%%..%%........................%%%%%%%%%%%%%%%....%%....%
m %%%..%.....%%%%%%%%%%%%%%%%......................%%%%.%%%%%%%%.%%%%......................%%%%%%%%%%%%%%%%.....%..%%%
m %%%%%......%%%%%%%%%%%%%%%%.......................%%%...%%%%...%%%.......................%%%%%%%%%%%%%%%%......%%%%%
m %%%%%%%....%%%%%%%%...%%...............................%%%%%%...............................%%...%%%%%%%%....%%%%%%%
m %%%%%%%%%%.%%%%%%%%.%..................%..............%%%%%%%%..............%..................%.%%%%%%%%.%%%%%%%%%%
m %%%%%%%%%%%.....%%%.%..............................%%%%%%%%%%%%%%..............................%.%%%.....%%%%%%%%%%%
m %%%%%%%%%%%%....%%..%.%.....................%.........%%%%%%%%.........%.....................%.%..%%....%%%%%%%%%%%%
m %%%%%%%%%%%%........%%%%.................%..%%%....%...%%%%%%...%....%%%..%.................%%%%........%%%%%%%%%%%%
m %%%%%%%%%%%%.......%%%%%.....%...............%%....%...%%%%%%...%....%%...............%.....%%%%%.......%%%%%%%%%%%%
m %%%%%%%%%%%%%..%..%%%%....................%..%%%%%....%%%%%%%%....%%%%%..%....................%%%%..%..%%%%%%%%%%%%%
m %%%%%%%%%%%%%.%%%......%%%................%..%%%%%..%%%%%%%%%%%%..%%%%%..%................%%%......%%%.%%%%%%%%%%%%%
m %%%%%%%%%%%%%%........%%%%.............%..%..%%%%%%%%%%%%%%%%%%%%%%%%%%..%..%.............%%%%........%%%%%%%%%%%%%%
m %%%%%%%%%%%%%%.........%%%.............%..%%%%%%%%%%%%%%%%%%%%%%%%%%%%%%%%..%.............%%%.........%%%%%%%%%%%%%%
m %%%%%%%%%%%%%%%........%%%......%.%%...%..%%%%%%%%%%%%%%%%%%%%%%%%%%%%%%%%..%...%%.%......%%%........%%%%%%%%%%%%%%%
m %%%%%%%%%%%%%%%.......%%%%....%%%%%%.%.%%%%%%%%%%%%%%%%%%%%%%%%%%%%%%%%%%%%%%.%.%%%%%%....%%%%.......%%%%%%%%%%%%%%%
m %%%%%%%%%%%%%%%%%%%%%%%%%%%%%%%%%%%%%%%%%%%%%%%%%%%%%%%%%%%%%%%%%%%%%%%%%%%%%%%%%%%%%%%%%%%%%%%%%%%%%%%%%%%%%%%%%%%%

