# map type: blank
# random seed: 108591826
# hill distance  73, 61  84, 72 100,102  57, 31
#        73, 61       0      22      88      78 
#        84, 72      22       0      78      88 
#       100,102      88      78       0     112 
#        57, 31      78      88     112       0 
players 2
rows 110
cols 140
m %......%%%%%%%%%%%%%%%%%%%%%%%%%.....%%%%%.....%%%%%......%%%......%%%%%%%%%%%%%%%%%%%%%%%%......%%%%%%%%%%%%%%%%%%%%%%%%......%%%%%%%%%%%%%
m %%......%%%%%%%%%%%%%%%%%%%%%%%%......%%%......%%%%%......%%%%......%%%%%%%%%%%%%%%%%%%%%%%%......%%%%%%%%%%%%%%%%%%%%%%%.......%%%%%%%%%%%%
m %.......%%%%%%%%%%%%%%%%%%%%%%%%......%%%.......%%%......%%%%......%%%%%%%%%%%%%%%%%%%%%%%%......%%%%%%%%%%%%%%%%%%%%%%%%.......%%%%%%%%%%%%
m .%.....%%%%%%.%%..%%%....%.%%.%%......%%%%.........%......%%%......%%%%%%..%%%%...%%.%.%.%%......%.%.%%...%...%...%%%%%%%%........%.%.%.%.%.
m .......%%%%%.........................%%%%..........................%%%%%.............................................%%%%...................
m ........%%%%..........................%%%..........................%%%%%.............................................%%%%%..................
m ........%%%%..........................%%%...........................%%%%..............................................%%%...................
m .......%%%%...........................%%%..........................%%%%...............................................%%%%..................
m ........%%%%..........................%%%...........................%%%%.............................................%%%%%..................
m .%%..%%%%%%%%%%.%%.%.%%.%%%...%%.....%%%%%%.%...%.%.%%.%%...%%......%%%%%%..%...%%%%.%%%.%%.%.%.%...%......%%%%..%...%%%%%%...%.%.%.%.%..%%%
m %%%%%%%%%%%%%%%%%%%%%%%%%%%%%%%%......%%%%%%%%%%%%%%%%%%%%%%%%......%%%%%%%%%%%%%%%%%%%%%%%%%%%%%%%%%......%%%%%%%%%%%%%%%%%%%%%%%%%%%%%%%%%
m %%%%%%%%%%%%%%%%%%%%%%%%%%%%%%%.......%%%%%%%%%%%%%%%%%%%%%%%%.....%%%%%%%%%%%%%%%%%%%%%%%%%%%%%%%%%%......%%%%%%%%%%%%%%%%%%%%%%%%%%%%%%%%%
m %%%%%%%%%%%%%%%%%%%%%%%%%%%%%%%.......%%%%%%%%%%%%%%%%%%%%%%%%.....%%%%%%%%%%%%%%%%%%%%%%%%%%%%%%%%%%%.....%%%%%%%%%%%%%%%%%%%%%%%%%%%%%%%%%
m %%%%%%%%%%%%%%%%%%%%%%%%%%%%%%%%......%%%%%%%%%%%%%%%%%%%%%%%......%%.%%%%%%..%%%%..%.%...%...%.%%%%%%......%%%%.%...%%.%..%.%%.%%%.%.%%.%%%
m %%%%%%%%%%%%%%%%%%%%%%%%%%%%%%%%%%%%%%%%%%%%%%%%%%%%%%%%%%%%%%....................................%%%....................................%%%
m %%%%%%%%%%%%%%%%%%%%%%%%%%%%%%%%%%%%%%%%%%%%%%%%%%%%%%%%%%%%%%....................................%%%%...................................%%%
m %%%%%%%%%%%%%%%%%%%%%%%%%%%%%%%%%%%%%%%%%%%%%%%%%%%%%%%%%%%%%%...................................%%%%.....................................%%
m %%%%%%%%%%%%%%%%%%%%%%%%%%%%%%%%%%%%%%%%%%%%%%%%%%%%%%%%%%%%%%...................................%%%%....................................%%%
m %%%%%...%..%%%%%%%.%%%...%%%...%%%.%%.%%.%%.....%%%%...%.%........................................%%%....................................%%%
m ............%%%%...............................................%%%%%%%%....%%.%%%%%%%...%.%.......%%%%%...%%%%%%.......%%%.%%%%.%%.%........
m ............%%%%%..............................................%%%%%%%%%%%%%%%%%%%%%%%%%%%%......%%%%%%%%%%%%%%.......%%%%%%%%%%%%%%........
m .............%%%%.............................................%%%%%%%%%%%%%%%%%%%%%%%%%%%%%.......%%%%%%%%%%%%%......%%%%%%%%%%%%%%.........
m .............%%%..............................................%%%%%%%%%%%%%%%%%%%%%%%%%%%%%%......%%%%%%%%%%%%%%.....%%%%%%%%%%%%%%.........
m ............%%%%%.............................................%%%%%%%%%%%.....%.%%.%.%..%%.......%%...%%%.%..........%%%%%%.%...%...........
m .....%...%.%%%%%%..........%.%%%...%%.......%%..%.%.%%.%.....%%%%%%%%%%%.............................................%%%%%..................
m ...%%%%%%%%%%%%%%.....%%%%%%%%%%%%%%......%%%%%%%%%%%%%%%%%%%%%%%%%%%%%%..............................................%%%...................
m ...%%%%%%%%%%%%%%......%%%%%%%%%%%%%.......%%%%%%%%%%%%%%%%%%%%%%%%%%%%%.............................................%%%%...................
m ..%%%%%%%%%%%%%%.......%%%%%%%%%%%%%%......%%%%%%%%%%%%%%%%%%%%%%%%%%%%..............................................%%%%%..................
m ..%.%%.%%%%.%%%.......%%%%%%...%%%%%.......%.%...%%%%%%%.%%....%%%%%%%%...............................................%%%%..................
m .................................%%%........................................%.%...%%%%.....%%.%%.%%.%%%...%%%...%%%.%%%%%%%..%...%%%%%%%%...
m .................................%%%%...................................%%%%%%%%%%%%%%%%%%%%%%%%%%%%%%%%%%%%%%%%%%%%%%%%%%%%%%%%%%%%%%%%%...
m .................................%%%%...................................%%%%%%%%%%%%%%%%%%%%%%%%%%%%%%%%%%%%%%%%%%%%%%%%%%%%%%%%%%%%%%%%....
m ................................%%%%....................................%%%%%%%%%%%%%%%%%%%%%%%%%%%%%%%%%%%%%%%%%%%%%%%%%%%%%%%%%%%%%%%%%...
m .................................%%%....................................%%%%%%%%%%%%%%%%%%%%%%%%%%%%%%%%%%%%%%%%%%%%%%%%%%%%%%%%%%%%%%%%%...
m .%.%%%.%%.%..%.%%...%.%%%%......%%%%%%.%...%...%.%..%%%%..%%%%%%.%%......%%%%%%%%%%%%%%%%%%%%%%%......%%%%%%%%%%%%%%%%%%%%%%%%%%%%%%%%%%%.%%
m %%%%%%%%%%%%%%%%%%%%%%%%%%%.....%%%%%%%%%%%%%%%%%%%%%%%%%%%%%%%%%%%.....%%%%%%%%%%%%%%%%%%%%%%%%.......%%%%%%%%%%%%%%%%%%%%%%%%%%%%%%%%%%%%%
m %%%%%%%%%%%%%%%%%%%%%%%%%%%......%%%%%%%%%%%%%%%%%%%%%%%%%%%%%%%%%%.....%%%%%%%%%%%%%%%%%%%%%%%%.......%%%%%%%%%%%%%%%%%%%%%%%%%%%%%%%%%%%%%
m %%%%%%%%%%%%%%%%%%%%%%%%%%%......%%%%%%%%%%%%%%%%%%%%%%%%%%%%%%%%%......%%%%%%%%%%%%%%%%%%%%%%%%......%%%%%%%%%%%%%%%%%%%%%%%%%%%%%%%%%%%%%%
m .%.%.%.%...%%%%%%...%..%%%%......%...%.%.%.%%.%%%.%%%%...%..%%%%%%......%%...%%.%%.%.%...%.%%%%%%.....%%...%%%.%%.%.%%.%%%%%%%%%%..%%.%%%..%
m ............%%%%%.............................................%%%%...........................%%%..........................%%%%..............
m ............%%%%...............................................%%%%..........................%%%...........................%%%%.............
m .............%%%..............................................%%%%...........................%%%..........................%%%%..............
m ............%%%%%.............................................%%%%%..........................%%%..........................%%%%..............
m .............%%%%.............................................%%%%%..........................%%%%.........................%%%%%.............
m .%.%........%%%%%%%%...%...%...%%.%.%......%%.%.%.%%...%%%%..%%%%%%......%%%......%.........%%%%......%%.%%.%....%%%..%%.%%%%%%.....%..%.%.%
m %%%%%%.......%%%%%%%%%%%%%%%%%%%%%%%%......%%%%%%%%%%%%%%%%%%%%%%%%......%%%%......%%%.......%%%......%%%%%%%%%%%%%%%%%%%%%%%%.......%%%%%%%
m %%%%%%.......%%%%%%%%%%%%%%%%%%%%%%%......%%%%%%%%%%%%%%%%%%%%%%%%......%%%%......%%%%%......%%%......%%%%%%%%%%%%%%%%%%%%%%%%......%%%%%%%%
m %%%%%%%......%%%%%%%%%%%%%%%%%%%%%%%%......%%%%%%%%%%%%%%%%%%%%%%%%......%%%......%%%%%.....%%%%%.....%%%%%%%%%%%%%%%%%%%%%%%%%......%%%%%%%
m ..%%%%%.....%%%%..%%%%%%%.%..%%.%%%%%......%%%%..%%.%..%%..%.%.%..........%.%.....%%%%%......%.%%......%%%%.%.%%.......%..%%%%%.....%....%.%
m ...%%%%.........................%%%%%......%%%%...................................%%%%%................%%%.................%%%%.............
m ...%%%..........................%%%%......%%%%%....................................%%%%................%%%................%%%%..............
m ..%%%%...........................%%%.......%%%.....................................%%%................%%%%................%%%%%.............
m ..%%%%..........................%%%%%.....%%%%.....................................%%%%...............%%%%.................%%%..............
m ..%%%%...........................%%%.......%%%%....................................%%%%...............%%%%................%%%%..............
m ...%%%%.%%.%%...%%%%%%%.%........%%%%.....%%%%.......%.......%%..%%.%%.%.%%%......%%%%%%%%.%.%%...%.%%%%%%........%%.......%%%%%.%..%...%...
m ..%%%%%%%%%%%%%%%%%%%%%%%%%.....%%%%%......%%%%......%%%%%%%%%%%%%%%%%%%%%%%%......%%%%%%%%%%%%%%%%%%%%%%%%......%%%......%%%%%%%%%%%%%%%...
m ..%%%%%%%%%%%%%%%%%%%%%%%%......%%%%%......%%%.......%%%%%%%%%%%%%%%%%%%%%%%......%%%%%%%%%%%%%%%%%%%%%%%%......%%%%......%%%%%%%%%%%%%%%...
m ...%%%%%%%%%%%%%%%%%%%%%%%.....0%%%%......%%%%%.....%%%%%%%%%%%%%%%%%%%%%%%%%......%%%%%%%%%%%%%%%%%%%%%%%......%%%%%......%%%%%%%%%%%%%%...
m ...%%%%.%....%%%.....%%%%%.......%%.......%%%%%.....%%.%%%%....%%%%.%%.....%.......%.%%.%..%..%%%.......%.%......%%%..........%%...%%%%%....
m ...%%%....................................%%%%%.................................................................%%%%........................
m ...%%%%....................................%%%..................................................................%%%%%.......................
m ...%%%%...................................%%%%..................................................................%%%%........................
m ..%%%%.....................................%%%..................................................................%%%%........................
m ..%%%%....................................%%%%%.................................................................%%%%%.......................
m ..%%%%%.....%%.%%.....%%...%..%..%%.%.%.%%%%%%.......%.%%%...%.%%%.........%.%%%..%%%.%%.%...%%%.%.%.%%......%%%%%%%%%..%%.%%.%......%%%%...
m ...%%%......%%%%%.....%%%%%%%%%%%%%%%%%%%%%%%%.......%%%%%%%%%%%%%%......%%%%%%%%%%%%%%%%%%%%%%%%%%%%%%%%%%%%%%%%%%%%%%%%%%%%%......%%%%....
m ...%%%.......%%%.......%%%%%%%%%%%%%%%%%%%%%%%.......%%%%%%%%%%%%%%.....%%%%%%%%%%%%%%%%%%%%%%%%%%%%%%%%%%%%%%%%%%%%%%%%%%%%%%%......%%%%...
m ..%%%%.......%%%%......%%%%%%%%%%%%%%%%%%%%%%%%......%%%%%%%%%%%%%%.....%%%%%%%%%%%%%%%%%%%%%%%%%%%%%%%%%%%%%%%%%%%%%%%%%%%%%%%......%%%....
m ..%%.%%......%%%%......%%%%.%%%%.%.%%%.%%.%%%%.......%%%%.%.%.%.%.%......%%%%%%%%%%%%%%%%%%%%%%%%%%%%%%%%%%%%%%%%%%%%%%%%%%%%%%.....%.%.%...
m ......................%%%%%...............%%%%......%%%%.................%%%%%%%%%%%%%%%%%%%%%%%%%%%%%%%%%%%%%%%%%%%%%%%%%..................
m ......................%%%%................%%%%%......%%%%...............%%%%%%%%%%%%%%%%%%%%%%%%%%%%%%%%%%%%%%%%%%%%%%%%%%..................
m ......................%%%%%................%%%......%%%%................%%%%%%%%%%%%%%%%%%%%%%%%%%%%%%%%%%%%%%%%%%%%%%%%%...................
m .......................%%%%................%%%%.....%%%%%................%%%%%%%%%%%%%%%%%%%%%%%%%%%%%%%%%%%%%%%%%%%%%%%%...................
m ......................%%%%.................%%%......%%%%%....1...........%%%%.%...%.%.%%...%.....%.%.%.%.%%.%.%%%%...%.%....................
m ...%..%.....%%.%%......%%%%.....%%.%.......%%%%......%%%......%%%..............................................................%%%%%.%%.%...
m ...%%%......%%%%......%%%%%......%%%......%%%%......%%%%.......%%%%%%%%%.......................................................%%%%%%%%%....
m ...%%%......%%%%%......%%%.......%%%%......%%%%.....%%%%.......%%%%%%%%%........................................................%%%%%%%%%...
m ...%%%%......%%%.......%%%%......%%%%.....%%%%......%%%%.......%%%%%%%%%.......................................................%%%%%%%%%%...
m ..%%%%%.....%.........%..%.........%%.....%.%.......%%%........%%%%%%%%%........................................................%%%%%%%%....
m %%%%%%........................................................%%%%%%%%%........%%%.......%.%.....%%.........%..%.........%.....%%%%%......%%
m %%%%%%%.......................................................%%%%%%%%%.......%%%%......%%%%.....%%%%......%%%%.......%%%......%%%%......%%%
m %%%%%%........................................................%%%%%%%%%.......%%%%.....%%%%......%%%%.......%%%......%%%%%......%%%......%%%
m %%%%%%%.......................................................%%%%%%%%%.......%%%%......%%%%......%%%......%%%%%......%%%%......%%%.......%%
m %.%%%%%..............................................................%%%......%%%......%%%%.......%.%%.....%%%%......%%.%%.....%..%......%.%
m ..............%.%...%%%%.%.%%.%.%.%.%.....%...%%.%.%...%.%%%%...........0....%%%%%......%%%.................%%%%............................
m .............%%%%%%%%%%%%%%%%%%%%%%%%%%%%%%%%%%%%%%%%%%%%%%%%................%%%%%.....%%%%................%%%%.............................
m .............%%%%%%%%%%%%%%%%%%%%%%%%%%%%%%%%%%%%%%%%%%%%%%%%%................%%%%......%%%................%%%%%............................
m ............%%%%%%%%%%%%%%%%%%%%%%%%%%%%%%%%%%%%%%%%%%%%%%%%%%...............%%%%......%%%%%................%%%%............................
m ............%%%%%%%%%%%%%%%%%%%%%%%%%%%%%%%%%%%%%%%%%%%%%%%%%.................%%%%......%%%%...............%%%%%............................
m .%.....%%%%%%%%%%%%%%%%%%%%%%%%%%%%%%%%%%%%%%%%%%%%%%%%%%%%%%......%.%.%.%.%.%%%%.......%%%%.%%.%%%.%.%%%%.%%%%......%%%%......%%.%%.....%.%
m %......%%%%%%%%%%%%%%%%%%%%%%%%%%%%%%%%%%%%%%%%%%%%%%%%%%%%%%%.....%%%%%%%%%%%%%%......%%%%%%%%%%%%%%%%%%%%%%%%......%%%%.......%%%%......%%
m %......%%%%%%%%%%%%%%%%%%%%%%%%%%%%%%%%%%%%%%%%%%%%%%%%%%%%%%%.....%%%%%%%%%%%%%%.......%%%%%%%%%%%%%%%%%%%%%%%.......%%%.......%%%......%%%
m %%......%%%%%%%%%%%%%%%%%%%%%%%%%%%%%%%%%%%%%%%%%%%%%%%%%%%%%......%%%%%%%%%%%%%%.......%%%%%%%%%%%%%%%%%%%%%%%%.....%%%%%......%%%.......%%
m %......%.%%.%%..%%%%%%%%%......%%.%.%.%%%...%.%%.%%%..%%%.%.........%%%.%...%%%.%.......%%%%%%.%.%.%%..%..%...%%.....%%.%%.....%%%%%.....%%%
m .................%%%%%.................................................................%%%%%....................................%%%%........
m ..................%%%%..................................................................%%%.....................................%%%%........
m ..................%%%%..................................................................%%%%...................................%%%%.........
m .................%%%%%..................................................................%%%....................................%%%%.........
m ..................%%%%.................................................................%%%%%....................................%%%.........
m %%%...%%..........%%%......%.%.......%%%..%..%.%%.%.......%.....%%.%%%%....%%%%.%%.....%%%%%.......%%.......%%%%%.....%%%....%.%%%%.......%%
m %%%%%%%%%%%......%%%%%......%%%%%%%%%%%%%%%%%%%%%%%......%%%%%%%%%%%%%%%%%%%%%%%%%.....%%%%%......%%%%1.....%%%%%%%%%%%%%%%%%%%%%%%......%%%
m %%%%%%%%%%%%......%%%%......%%%%%%%%%%%%%%%%%%%%%%%%......%%%%%%%%%%%%%%%%%%%%%%%.......%%%......%%%%%......%%%%%%%%%%%%%%%%%%%%%%%%.....%%%
m %%%%%%%%%%%%......%%%......%%%%%%%%%%%%%%%%%%%%%%%%......%%%%%%%%%%%%%%%%%%%%%%%%......%%%%......%%%%%.....%%%%%%%%%%%%%%%%%%%%%%%%%.....%%%
m .%..%.%%%%%.......%%........%%%%%%.%...%%.%.%%%%%%%%......%%%.%.%%.%%..%%.......%.......%%%%.....%%%%........%.%%%%%%%...%%.%%.%%%%......%..
m ........%%%%................%%%%...............%%%%....................................%%%%.......%%%...........................%%%%........
m ........%%%.................%%%%...............%%%%.....................................%%%%.....%%%%%..........................%%%%........
m .......%%%%%................%%%%................%%%.....................................%%%.......%%%...........................%%%%........
m ........%%%%................%%%................%%%%....................................%%%%%......%%%%..........................%%%.........
m .......%%%%.................%%%................%%%%%...................................%%%%......%%%%%.........................%%%%.........
m .%.....%%%%%..%.......%%.%.%%%%......%%.%......%%%%%.....%.%..........%.%.%..%%..%.%%..%%%%......%%%%%.%%..%.%%%%%%%..%%%%.....%%%%%..%.%...
