# map type: blank
# random seed: 2061072602
# hill distance  25, 16  47, 24  55, 95  11, 72  61, 64  19, 47   1, 71  43, 88  65,  0  37, 23   7, 40  29, 48
#        25, 16       0      58      59      82     132      77      85      98      48      47      98      84 
#        47, 24      58       0      45      84      82      51      83      84      42      11      48      42 
#        55, 95      59      45       0      51      77      84      42      47      11      42      85      83 
#        11, 72      82      84      51       0      58      45      11      48      42      83      84      42 
#        61, 64     132      82      77      58       0      59      47      98      84      85      98      48 
#        19, 47      77      51      84      45      59       0      42      85      83      42      47      11 
#         1, 71      85      83      42      11      47      42       0      59      45      84      77      51 
#        43, 88      98      84      47      48      98      85      59       0      58      77     132      82 
#        65,  0      48      42      11      42      84      83      45      58       0      51      82      84 
#        37, 23      47      11      42      83      85      42      84      77      51       0      59      45 
#         7, 40      98      48      85      84      98      47      77     132      82      59       0      58 
#        29, 48      84      42      83      42      48      11      51      82      84      45      58       0 
players 4
rows 72
cols 96
m ....%%%%%.%..%%....%%%....%%...%%....%%.....%....%.%%%%%%....%....%.%%....%....%%...%%%%...%%...
m ...................%%%...%%%....%..........%%..........%%..............3..%..........%%%....%...
m ....................%%....%%...%%%.........%%%.........%%%................%%.........%%%....%...
m ...................%%%....%%...%%%.........%%%.........%%.................%%.........%%.....%%..
m .%%....%.%%%%%%.....%%...%%%....%%.....%...%%%..........%%...%.%....%%....%%..%......%%%....%%..
m %%%%...%%%%%%%%.....%%....%.....%%...%%....%%%....%%....%%....%%...%%%...%%%%%%%%....%%%....%%%%
m %.%%...%%..%.%%.....%%.....%..........%.....%....%%%.....%....%%...%%....%%%.%%.%%...%.%....%%%%
m ....................%%...............%%.1..%%%...............%%%...%%......................%%%..
m ....................%%................%.....%................%%%...%%%.....................%%%..
m ...................%%%...............%%....%%................%%%....%......................%%%..
m .%......%..%.%.%...%%%%...%%...%%.%%%%%%%%.%%%...%.%...%%%...%%%.%.%%%...%.%...%............%%..
m .%%%%%%%%%%%%%%....%%%%%%%%....%%%%%%%%%%%%%%%...%%.....%%...%%%%%%%%%..3.%%...%%....%%.....%%..
m ..%%...%%%.%%%.%...%%%%%%%%%....%..%%......%.....%%....%.....%%%..........%%...%%%...%......%%..
m ...................%%....%%%......................%%.........%%%.........%%....%%%..........%%..
m ...................%%%...%%.......................%%.........%%%..........%.....%%..........%%..
m ....................%%...%%......................%%..........%%%.........%%%....%%..........%%..
m .%.%....%%.....%...%%....%%%.%...%...%%.%%.%.....%%....%%%%..%%....%.....%%%.%.%%%%.%%%.....%%..
m .%%%...%%%....%.....%%...%%%%%%%%%...%%%%%%%%....%%.....%%%%%%%....%%%...%%%%%%%%%%%%%%....%%%..
m ..%%...%%....%%.....%....%.%%%%%%....%....%.%%....%....%%...%%%%...%%.......%%%%%.%..%%....%%%..
m .%%%....%..........%%..........%%..............2..%..........%%%....%......................%%%..
m ..%%...%%%.........%%%.........%%%................%%.........%%%....%.......................%%..
m ..%%...%%%.........%%%.........%%.................%%.........%%.....%%.....................%%%..
m .%%%....%%.....%...%%%..........%%...%.%....%%....%%..%......%%%....%%...%%....%.%%%%%%.....%%..
m ..%.....%%...%%....%%%....%%....%%....%%...%%%...%%%%%%%%....%%%....%%%%%%%%...%%%%%%%%.....%%..
m ...%..........%.....%....%%%.....%....%%...%%....%%%.%%.%%...%.%....%%%%%.%%...%%..%.%%.....%%..
m .............%%.0..%%%...............%%%...%%......................%%%......................%%..
m ..............%.....%................%%%...%%%.....................%%%......................%%..
m .............%%....%%................%%%....%......................%%%.....................%%%..
m ..%%...%%.%%%%%%%%.%%%...%.%...%%%...%%%.%.%%%...%.%...%............%%...%......%..%.%.%...%%%%.
m %%%....%%%%%%%%%%%%%%%...%%.....%%...%%%%%%%%%..2.%%...%%....%%.....%%...%%%%%%%%%%%%%%....%%%%%
m %%%%....%..%%......%.....%%....%.....%%%..........%%...%%%...%......%%....%%...%%%.%%%.%...%%%%%
m .%%%......................%%.........%%%.........%%....%%%..........%%.....................%%...
m .%%.......................%%.........%%%..........%.....%%..........%%.....................%%%..
m .%%......................%%..........%%%.........%%%....%%..........%%......................%%..
m .%%%.%...%...%%.%%.%.....%%....%%%%..%%....%.....%%%.%.%%%%.%%%.....%%...%.%....%%.....%...%%...
m .%%%%%%%%%...%%%%%%%%....%%.....%%%%%%%....%%%...%%%%%%%%%%%%%%....%%%...%%%...%%%....%.....%%..
m .%.%%%%%%....%....%.%%....%....%%...%%%%...%%.......%%%%%.%..%%....%%%....%%...%%....%%.....%...
m .......%%..............1..%..........%%%....%......................%%%...%%%....%..........%%...
m .......%%%................%%.........%%%....%.......................%%....%%...%%%.........%%%..
m .......%%.................%%.........%%.....%%.....................%%%....%%...%%%.........%%%..
m ........%%...%.%....%%....%%..%......%%%....%%...%%....%.%%%%%%.....%%...%%%....%%.....%...%%%..
m ..%%....%%....%%...%%%...%%%%%%%%....%%%....%%%%%%%%...%%%%%%%%.....%%....%.....%%...%%....%%%..
m .%%%.....%....%%...%%....%%%.%%.%%...%.%....%%%%%.%%...%%..%.%%.....%%.....%..........%.....%...
m .............%%%...%%......................%%%......................%%...............%%.3..%%%..
m .............%%%...%%%.....................%%%......................%%................%.....%...
m .............%%%....%......................%%%.....................%%%...............%%....%%...
m .%.%...%%%...%%%.%.%%%...%.%...%............%%...%......%..%.%.%...%%%%...%%...%%.%%%%%%%%.%%%..
m .%%.....%%...%%%%%%%%%..1.%%...%%....%%.....%%...%%%%%%%%%%%%%%....%%%%%%%%....%%%%%%%%%%%%%%%..
m .%%....%.....%%%..........%%...%%%...%......%%....%%...%%%.%%%.%...%%%%%%%%%....%..%%......%....
m ..%%.........%%%.........%%....%%%..........%%.....................%%....%%%....................
m ..%%.........%%%..........%.....%%..........%%.....................%%%...%%.....................
m .%%..........%%%.........%%%....%%..........%%......................%%...%%.....................
m .%%....%%%%..%%....%.....%%%.%.%%%%.%%%.....%%...%.%....%%.....%...%%....%%%.%...%...%%.%%.%....
m .%%.....%%%%%%%....%%%...%%%%%%%%%%%%%%....%%%...%%%...%%%....%.....%%...%%%%%%%%%...%%%%%%%%...
m ..%....%%...%%%%...%%.......%%%%%.%..%%....%%%....%%...%%....%%.....%....%.%%%%%%....%....%.%%..
m ..%..........%%%....%......................%%%...%%%....%..........%%..........%%..............0
m ..%%.........%%%....%.......................%%....%%...%%%.........%%%.........%%%..............
m ..%%.........%%.....%%.....................%%%....%%...%%%.........%%%.........%%...............
m ..%%..%......%%%....%%...%%....%.%%%%%%.....%%...%%%....%%.....%...%%%..........%%...%.%....%%..
m .%%%%%%%%....%%%....%%%%%%%%...%%%%%%%%.....%%....%.....%%...%%....%%%....%%....%%....%%...%%%..
m .%%%.%%.%%...%.%....%%%%%.%%...%%..%.%%.....%%.....%..........%.....%....%%%.....%....%%...%%...
m ...................%%%......................%%...............%%.2..%%%...............%%%...%%...
m ...................%%%......................%%................%.....%................%%%...%%%..
m ...................%%%.....................%%%...............%%....%%................%%%....%...
m .%.%...%............%%...%......%..%.%.%...%%%%...%%...%%.%%%%%%%%.%%%...%.%...%%%...%%%.%.%%%..
m 0.%%...%%....%%.....%%...%%%%%%%%%%%%%%....%%%%%%%%....%%%%%%%%%%%%%%%...%%.....%%...%%%%%%%%%..
m ..%%...%%%...%......%%....%%...%%%.%%%.%...%%%%%%%%%....%..%%......%.....%%....%.....%%%........
m .%%....%%%..........%%.....................%%....%%%......................%%.........%%%........
m ..%.....%%..........%%.....................%%%...%%.......................%%.........%%%........
m .%%%....%%..........%%......................%%...%%......................%%..........%%%........
m .%%%.%.%%%%.%%%.....%%...%.%....%%.....%...%%....%%%.%...%...%%.%%.%.....%%....%%%%..%%....%....
m .%%%%%%%%%%%%%%....%%%...%%%...%%%....%.....%%...%%%%%%%%%...%%%%%%%%....%%.....%%%%%%%....%%%..
