# map type: blank
# random seed: -1235888034
# hill distance  33, 26  57,  5  62, 42  14, 21
#        33, 26       0      45      73      70 
#        57,  5      45       0      52      73 
#        62, 42      73      52       0      45 
#        14, 21      70      73      45       0 
players 2
rows 72
cols 84
m %%%%%........................................................%%%%......%%%%%.......%
m %%%%.........................................................%%%%.......%%%%%......%
m %%%%%........................................................%%%%......%%%%%%.......
m %%%%%..%%..%%%.....%%.%%.....%%%%%%%%......%%.%%%..........%%%%%%......%%%%%%...%%.%
m %%%%%%%%%%%%%%%%%%%%%%%%%%%%%%%%%%%%........%%%%%......%%%%%%%%%%.......%%%%%%%%%%%%
m %%%%%%%%%%%%%%%%%%%%%%%%%%%%%%%%%%%%........%%%%%......%%%%%%%%%%......%%%%%%%%%%%%%
m %%%%%%%%%%%%%%%%%%%%%%%%%%%%%%%%%%%%%......%%%%%%.......%%%%%%%%%......%%%%%%%%%%%%%
m %%%%%%%%%%%%%%%%%%%%%%%%%%%%%%%%%%%%.......%%%%%%......%%%%%%%%%%......%%%%%%%%%%%%%
m %....%.%...%%%%.%%.....%...%.%%%....%......%%%%%%........%%%.%%%%......%%%%%%...%.%.
m ............................................%%%%.............%%%%...................
m ............................................%%%%%............%%%%...................
m ...........................................%%%%%%............%%%%...................
m ...........................................%%%%%.............%%%%...................
m ...........................................%%%%%.............%%%%...................
m .....................1.....................%%%%%.............%%%%...................
m ..%%.%..%....%.%%.%%..%..........%%.%.%%%%.%%%%%.......%...%%%%%%......%............
m %%%%%%%%%%%%%%%%%%%%%%%%%.......%%%%%%%%%%%%%%%%........%%%%%%%%%......%%%%%%......%
m %%%%%%%%%%%%%%%%%%%%%%%%%.......%%%%%%%%%%%%%%%%........%%%%%%%%%.......%%%%........
m %%%%%%%%%%%%%%%%%%%%%%%%%.......%%%%%%%%%%%%%%%%%.......%%%%%%%%%.......%%%%.......%
m %%%%%%%%%%%%%%%%%%%%%%%%%......%%%%%%%%%%%%%%%%%.......%%%%%%%%%%......%%%%%%.......
m %%..%%%..%...%..%.%..%%%%......%%...%.%.%..%%%.........%%%%%%%%%%.......%%%%%.......
m .......................%%...............................%%%%%...........%%%%........
m .......................%................................%%%%%...........%%%%........
m .......................%...............................%%%%%............%%%%%.......
m ........................%..............................%%%%%............%%%%%.......
m ........................%...............................%%%%...........%%%%%........
m .......................%%...............................%%%%...........%%%%%........
m ..%%%..%.%.%...%%......%%%%..%.%..%...%..%%%..%%.......%%%%%.......%%%%%%%%%%.......
m %%%%%%%%%%%%%%%%%......%%%%%%%%%%%%%%%%%%%%%%%%%.......%%%%%%......%%%%%%%%%%.......
m %%%%%%%%%%%%%%%%.......%%%%%%%%%%%%%%%%%%%%%%%%%%.......%%%%.......%%%%%%%%%.......%
m %%%%%%%%%%%%%%%%.......%%%%%%%%%%%%%%%%%%%%%%%%%........%%%%.......%%%%%%%%%........
m %%%%%%%%%%%%%%%%.......%%%%%%%%%%%%%%%%%%%%%%%%%%......%%%%%%......%%%%%%%%%........
m %%%%%.%%%%.%.%%..........%..%%.%%.%....%..%.%%..............%......%%%%%%...%.......
m %%%%%.....................0........................................%%%%.............
m %%%%%..............................................................%%%%.............
m %%%%%..............................................................%%%%.............
m %%%%%..............................................................%%%%............%
m %%%%...............................................................%%%%............%
m %%%%...............................................................%%%%.............
m %%%%%......%....%%%.%...%.....%%.%%%%...%.%....%.%.%...%%%%%%......%%%%.%%%........%
m %%%%%.......%%%%%%%%%%%%%%%%%%%%%%%%%%%%%%%%%%%%%%%%%%%%%%%%%......%%%%%%%%%%......%
m %%%%%......%%%%%%%%%%%%%%%%%%%%%%%%%%%%%%%%%%%%%%%%%%%%%%%%%%......%%%%%%%%%.......%
m %%%%........%%%%%%%%%%%%%%%%%%%%%%%%%%%%%%%%%%%%%%%%%%%%%%%%%......%%%%%%%%%%......%
m %%%%........%%%%%%%%%%%%%%%%%%%%%%%%%%%%%%%%%%%%%%%%%%%%%%%%.......%%%%%%%%%%......%
m %%.%%......%%%%%%%%.....%%.%%.....%%%..%%..%%%%%%.%%...%%%%%%......%%%%%%..........%
m ...........................................%%%%%.......%%%%%%......%%%%.............
m ............................................%%%%%......%%%%%.......%%%%.............
m ...........................................%%%%%%.......%%%%%......%%%%.............
m ............................................%%%%.......%%%%%%......%%%%.............
m ............................................%%%%........%%%%.......%%%%.............
m ...........................................%%%%%%......%%%%%%......%%%%.............
m .%%.%.......%%%%.......%%.......%.%.%.......%%%%.......%%%%%.......%%%%..%.%........
m %%%%%.......%%%%.......%%.......%%%%.......%%%%%%.......%%%%.......%%%%%%%%%%......%
m %%%%.......%%%%%.......%%......%%%%%%......%%%%%%.......%%%%%......%%%%%%%%%.......%
m %%%%%.......%%%%.......%%......%%%%%.......%%%%%.......%%%%%.......%%%%%%%%%%......%
m %%%%%......%%%%%.......%........%%%%%......%%%%%%......%%%%%%......%%%%%%%%%%.......
m ....%......%%%%.%......%%.......%%%.........%%%............%.......%%%%.%..........%
m .....0..................%...........................................................
m .......................%%...........................................................
m ........................%...........................................................
m .......................%............................................................
m .......................%%...........................................................
m .......................%..................1.........................................
m .%%%.........%%%.......%%......%.%%%%......%....%..........%.%%%%.......%...........
m %%%%%......%%%%%........%.......%%%%%......%%%%%.......%%%%%%%%%%......%%%%%%......%
m %%%%%.......%%%%%......%%.......%%%%.......%%%%%%......%%%%%%%%%%.......%%%%%.......
m %%%%%......%%%%%%......%%.......%%%%%.......%%%%%.......%%%%%%%%%......%%%%%.......%
m %%%%%.......%%%%.......%%.......%%%%.......%%%%%%......%%%%%%%%%%.......%%%%.......%
m %%%%.......%.%.%.......%%.......%%%%.......%.%%.........%.%..%%%%.......%%%%%.......
m %%%%%........................................................%%%%......%%%%%%......%
m %%%%.........................................................%%%%.......%%%%........
m %%%%.........................................................%%%%......%%%%%%.......
