# map type: blank
# random seed: 859392360
# hill distance  16, 38  55, 16  80, 93  29, 42  84, 10  51,  3  10, 67  23, 71
#        16, 38       0      81      73      29      56      94      91      94 
#        55, 16      81       0     112      52      91      29      90      73 
#        80, 93      73     112       0      90      29      91      52      81 
#        29, 42      29      52      90       0      73      81     112      91 
#        84, 10      56      91      29      73       0      94      81      94 
#        51,  3      94      29      91      81      94       0      73      56 
#        10, 67      91      90      52     112      81      73       0      29 
#        23, 71      94      73      81      91      94      56      29       0 
players 4
rows 96
cols 96
m ...................%%.....%%%%...%%%%%%%%%%%%%%%....%%....%%%%%%...................%%%%.........
m ...................%%.......%%....%.%%.%%.%%.%%%....%%....%%%%%%%..................%%%%%........
m ....................%...............................%....%%%%%%%.....%.%.%.%....%%%%%%%%........
m .%%..%%%%..%%%%%....%%%............................%%%...%%%%%%%.....%%%%%%%....%%%%%%%%....%%..
m ..%%%%%%%%%%%%%.....%%%%...........................%%....%%%%%%%.....%%%%.%%%....%..%%%%....%...
m .%.%..%%....%%.%....%%%%...%%%%%%%%%.%..%%.%..%%....%%...%%%%%%%.....%....%%%...............%...
m ....................%%%%%%%%%%%%%%%%%%%%%%%%%%%.....%.....%%%%%%%...%%.....%%............%%%%%..
m ...................%.....%%.%%%.%%%%%...%..%.%%....%.%...%%.%%%%....%%.....%%............%%%%...
m .................................%%%..........%%............%%%%.....%.....%%%%..........%%%%%..
m %%......%....%%...................%...........%.............%%%%%...%%....%%%%%%%%....%%%%%%%%%.
m %%%....%%.....%..................%%%..........%.............%%.%...1......%...%.%%%...%..%.%%%%%
m %%%%...%%%...%%......%.%...%%....%%%.....%...%%.....%.%%%.%%%%...................%..........%%%%
m %%%%..........%%%%....%%....%%...%%%....%.....%....%%%%%%%%%%%..................%%...........%%%
m %%%..........%.%.%...%%%...%%....%%%....%....%%%...%%%%%%%%%%%...................%%.........%%%%
m %%%..................%%%....%..........%%.....%%.........%%%%%%%...%%.......%....%....%.%...%%%%
m %%%...................%%....%%..........%%...%%%.........%%%%%%%%%%%%%%%%%%%.....%%...%%.....%%%
m ......................%.....%%........3.%%....%%.........%%..%%%%.%...%..%..%...%%%....%%.....%%
m ....%....%.....%......%.....%....%%....%%%....%%...%.%%%%%......................%%%....%........
m ...............%%%....%%...%%%....%%...%%%...%%%...%%%%%%%%......................%....%%........
m ...............%%....%%%....%....%.%...%.%...%%%....%%%%%%......................%%....%%%.......
m .....................%%%....%%......................%%%%%%....%%%...%.%...%.%....%....%%%....%%.
m ......................%%....%......................%%%%%%%%...%%%...%%%...%%....%%%...%%....%%%.
m ....%....%............%....%%%......................%%%%%.%...%%....%%%....%%....%.....%......%.
m ..............%%.....%%....%%%...%..%..%...%.%%%%..%%.........%%....%%.2........%%.....%........
m ...........%%%%%%.....%%...%%.....%%%%%%%%%%%%%%%%%%%.........%%%...%%..........%%....%%........
m ...........%%%%%%%...%.%....%....%.......%%...%%%%%%%.........%%.....%%..........%....%%%.......
m %..........%%%%%%%.........%%...................%%%%%%%%%%%...%%%....%....%%%....%%...%%%...%.%.
m ..........%%%%%%%...........%%..................%%%%%%%%%%%....%.....%....%%%...%%....%%....%%%%
m %...%%%...%%%%%%%%..........%...................%%%%.%%%.%.....%%...%.....%%%....%%...%.%......%
m .....%%....%%%%%%%%.%..%...%%%.%...%......0...%.%%.............%..........%%%..................%
m %....%......%%.%%%%%%%%%....%%%%%%%%....%%...%%%%%.............%...........%...................%
m ................%%%%%..........%%%%.....%.....%%%%............%%..........%%%...................
m .................%%%%............%%.....%%....%%%%.%%...%.%....%%.%..%...%%%%%.%%%.%%.....%.....
m ................%%%%%............%%.....%%...%%%%%%%.....%.....%%%%%%%%%%%%%%%%%%%%%%%%%%%......
m %%....%%..%.%....%...............%%%....%.....%%%%%%%...%%....%%..%.%%..%.%%%%%%%%%...%%%%....%.
m %%%%%%%%%%%%.....%....%%%%..%....%%%.%%%%.....%%%%%%%....%%...........................%%%%.....%
m %%%..%%%%..%%...%%....%%%%%%%%....%%%%%%%.....%%%%%%%...%%%............................%%%....%%
m ......................%%%%%%%%....%.%.%.%.....%%%%%%%....%...............................%......
m ......................%%%%%..................%%%%%%%....%%....%%%.%%.%%.%%.%....%%.......%%.....
m .......................%%%%...................%%%%%%....%%....%%%%%%%%%%%%%%%...%%%%.....%%.....
m %....%...%%%.%..%......%%.....................%%%%%%....%%....%%%.%%%.%..........%%%....%%....%.
m %%%%%%%%%%%%%%%%%%....%%%...%%%.%%%..%%%%.....%%%%%%%..........%%................%%%%...%%%...%%
m ..%%.%.%.%%...%.%%.....%%...%%%%%%%%%%%%%.....%%%%%%%.........%%...................%%...%%%....%
m .................%..........%%%%%%%%.%.%.....%%%%%%%..........%%%.......................%%%.....
m ................%%%..........%%%%%%%..........%%%%%%.....%.%%.%%....%%%...%.%%%.........%%......
m .................%%.........%%%%%%%...........%%%%%%.....%%%%%%%....%%....%%%%%.........%%%.....
m %...%.%...%.%....%%%%%%.....%%%%%%%%.........%%%%%%%%....%%.%..%%....%.....%%%%....%....%%%%.%%%
m %...%%.....%.....%%%%%%%%...%%%%%%%%...%..%.%%%%%%%%.................%.....%%%.....%%...%%%%%%%%
m %....%%....%....%%...%%%.....%%%.%%%...%%%%%%%%..%%%%................%.......%%....%....%%%%.%%%
m ..........%%...........%%....%.....................................................%%....%%.....
m ...........%..........%%....%%%......................%.............................%%...%%......
m ...1.......%..........%%%...%%......................%%%............................%.....%......
m .%..%%%...%%..........%%....%%%...%%....%...........%%......%...%%%%..%.......%...%%%....%......
m %%%%%%.....%.....%%%%%%%%...%%.....%...%%......%.....%%...%%%...%%%%%%....%%%%%....%%...%%%....%
m ..%%%%%....%%....%.%%..............%.....%...%%%....%%%....%%....%%%%%.......%%...%%....%%....%.
m ...........%%...2.................%%.................%%...%%.....%%%%%%...........%%%....%......
m ..........%%.......................%................%%....%%%...%%%%%%%...........%%%...%%%.....
m ...........%......................%%..........%%....%%%....%%....%%%%%%............%.....%......
m %.%..%%...%%.....%..%....%....%..%%%.....%....%.....%%....%%%%.%%.%..%%.....%..%.%%%%....%%...%.
m %%%%%%%...%%%...%%%%%%%%%%%%%%%%%%%%.....%..%%%......%%....%%%%%%...........%%%%%%%%%...%%%%%%%%
m %%%%%%%...%%%....%%%%%%%%%%%%%%%%%%.....%%..%.............%%%%%%.............%%%%.%%%...%..%....
m ..........%%%%%%%%%%%%%%%%%%%%%%%%%.......................%%%%%%%............%..................
m ...........%%%%%%%%%%%%%%%%%%%%%%%%%.......................%%%%%%%%.%%%.....%%%.................
m ...........%%%%%....%%%%%%%%%%%%%%%%......................%%%%%%%%%%%%.......%%.................
m %...%%..%.%%%%%%...%%%%%%%%%%%%%%%%%...............%%..%%.%%.%%.%.%%.%......%%........%%..%....%
m %....%%%%%%%%%%....%.%%%%...%%...%.%..%%.%.%%%.....%%%%%%%..................%%%...%%%%%%%%....%%
m %...%%%%%%...%%%.....................%%%%%%%%%%.....%%%%%%%.......................%%%.%.%.%....%
m %...%%%%%%...%%%......................%.%%%.%.%.....%%%%%%%...................................%%
m %...%%%%%%...%%%...................................%%%%%%%.....%.%.%%%.%......................%%
m %...%%%%%%...%%....%.%.%.%%%.......................%%%%%%%.....%%%%%%%%%%.....................%%
m %%%%%%%%%....%%%....%%%%%%%%...%%%..................%%%%%%%.....%%%.%.%%..%.%...%%...%%%%.%....%
m %%%%.%..%%...%%....%..%%........%%......%.%%.%.%%.%%.%%..%%...............%%%%%%%%%%%%%%%%%...%%
m %%%............................%%.......%%%%%%%%%%%%......................%%%%%%%%%%%%%%%%....%%
m %%%............................%%%.....%%%.%%%%%%%%.......................%%%%%%%%%%%%%%%%%%%%%%
m %%%%............................%............%%%%%%%.......................%%%%%%%%%%%%%%%%%%%%%
m .%%%...%%%%%%%....%..%...%%%.%%%%.............%%%%%%.............%..%%.....%%%%%%%%%%%%%%%%%%...
m .%%%...%%%%%%%%%%%%%%%...%%%%%%%%%...........%%%%%%....%%......%%%..%.....%%%%%%%%%%%%%%%%%%%%..
m ..%%...%%..%.%.%...%%....%%%%.%..%.....%%..%.%%.%%%%....%%.....%....%.....%%%..%....%....%..%...
m ..%.................%.....%............%%%%%%....%%....%%%....%%..........%%....................
m ..%%...............%%%...%%%...........%%%%%%%...%%%....%%................%.....................
m .%%.................%....%%%...........%%%%%%.....%%...%%.................%%.................3..
m .%%....%%%%%...%....%%....%%...%%.......%%%%%....%%....%%%....%%%...%.....%..............%%.%...
m ..%.....%%%%%%%....%%%...%%....%%%%%....%%%%%%...%%%...%%.....%......%%...%.....%%...%%%%%%%%...
m ..%%...%%%..%.......%....%%%...%.......%..%%%%...%......%%...........%....%%...%%%....%%........
m ..%.......0.........%.....%............................%%%......................%%...%%%........
m ..%.................%%...%%.............................%......................%%%....%%........
m ..%%...............%%....%%.....................................................%....%%.........
m ..%....%%....%%%%.%%%%....%....%%.......%................%%%%..%%%%%%%%...%%%.%%%.....%%%...%%..
m ..%.....%%...%%%%%%%%%...%%.....%%%.....%.................%%%%%%%%.%..%...%%%%%%%%...%%%%%%%%...
m .%.%...%.%...%%%%.%%%%....%....%%%%.....%....%%..%.%%....%%%%%%%%.........%%%%%%%%.....%%%%%%...
m ...................%%%.........%%%%%....%%....%%%%%%%.....%%%%%%...........%%%%%%%.........%%...
m ....................%%.........%%%.%...%%%....%%.%%.%.....%%%%%%..........%%%%%%%..........%%%..
m ...................%%%.......................%%%..........%%%%%%%.....%.%.%%%%%%%%..........%...
m ...%%.%.%.%%..%....%%%...%%...................%%.........%%%%%%%.....%%%%%%%%%%%%%...%%.....%%.%
m %%%%%%%%%%%%%%%%...%%%...%%%%................%%..........%%%%%%%.....%%%%..%%%.%%%...%%%....%%%%
m %.%%%...%....%.%....%%....%%%..........%.%%%.%%%....%%....%%%%%%.....................%%......%..
