rows 60
cols 90
players 4
m %%.%....%...%%%.....%%...%%....%%%....%%%....%%...%%.....%%%...%....%.%%.%%%..........%%%.
m %%%....%%%%%%%%....%%.....%%...%%%....%%%...%%.....%%....%%%%%%%%....%%%%%%%....%%....%%%%
m ..%....%%.%%.%%%...%%....%%%....%%....%%....%%%....%%...%%%.%%.%%....%..%.%%%...%%...%%%.%
m ..............%...........%%....%%....%%....%%...........%................%%....%%....%%..
m .............%%%.........%%%....%%....%%....%%%.........%%%................%....%%....%...
m ..............%...........%....%%%....%%%....%...........%................%%..........%%..
m .%%.%...%%...%%%...%%%%%%%%%.%.%%%....%%%.%.%%%%%%%%%...%%%...%%...%.%%...%%....%%....%%..
m .%%%%%%%%....%%%...%%%%%%%%%%%%%%......%%%%%%%%%%%%%%...%%%....%%%%%%%%....%..........%...
m .%....%%%%...%%%...%%.%..%.%.%%%%......%%%%.%.%..%.%%...%%%...%%%%....%.........%%........
m ......1%%.....%%................%......%................%%.....%%0..............%%........
m ........%....%%.................%%....%%.................%%....%..........................
m ........%....%%%...............%%%....%%%...............%%%....%..........................
m %.%....%%%...%%%%%..%.%%%%.%...%%%....%%%...%.%%%%.%..%%%%%...%%%....%.%%%%.....%%.....%%%
m %%%%%%%%%%....%%%%%%%%%%%%%....%%......%%....%%%%%%%%%%%%%....%%%%%%%%%%%%%%..........%%%%
m %%%%.%%..%.......%.%%%%.%%.....%%......%%.....%%.%%%%.%.......%..%%.%%%%..................
m ..........................................................................................
m ..........................................................................................
m ..........................................................................................
m ..%..%...%...%%.%..%......%%.%.%.%%..%%.%.%.%%......%..%.%%...%...%..%....%.%........%.%..
m ..%%%%%%%.....%%%%%%%.....%%%%%%%%%%%%%%%%%%%%.....%%%%%%%.....%%%%%%%.....%....%%....%...
m ..%%%%%%%....%%%%%%%%.....%%%%%%%%%%%%%%%%%%%%.....%%%%%%%%....%%%%%%%....%%%........%%%..
m ..%%%%%%%....%%%%%%%%.....%%%%%%%%%%%%%%%%%%%%.....%%%%%%%%....%%%%%%%....%%%........%%%..
m ..%%%%%%%.....%%%%%%%.....%%%%%%%%%%%%%%%%%%%%.....%%%%%%%.....%%%%%%%.....%....%%....%...
m ..%..%...%...%%.%..%......%%.%.%.%%..%%.%.%.%%......%..%.%%...%...%..%....%.%........%.%..
m ..........................................................................................
m ..........................................................................................
m ..........................................................................................
m %%%%.%%..%.......%.%%%%.%%.....%%......%%.....%%.%%%%.%.......%..%%.%%%%..................
m %%%%%%%%%%....%%%%%%%%%%%%%....%%......%%....%%%%%%%%%%%%%....%%%%%%%%%%%%%%..........%%%%
m %.%....%%%...%%%%%..%.%%%%.%...%%%....%%%...%.%%%%.%..%%%%%...%%%....%.%%%%.....%%.....%%%
m ........%....%%%...............%%%....%%%...............%%%....%..........................
m ........%....%%.................%%....%%.................%%....%..........................
m ......3%%.....%%................%......%................%%.....%%2..............%%........
m .%....%%%%...%%%...%%.%..%.%.%%%%......%%%%.%.%..%.%%...%%%...%%%%....%.........%%........
m .%%%%%%%%....%%%...%%%%%%%%%%%%%%......%%%%%%%%%%%%%%...%%%....%%%%%%%%....%..........%...
m .%%.%...%%...%%%...%%%%%%%%%.%.%%%....%%%.%.%%%%%%%%%...%%%...%%...%.%%...%%....%%....%%..
m ..............%...........%....%%%....%%%....%...........%................%%..........%%..
m .............%%%.........%%%....%%....%%....%%%.........%%%................%....%%....%...
m ..............%...........%%....%%....%%....%%...........%................%%....%%....%%..
m ..%....%%.%%.%%%...%%....%%%....%%....%%....%%%....%%...%%%.%%.%%....%..%.%%%...%%...%%%.%
m %%%....%%%%%%%%....%%.....%%...%%%....%%%...%%.....%%....%%%%%%%%....%%%%%%%....%%....%%%%
m %%.%....%...%%%.....%%...%%....%%%....%%%....%%...%%.....%%%...%....%.%%.%%%..........%%%.
m ...............................%%%....%%%..................................%..........%...
m ................................%......%..................................%%%........%%%..
m ................................%......%..................................%%..........%%..
m ...%%...%.%...%%%..%%..%.%%%....%......%....%%%.%..%%..%%%...%.%...%%.....%%..........%%..
m .%%%%%%%%%%%%%%%%%%%%%%%%%%.....%%....%%.....%%%%%%%%%%%%%%%%%%%%%%%%%%...%%..........%%..
m ..%%.%%.%...%..%.%....%..%......%%....%%......%..%....%.%..%...%.%%.%%....%%....%%....%%..
m ..%..................................................................%....................
m .%%..................................................................%%.........%%........
m .%%%................................................................%%%.........%%........
m .%%%................................................................%%%.........%%........
m .%%..................................................................%%.........%%........
m ..%..................................................................%....................
m ..%%.%%.%...%..%.%....%..%......%%....%%......%..%....%.%..%...%.%%.%%....%%....%%....%%..
m .%%%%%%%%%%%%%%%%%%%%%%%%%%.....%%....%%.....%%%%%%%%%%%%%%%%%%%%%%%%%%...%%..........%%..
m ...%%...%.%...%%%..%%..%.%%%....%......%....%%%.%..%%..%%%...%.%...%%.....%%..........%%..
m ................................%......%..................................%%..........%%..
m ................................%......%..................................%%%........%%%..
m ...............................%%%....%%%..................................%..........%...
