# map type: blank
# random seed: -400162634
# hill distance  37, 14  20, 50   1, 86  56,122
#        37, 14       0      53     108     127 
#        20, 50      53       0     127     146 
#         1, 86     108     127       0      53 
#        56,122     127     146      53       0 
players 2
rows 72
cols 144
m %%..................%%%%%%......................................................%%%%%%......................................................%%%%
m %....................%%%%%......................................................%%%%%%0.....................................................%%%%
m %.......%%.%....%.%%%%%%%%......%%%%.........%%.%........%...%.......%..%........%%%%%.%..%%%%%.%.%..%....%..%........%%%%........%%%........%%%
m %%......%%%%%%%%%%%%%%%%%%.......%%%%%......%%%%%%.......%%%%%.......%%%%%.......%%%%%%%%%%%%%%%%%%%%%%%%%%%%%......%%%%%%......%%%%%.......%%%%
m %........%%%%%%%%%%%%%%%%%.......%%%%.......%%%%%%.......%%%%.......%%%%%%......%%%%%%%%%%%%%%%%%%%%%%%%%%%%%.......%%%%%%......%%%%%%.......%%%
m %.......%%%%%%%%%%%%%%%%%.......%%%%%........%%%%%......%%%%%%.......%%%%%.......%%%%%%%%%%%%%%%%%%%%%%%%%%%%.......%%%%%.......%%%%%........%%%
m %%......%%%%%%%%%%%%%%%%%.......%%%%%%......%%%%%%......%%%%%%.......%%%%%......%%%%%%%%%%%%%%%%%%%%%%%%%%%%%........%%%%%......%%%%%%.......%%%
m %........%%%%%%%%%%%%%%..........%..%%..........%%.......%%%%%......%...%........%%%%%%%%%%%%..%....%.%%%..%........%..%.%.......%%%%.........%.
m ........%%%%%%..................................................................%%%%%............................................%%%%...........
m ........%%%%%%..................................................................%%%%%............................................%%%%...........
m ........%%%%%%..................................................................%%%%%%...........................................%%%%%..........
m .........%%%%%..................................................................%%%%%%...........................................%%%%...........
m .........%%%%%..................................................................%%%%%............................................%%%%%..........
m ........%%%%%%..................................................................%%%%%%..........................................%%%%%%..........
m %.%.%%%%%%%%%%.%%%%%.%%.%.%.%%%.%.%%%.%%.%%.%..%..%..%%.%.%%........%...%.......%%%%%%.......%%%%%..%.%%..%.%..%%%....%..%%%%.%.%%%%%%......%..%
m %%%%%%%%%%%%%%%%%%%%%%%%%%%%%%%%%%%%%%%%%%%%%%%%%%%%%%%%%%%%%%.......%%%%.......%%%%%%......%%%%%%%%%%%%%%%%%%%%%%%%%%%%%%%%%%%%%%%%%.......%%%%
m %%%%%%%%%%%%%%%%%%%%%%%%%%%%%%%%%%%%%%%%%%%%%%%%%%%%%%%%%%%%%.......%%%%%%.......%%%%.......%%%%%%%%%%%%%%%%%%%%%%%%%%%%%%%%%%%%%%%%%.......%%%%
m %%%%%%%%%%%%%%%%%%%%%%%%%%%%%%%%%%%%%%%%%%%%%%%%%%%%%%%%%%%%%.......%%%%%%.......%%%%........%%%%%%%%%%%%%%%%%%%%%%%%%%%%%%%%%%%%%%%%%......%%%%
m %%%%%%%%%%%%%%%%%%%%%%%%%%%%%%%%%%%%%%%%%%%%%%%%%%%%%%%%%%%%%.......%%%%%%.......%%%%%.......%%%%%%%%%%%%%%%%%%%%%%%%%%%%%%%%%%%%%%%%.......%%%%
m %.%%%%%%.%%%%%......%%.%.%...%.%%.%%.%...%.%..%%%%.%%.%.%%%%%.......%%%%%........%.%........%....%%%%%%%.%.%.%..%%%...%.%...%..%.%%%.%.........%
m ..................................................1.....%%%%%........%%%%%......................................................................
m ........................................................%%%%%%.......%%%%%......................................................................
m .........................................................%%%%%.......%%%%.......................................................................
m ........................................................%%%%%........%%%%.......................................................................
m .........................................................%%%%.......%%%%%%......................................................................
m .........................................................%%%%%.......%%%%%......................................................................
m %.........%.%.......%..%%........%..%.%...%..%%.%%.%%%%.%%%%%........%%%%..........%%.......%%%.%%......%%.%.%%%......%%%%....%%%%..%%%%...%%...
m %%......%%%%%%......%%%%%........%%%%%%%%%%%%%%%%%%%%%%%%%%%%%......%%%%%........%%%%%......%%%%%%......%%%%%%%%%%%%%%%%%%%%%%%%%%%%%%%%%%%%%%%%
m %%......%%%%%%......%%%%%%.......%%%%%%%%%%%%%%%%%%%%%%%%%%%%%......%%%%%%.......%%%%.......%%%%%.......%%%%%%%%%%%%%%%%%%%%%%%%%%%%%%%%%%%%%%%%
m %%......%%%%%........%%%%........%%%%%%%%%%%%%%%%%%%%%%%%%%%%%......%%%%%%......%%%%%........%%%%.......%%%%%%%%%%%%%%%%%%%%%%%%%%%%%%%%%%%%%%%%
m %%.......%%%%........%%%%.......%%%%%%%%%%%%%%%%%%%%%%%%%%%%%........%%%%.......%%%%%........%%%%%......%%%%%%%%%%%%%%%%%%%%%%%%%%%%%%%%%%%%%%%%
m ........%%%%%%........%..%.......%..%%.....%%.%.%..%%....%%.........%%%%%%.......%%..%.......%%%%%......%.%.%%%..%.%.%.%%.........%..%.%%..%.%..
m ........%%%%%%......................................................%%%%%%...................%%%%%..............................................
m ........%%%%%%......................................................%%%%%%..................%%%%%%..............................................
m ........%%%%%%.......................................................%%%%%..................%%%%%%..............................................
m ........%%%%%%.......................................................%%%%%...................%%%%%..............................................
m ........%%%%%%......................................................%%%%%%..................%%%%%%..............................................
m ........%%%%%%1.....................................................%%%%%....................%%%%%..............................................
m %........%%%%%.%..%%%%%.%.%..%....%..%........%%%%........%%%........%%%%.......%%.%....%.%%%%%%%%......%%%%.........%%.%........%...%.......%..
m %%.......%%%%%%%%%%%%%%%%%%%%%%%%%%%%%......%%%%%%......%%%%%.......%%%%%%......%%%%%%%%%%%%%%%%%%.......%%%%%......%%%%%%.......%%%%%.......%%%
m %%......%%%%%%%%%%%%%%%%%%%%%%%%%%%%%.......%%%%%%......%%%%%%.......%%%%........%%%%%%%%%%%%%%%%%.......%%%%.......%%%%%%.......%%%%.......%%%%
m %%.......%%%%%%%%%%%%%%%%%%%%%%%%%%%%.......%%%%%.......%%%%%........%%%%.......%%%%%%%%%%%%%%%%%.......%%%%%........%%%%%......%%%%%%.......%%%
m %%......%%%%%%%%%%%%%%%%%%%%%%%%%%%%%........%%%%%......%%%%%%.......%%%%%......%%%%%%%%%%%%%%%%%.......%%%%%%......%%%%%%......%%%%%%.......%%%
m %........%%%%%%%%%%%%..%....%.%%%..%........%..%.%.......%%%%.........%.%........%%%%%%%%%%%%%%..........%..%%..........%%.......%%%%%......%...
m ........%%%%%............................................%%%%...................%%%%%%..........................................................
m ........%%%%%............................................%%%%...................%%%%%%..........................................................
m ........%%%%%%...........................................%%%%%..................%%%%%%..........................................................
m ........%%%%%%...........................................%%%%....................%%%%%..........................................................
m ........%%%%%............................................%%%%%...................%%%%%..........................................................
m ........%%%%%%..........................................%%%%%%..................%%%%%%..........................................................
m %.......%%%%%%.......%%%%%..%.%%..%.%..%%%....%..%%%%.%.%%%%%%......%..%%.%.%%%%%%%%%%.%%%%%.%%.%.%.%%%.%.%%%.%%.%%.%..%..%..%%.%.%%........%...
m %.......%%%%%%......%%%%%%%%%%%%%%%%%%%%%%%%%%%%%%%%%%%%%%%%%.......%%%%%%%%%%%%%%%%%%%%%%%%%%%%%%%%%%%%%%%%%%%%%%%%%%%%%%%%%%%%%%%%%%.......%%%
m %%.......%%%%.......%%%%%%%%%%%%%%%%%%%%%%%%%%%%%%%%%%%%%%%%%.......%%%%%%%%%%%%%%%%%%%%%%%%%%%%%%%%%%%%%%%%%%%%%%%%%%%%%%%%%%%%%%%%%.......%%%%
m %%.......%%%%........%%%%%%%%%%%%%%%%%%%%%%%%%%%%%%%%%%%%%%%%%......%%%%%%%%%%%%%%%%%%%%%%%%%%%%%%%%%%%%%%%%%%%%%%%%%%%%%%%%%%%%%%%%%.......%%%%
m %%.......%%%%%.......%%%%%%%%%%%%%%%%%%%%%%%%%%%%%%%%%%%%%%%%.......%%%%%%%%%%%%%%%%%%%%%%%%%%%%%%%%%%%%%%%%%%%%%%%%%%%%%%%%%%%%%%%%%.......%%%%
m %........%.%........%....%%%%%%%.%.%.%..%%%...%.%...%..%.%%%.%.........%%.%%%%%%.%%%%%......%%.%.%...%.%%.%%.%...%.%..%%%%.%%.%.%%%%%.......%%%%
m %%........................................................................................................................0.....%%%%%........%%%
m %%..............................................................................................................................%%%%%%.......%%%
m %................................................................................................................................%%%%%.......%%%
m %...............................................................................................................................%%%%%........%%%
m %%...............................................................................................................................%%%%.......%%%%
m %%...............................................................................................................................%%%%%.......%%%
m %..........%%.......%%%.%%......%%.%.%%%......%%%%....%%%%..%%%%...%%...%.........%.%.......%..%%........%..%.%...%..%%.%%.%%%%.%%%%%........%%%
m %........%%%%%......%%%%%%......%%%%%%%%%%%%%%%%%%%%%%%%%%%%%%%%%%%%%%%%%%......%%%%%%......%%%%%........%%%%%%%%%%%%%%%%%%%%%%%%%%%%%......%%%%
m %%.......%%%%.......%%%%%.......%%%%%%%%%%%%%%%%%%%%%%%%%%%%%%%%%%%%%%%%%%......%%%%%%......%%%%%%.......%%%%%%%%%%%%%%%%%%%%%%%%%%%%%......%%%%
m %%......%%%%%........%%%%.......%%%%%%%%%%%%%%%%%%%%%%%%%%%%%%%%%%%%%%%%%%......%%%%%........%%%%........%%%%%%%%%%%%%%%%%%%%%%%%%%%%%......%%%%
m %.......%%%%%........%%%%%......%%%%%%%%%%%%%%%%%%%%%%%%%%%%%%%%%%%%%%%%%%.......%%%%........%%%%.......%%%%%%%%%%%%%%%%%%%%%%%%%%%%%........%%%
m %%.......%%..%.......%%%%%......%.%.%%%..%.%.%.%%.........%..%.%%..%.%..........%%%%%%........%..%.......%..%%.....%%.%.%..%%....%%.........%%%%
m %%...................%%%%%......................................................%%%%%%......................................................%%%%
m %%..................%%%%%%......................................................%%%%%%......................................................%%%%
m %%..................%%%%%%......................................................%%%%%%.......................................................%%%
m %%...................%%%%%......................................................%%%%%%.......................................................%%%
