# map type: blank
# random seed: 219050789
# hill distance  87,116  26,116  90, 58  72, 74  41, 74  23, 58
#        87,116       0      43     113     107     112     118 
#        26,116      43       0     118     112     107     113 
#        90, 58     113     118       0      34      83      83 
#        72, 74     107     112      34       0      51      83 
#        41, 74     112     107      83      51       0      34 
#        23, 58     118     113      83      83      34       0 
players 2
rows 96
cols 120
m %%................%.....%%.........%%%.........%%.................%.............................%%....%%...%%%.........%
m %%................%%....%...........%..........%%%...............%%............................%%.....%%....%%..........
m %.................%%...%%%..........%%.........%%.................%............................%%.....%%....%%.........%
m %......%%.%%....%%%%...%%....%..%.%%%....%......%%...%%%%%%%.%.%.%%..........%%%....%....%%%....%%....%%....%%....%%%%%%
m %%...%%%%%%%%%%%%%%%...%%.....%%%%%%%%...%%%....%....%%%%%%%%%%%%%%.....%%%%%%%%%%%%%....%%....%%....%%%....%%...%%%%%%%
m %....%....%%%%.%..%....%%%...%%%%%%%......%%.....%...%%%%%.%%..%...%.....%%...%%%%.%%%...%%.....%....%%%....%%.......%%%
m %.......................%%...............%%...........%...................................%%..........%%................
m %......................%%%...............%%%.........%%...................................%..........%%%................
m %%.....................%%................%%..........%%..................................%%%..........%%................
m %%.....................%%................%%..........%%..................................%%%..........%%................
m %......................%%%...............%%%.........%%...................................%..........%%%................
m %.......................%%...............%%...........%...................................%%..........%%................
m %....%....%%%%.%..%....%%%...%%%%%%%......%%.....%...%%%%%.%%..%...%.....%%...%%%%.%%%...%%.....%....%%%....%%.......%%%
m %%...%%%%%%%%%%%%%%%...%%.....%%%%%%%%...%%%....%....%%%%%%%%%%%%%%.....%%%%%%%%%%%%%....%%....%%....%%%....%%...%%%%%%%
m %......%%.%%....%%%%...%%....%..%.%%%....%......%%...%%%%%%%.%.%.%%..........%%%....%....%%%....%%....%%....%%....%%%%%%
m %.................%%...%%%..........%%.........%%.................%............................%%.....%%....%%.........%
m %%................%%....%...........%..........%%%...............%%............................%%.....%%....%%..........
m %%................%.....%%.........%%%.........%%.................%.............................%%....%%...%%%.........%
m %%%%.%.%..%..%...%%%...%%%.%%.%%....%%..%.%....%%%%.%%..%%.%.%...%%%%..%.....%.....%%.%........%%%....%%...%%%%.%..%....
m %%%%%%%%%%%%%%...%%%...%%%%%%%%....%%%%%%%%%%%%%%%%%%%%%%%%%%%....%%%%%%%%...%%%....%%%%%%%%....%%...%%.....%%%%%%%%....
m %%%..%%%.%.%%.....%....%%%.%%%%%.......%..%...%%%%.%.%%..%.%%....%%%..%.%%...%%.....%%.....%....%.....%%...%%%...%.....%
m %%..........%.....%%.........%%%................%...........%%................%....%%%.........%%...........%..........%
m %%..........%%....%%.........%%%................%%.........%%%...............%%....%%%..........%%..........%%.........%
m %%.........%%....%%%.........%%%................%.........0%%%...............%%%...%%..........%%...........%%.........%
m %%...%%%...%%.....%%%%..%....%%%%%...%%..%......%.....%....%%%%%%.%%....%.%%.%%%....%%...%%.....%......%%.%%%..........%
m %%....%....%%....%%%%%%%%.....%%%%%%%%%%%%%%....%.....%.....%%%%%%%.....%%%%%%%....%%....%%.....%%....%%%%%%%....%%.....
m %%...%%....%%....%%%.%.%%.....%%.%.%%%.%.%%..........%%.....%..%%%%.......%..%%....%%....%......%%....%%.%.%%%...%%.0..%
m %.....%.....%...........%.................%%.........%%%......................%.....%...........%%...%%....%%....%%....%
m %%....%....%%%..........%.................%..........%%%......................%%....%%.........%%.....%%...%%.....%.....
m %%....%.....%%..........%.................%..........%%.......................%.....%%..........%%....%%...%%%....%.....
m %....%%....%%%.%%.%%...%%%%%%%..%.%%%....%%%%%.%%%..%%%.....%%.....%...%......%.....%.........%%%....%%%....%%...%%%%..%
m %....%%%....%%%%%%%.....%%%%%%%%%%%%%%...%%%%%%%%%%%%%%%....%.....%%%%%%%%....%%....%%....%%%%%%%....%%....%%%...%%%%%%%
m %%...%%%.....%%%%%%%...%%%%%.%..%.%%%....%.%.%....%%%......%%....%.%%.%%%.....%%....%.....%%%%.%.%.........%%....%%%....
m .....%%%..........%%...............%%.......................%...........%..........%%.....%%................%...........
m .....%%%.........%%%...............%%......................%%%.........%%..........%%%....%................%%...........
m ......%...........%%...............%%......................%%%.........%%...........%.....%................%%%..........
m ......%%.%.%%....%%%...%%%%.%%......%%...%..%%.%%%%.%.%%%%.%%.....%%...%%....%%%...%%%....%%%..%...%.%.%....%%.%%%..%.%.
m %....%%%%%%%%....%%%%%%%%%%%%%%.....%%%%%%%%%%%%%%%%%%%%%%%%%%....%%...%%%....%%....%....%%%%%%%%%%%%%%.....%%%%%%%%%%%%
m %....%.%.%%%%%.......%%%%.%%.%%......%..%.....%%%%...%%...%%.%...%%....%%....%.%....%....%....%%%%%%..%%...%%%.....%%.%%
m %%..........%%...............%%................%%%................%.................%%..........%...........%%.........%
m %%.........%%................%%%...............%%%................%%................%..........%%...........%...........
m %..........%%.................%%................%%................%.......1........%%%.........%%%.........%%..........%
m %%......%%%%%%...%%%.%%..%....%%%..%...%%.%....%%%....%....%%%%.%%%%%%%.%.%%.%%.....%%..%.%....%%%%..%%%.%%%%....%.....%
m %%....%%%%%%%%%%%%%%%%%%%%...%%%%%%%%%%%%%%....%%%....%.....%%%%%%%%%%%%%%%%%%%%....%%%%%%%.....%%%%%%%%%%%%%.....%%....
m %.....%%%%%..%.%.%%%%%.%%%....%%..%.%%%%%%%%...%%....%.%....%%...%%%..%%%%%...%%....%%.%...%...%%%..%%..%%%.%....%%....%
m %%...%%%..........%...........%...........%%...%%................%%%...............%%...........%%................%....%
m %....%%..........%%..........%%...........%.....%%................%%...............%%%..........%%................%.....
m %....%%..........%%...........%%..........%%...%%%................%%...............%%%.........%%%...............%%....%
m %%%..%%%...%.....%%%....%%....%%%%%%%%...%%....%%%%.%..%.%.%.%...%%....%.%...%.%.%.%%%...%.%...%%....%....%..%.%%%%%...%
m %%%%%%%....%%.....%.....%....%%%%%%%%.....%.....%%%%%%%%%%%%%....%%%...%%.....%%%%%%%%....%%%%%%%.....%%%%%%%%%%%%%....%
m %%%.%.......%%...%.%....%%...%%%.%%%%....%%....%%%%%%...%.%..%...%%%....%%...%%%.%...%....%...%%.....%%%%.%.%%%%.%......
m ...........%%%.........%%.................%.......................%%..................................%.................
m ............%..........%%%................%%......................%%.................................%%%................
m ...........%%%..........%%...............%%......................%%%.................................%%%................
m %........%.%%%%%%%.%%%.%%%.....%..%.%.%..%%%...%%%.........%.%....%%..%.%%....%%.......%%%%%.....%....%%.....%...%.%...%
m %%...%%%%%%%%%%%%%%%%%%%%%...%%%%%%%%%%%%%%%%%%%%%....%....%%.....%%%%%%%....%%%....%%%%%%%.....%%...%%%%%%%%%....%%...%
m %....%%%%%%%%%%%%%%%%%%%%%...%%%%%%%%%%%%%%%%%%%%.....%%....%....%%%%%%%%.....%....%%%%%%%%%....%....%%%%%%%%%....%%....
m %....%%%%%%%%%%%%%%%%%%%%%...%%%%%%%%%%%%%%%%%%%%.....%%....%....%%%%%%%%.....%....%%%%%%%%%....%....%%%%%%%%%....%%....
m %%...%%%%%%%%%%%%%%%%%%%%%...%%%%%%%%%%%%%%%%%%%%%....%....%%.....%%%%%%%....%%%....%%%%%%%.....%%...%%%%%%%%%....%%...%
m %........%.%%%%%%%.%%%.%%%.....%..%.%.%..%%%...%%%.........%.%....%%..%.%%....%%.......%%%%%.....%....%%.....%...%.%...%
m ...........%%%..........%%...............%%......................%%%.................................%%%................
m ............%..........%%%................%%......................%%.................................%%%................
m ...........%%%.........%%.................%.......................%%..................................%.................
m %%%.%.......%%...%.%....%%...%%%.%%%%....%%....%%%%%%...%.%..%...%%%....%%...%%%.%...%....%...%%.....%%%%.%.%%%%.%......
m %%%%%%%....%%.....%.....%....%%%%%%%%.....%.....%%%%%%%%%%%%%....%%%...%%.....%%%%%%%%....%%%%%%%.....%%%%%%%%%%%%%....%
m %%%..%%%...%.....%%%....%%....%%%%%%%%...%%....%%%%.%..%.%.%.%...%%....%.%...%.%.%.%%%...%.%...%%....%....%..%.%%%%%...%
m %....%%..........%%...........%%..........%%...%%%................%%...............%%%.........%%%...............%%....%
m %....%%..........%%..........%%...........%.....%%................%%...............%%%..........%%................%.....
m %%...%%%..........%...........%...........%%...%%................%%%...............%%...........%%................%....%
m %.....%%%%%..%.%.%%%%%.%%%....%%..%.%%%%%%%%...%%....%.%....%%...%%%..%%%%%...%%....%%.%...%...%%%..%%..%%%.%....%%....%
m %%....%%%%%%%%%%%%%%%%%%%%...%%%%%%%%%%%%%%....%%%....%.....%%%%%%%%%%%%%%%%%%%%....%%%%%%%.....%%%%%%%%%%%%%.....%%....
m %%......%%%%%%...%%%.%%..%....%%%..%...%%.%....%%%....%....%%%%.%%%%%%%.%.%%.%%.....%%..%.%....%%%%..%%%.%%%%....%.....%
m %..........%%.................%%................%%................%.......0........%%%.........%%%.........%%..........%
m %%.........%%................%%%...............%%%................%%................%..........%%...........%...........
m %%..........%%...............%%................%%%................%.................%%..........%...........%%.........%
m %....%.%.%%%%%.......%%%%.%%.%%......%..%.....%%%%...%%...%%.%...%%....%%....%.%....%....%....%%%%%%..%%...%%%.....%%.%%
m %....%%%%%%%%....%%%%%%%%%%%%%%.....%%%%%%%%%%%%%%%%%%%%%%%%%%....%%...%%%....%%....%....%%%%%%%%%%%%%%.....%%%%%%%%%%%%
m ......%%.%.%%....%%%...%%%%.%%......%%...%..%%.%%%%.%.%%%%.%%.....%%...%%....%%%...%%%....%%%..%...%.%.%....%%.%%%..%.%.
m ......%...........%%...............%%......................%%%.........%%...........%.....%................%%%..........
m .....%%%.........%%%...............%%......................%%%.........%%..........%%%....%................%%...........
m .....%%%..........%%...............%%.......................%...........%..........%%.....%%................%...........
m %%...%%%.....%%%%%%%...%%%%%.%..%.%%%....%.%.%....%%%......%%....%.%%.%%%.....%%....%.....%%%%.%.%.........%%....%%%....
m %....%%%....%%%%%%%.....%%%%%%%%%%%%%%...%%%%%%%%%%%%%%%....%.....%%%%%%%%....%%....%%....%%%%%%%....%%....%%%...%%%%%%%
m %....%%....%%%.%%.%%...%%%%%%%..%.%%%....%%%%%.%%%..%%%.....%%.....%...%......%.....%.........%%%....%%%....%%...%%%%..%
m %%....%.....%%..........%.................%..........%%.......................%.....%%..........%%....%%...%%%....%.....
m %%....%....%%%..........%.................%..........%%%......................%%....%%.........%%.....%%...%%.....%.....
m %.....%.....%...........%.................%%.........%%%......................%.....%...........%%...%%....%%....%%....%
m %%...%%....%%....%%%.%.%%.....%%.%.%%%.%.%%..........%%.....%..%%%%.......%..%%....%%....%......%%....%%.%.%%%...%%.1..%
m %%....%....%%....%%%%%%%%.....%%%%%%%%%%%%%%....%.....%.....%%%%%%%.....%%%%%%%....%%....%%.....%%....%%%%%%%....%%.....
m %%...%%%...%%.....%%%%..%....%%%%%...%%..%......%.....%....%%%%%%.%%....%.%%.%%%....%%...%%.....%......%%.%%%..........%
m %%.........%%....%%%.........%%%................%.........1%%%...............%%%...%%..........%%...........%%.........%
m %%..........%%....%%.........%%%................%%.........%%%...............%%....%%%..........%%..........%%.........%
m %%..........%.....%%.........%%%................%...........%%................%....%%%.........%%...........%..........%
m %%%..%%%.%.%%.....%....%%%.%%%%%.......%..%...%%%%.%.%%..%.%%....%%%..%.%%...%%.....%%.....%....%.....%%...%%%...%.....%
m %%%%%%%%%%%%%%...%%%...%%%%%%%%....%%%%%%%%%%%%%%%%%%%%%%%%%%%....%%%%%%%%...%%%....%%%%%%%%....%%...%%.....%%%%%%%%....
m %%%%.%.%..%..%...%%%...%%%.%%.%%....%%..%.%....%%%%.%%..%%.%.%...%%%%..%.....%.....%%.%........%%%....%%...%%%%.%..%....
