# map type: blank
# random seed: -1656456606
# hill distance  95,118  10,118  10, 17  95, 17
#        95,118       0      23     122     111 
#        10,118      23       0     111     122 
#        10, 17     122     111       0      23 
#        95, 17     111     122      23       0 
players 4
rows 108
cols 132
m %%%%%%%%%%....%%%...%%%%%%%%.....%%%%%%%%...%%%%%%%%.....%.....%%%%%%%%%%.....%.....%%%%%%%%...%%%%%%%%.....%%%%%%%%...%%%....%%%%%%
m %%%%%%..%.....%%%....%.%..%%....%...%%..%....%%%%%%%......%.....%%....%%.....%......%%%%%%%....%..%%...%....%%..%.%....%%%.....%..%%
m %%%%...........%..........%%%................%%..........................................%%................%%%..........%...........
m %%%%%..........%%.........%%%................%%..........................................%%................%%%.........%%..........%
m %%%%%.........%%...........%.................%............................................%.................%...........%%.........%
m %%%%%...%%%...%%....%%....%%%...%......%%%..%%....%...%%.%..%.%%........%%.%..%.%%...%....%%..%%%......%...%%%....%%....%%...%%%...%
m %%%%%...%%....%%....%%.....%....%%%....%%%%%%%....%%%%%%%%%%%%%%%......%%%%%%%%%%%%%%%....%%%%%%%....%%%....%.....%%....%%....%%...%
m ....%....%.....%%....%....%%%...%%%......%%.%.%....%%%...%%...%%%......%%%...%%...%%%....%.%.%%......%%%...%%%....%....%%.....%....%
m ..............%%.....%%...%%.....%%................%%.........%%........%%.........%%................%%.....%%...%%.....%%..........
m ..............%%%....%.....%.....%................%%...........%........%...........%%................%.....%.....%....%%%..........
m ...............%.2..%%%....%%...%%................%%%..........%........%..........%%%................%%...%%....%%%..3.%...........
m %..%....%.%...%%%%%.%%.....%%...%%....%%%...%.%...%%%...%.%%%.%%........%%.%%%.%...%%%...%.%...%%%....%%...%%.....%%.%%%%%...%.%....
m %%%%%....%.....%%%%%%%....%%.....%%....%%%%%%%%....%.....%%%%%%%........%%%%%%%.....%....%%%%%%%%....%%.....%%....%%%%%%%.....%....%
m %%%%.....%%....%%%%%%%.....%.....%%....%%.%%%%%...%%....%%.%%.%%%......%%%.%%.%%....%%...%%%%%.%%....%%.....%.....%%%%%%%....%%.....
m %%%%%...%%%.........%%.....%...........%%......................%........%......................%%...........%.....%%.........%%%...%
m %%%%....%%..........%%%....%...........%.......................%%......%%.......................%...........%....%%%..........%%....
m %%%%%...%%%..........%%...%%%..........%.......................%%......%%.......................%..........%%%...%%..........%%%...%
m %%%%%..%%%%.%%%......%.....%......%%%%%%%.%..%..%.........%....%%......%%....%.........%..%..%.%%%%%%%......%.....%......%%%.%%%%..%
m %%%%%%%%%%%%%%%%%...%%.....%%....%%%%%%%%%%%%%%%%%%%%...%%%....%........%....%%%...%%%%%%%%%%%%%%%%%%%%....%%.....%%...%%%%%%%%%%%%%
m %%%%%.%%.%.%.%.%%...%%%...%%....%%%.%.%.%.%.%%.%%.%%%....%....%%%......%%%....%....%%%.%%.%%.%.%.%.%.%%%....%%...%%%...%%.%.%.%.%%.%
m %%%%.................%%...%%%....%................%%.....%....%%........%%....%.....%%................%....%%%...%%.................
m %%%%.................%....%%%....%.................%%....%%...%%%......%%%...%%....%%.................%....%%%....%.................
m %%%%.................%%....%....%%.................%%...%%%....%........%....%%%...%%.................%%....%....%%.................
m %%%%%...%%%.%.%%...%%%%....%%....%.....%%%..%%%...%%%%%.%%%...%%%......%%%...%%%.%%%%%...%%%..%%%.....%....%%....%%%%...%%.%.%%%...%
m %%%%.....%%%%%%%%%%%%%%...%%%....%%....%%%%%%%%...%%%%%%%%%...%%........%%...%%%%%%%%%...%%%%%%%%....%%....%%%...%%%%%%%%%%%%%%.....
m ..........%..%%.%%%%%%....%%%...%.....%%%.%%..%...%%%%%..%%....%%......%%....%%..%%%%%...%..%%.%%%.....%...%%%....%%%%%%.%%..%......
m ...........................%..........%%%..........%%..........%%......%%..........%%..........%%%..........%.......................
m ...........................%%..........%..........%%...........%........%...........%%..........%..........%%.......................
m ..........................%%%..........%%.........%%%.........%%%......%%%.........%%%.........%%..........%%%......................
m .%%.....%%%%%.%%.%%.%.%.%.%%%%..%...%.%%%...%%%%..%%%...%%%..%%%%......%%%%..%%%...%%%..%%%%...%%%.%...%..%%%%.%.%.%.%%.%%.%%%%%....
m %%%%%....%%%%%%%%%%%%%%%%%%%%%%%%%%%%%%%.....%%%%%%%.....%%%%%%%........%%%%%%%.....%%%%%%%.....%%%%%%%%%%%%%%%%%%%%%%%%%%%%%%%....%
m %%%%%....%%%..%%.%%......%%.%%%.%%%%..%.%....%%%.........%%...%%%......%%%...%%.........%%%....%.%..%%%%.%%%.%%......%%.%%..%%%....%
m %%%%....%%.......................%%.........%%...........%%..................%%...........%%.........%%.......................%%....
m %%%%.....%.......................%%.........%%...........%%..................%%...........%%.........%%.......................%.....
m %%%%....%%%......................%...........%%.........%%....................%%.........%%...........%......................%%%....
m %%%%....%%%%..%%%....%.%.%.%%...%%%...%....%%%%....%%....%....%..........%....%....%%....%%%%....%...%%%...%%.%.%.%....%%%..%%%%....
m %%%%%...%%%%%%%%....%%%%%%%%.....%%...%%%%%%%%....%%....%%%...%%%......%%%...%%%....%%....%%%%%%%%...%%.....%%%%%%%%....%%%%%%%%...%
m ........%...%.%%....%%%%.%%%%.....%...%%%...%%%...%%%...%%....%%........%%....%%...%%%...%%%...%%%...%.....%%%%.%%%%....%%.%...%....
m ..............%%..........%%%.........%%..........%%%....%%....%........%....%%....%%%..........%%.........%%%..........%%..........
m ..............%%%.........%%%..........%..........%%%....%%...%%%......%%%...%%....%%%..........%..........%%%.........%%%..........
m ..............%%%.........%%%.........%%%..........%.....%%...%%%......%%%...%%.....%..........%%%.........%%%.........%%%..........
m %%%%%..%%......%%%......%.%%%......%..%%%...%%%%..%%%...%%%...%%%..%%..%%%...%%%...%%%..%%%%...%%%..%......%%%.%......%%%......%%..%
m %%%%%%%%%%.....%%%%%%%%%%%%%%....%%%%%%%%%%%%%%%%%%%%...%%.....%%%%%%%%%%.....%%...%%%%%%%%%%%%%%%%%%%%....%%%%%%%%%%%%%%.....%%%%%%
m %%%%%%.%..%....%%%%.%...%.%%......%%..%..%%......%%.....%%......%%....%%......%%.....%%......%%..%..%%......%%.%...%.%%%%....%..%.%%
m %%%%...........%%..........%............................%%%..................%%%............................%..........%%...........
m %%%%%.........%%%.........%%%...........................%%%..................%%%...........................%%%.........%%%.........%
m %%%%%.........%%..........%%............................%%%..................%%%............................%%..........%%.........%
m %%%%....%.%%%.%%.....%.....%%.......%%...%.%%.%.%%%%.%%.%%%...%%%......%%%...%%%.%%.%%%%.%.%%.%...%%.......%%.....%.....%%.%%%.%....
m %%%%....%%%%%%%%.....%%...%%%%%%%%%%%%%%%%%%%%%%%%%%%%%%%%%%%%%%%......%%%%%%%%%%%%%%%%%%%%%%%%%%%%%%%%%%%%%%%...%%.....%%%%%%%%....
m %%%%......%....%%...%%.....%%%%...%..%%%....%.%..%%.%%..%%.%%.%%%......%%%.%%.%%..%%.%%..%.%....%%%..%...%%%%.....%%...%%....%......
m %%%%%................%%..........................................................................................%%................%
m %%%%%................%%..........................................................................................%%................%
m %%%%.................%............................................................................................%.................
m %%%%.................%............................................................................................%.................
m %%%%%................%%..........................................................................................%%................%
m %%%%%................%%..........................................................................................%%................%
m %%%%......%....%%...%%.....%%%%...%..%%%....%.%..%%.%%..%%.%%.%%%......%%%.%%.%%..%%.%%..%.%....%%%..%...%%%%.....%%...%%....%......
m %%%%....%%%%%%%%.....%%...%%%%%%%%%%%%%%%%%%%%%%%%%%%%%%%%%%%%%%%......%%%%%%%%%%%%%%%%%%%%%%%%%%%%%%%%%%%%%%%...%%.....%%%%%%%%....
m %%%%....%.%%%.%%.....%.....%%.......%%...%.%%.%.%%%%.%%.%%%...%%%......%%%...%%%.%%.%%%%.%.%%.%...%%.......%%.....%.....%%.%%%.%....
m %%%%%.........%%..........%%............................%%%..................%%%............................%%..........%%.........%
m %%%%%.........%%%.........%%%...........................%%%..................%%%...........................%%%.........%%%.........%
m %%%%...........%%..........%............................%%%..................%%%............................%..........%%...........
m %%%%%%.%..%....%%%%.%...%.%%......%%..%..%%......%%.....%%......%%....%%......%%.....%%......%%..%..%%......%%.%...%.%%%%....%..%.%%
m %%%%%%%%%%.....%%%%%%%%%%%%%%....%%%%%%%%%%%%%%%%%%%%...%%.....%%%%%%%%%%.....%%...%%%%%%%%%%%%%%%%%%%%....%%%%%%%%%%%%%%.....%%%%%%
m %%%%%..%%......%%%......%.%%%......%..%%%...%%%%..%%%...%%%...%%%..%%..%%%...%%%...%%%..%%%%...%%%..%......%%%.%......%%%......%%..%
m ..............%%%.........%%%.........%%%..........%.....%%...%%%......%%%...%%.....%..........%%%.........%%%.........%%%..........
m ..............%%%.........%%%..........%..........%%%....%%...%%%......%%%...%%....%%%..........%..........%%%.........%%%..........
m ..............%%..........%%%.........%%..........%%%....%%....%........%....%%....%%%..........%%.........%%%..........%%..........
m ........%...%.%%....%%%%.%%%%.....%...%%%...%%%...%%%...%%....%%........%%....%%...%%%...%%%...%%%...%.....%%%%.%%%%....%%.%...%....
m %%%%%...%%%%%%%%....%%%%%%%%.....%%...%%%%%%%%....%%....%%%...%%%......%%%...%%%....%%....%%%%%%%%...%%.....%%%%%%%%....%%%%%%%%...%
m %%%%....%%%%..%%%....%.%.%.%%...%%%...%....%%%%....%%....%....%..........%....%....%%....%%%%....%...%%%...%%.%.%.%....%%%..%%%%....
m %%%%....%%%......................%...........%%.........%%....................%%.........%%...........%......................%%%....
m %%%%.....%.......................%%.........%%...........%%..................%%...........%%.........%%.......................%.....
m %%%%....%%.......................%%.........%%...........%%..................%%...........%%.........%%.......................%%....
m %%%%%....%%%..%%.%%......%%.%%%.%%%%..%.%....%%%.........%%...%%%......%%%...%%.........%%%....%.%..%%%%.%%%.%%......%%.%%..%%%....%
m %%%%%....%%%%%%%%%%%%%%%%%%%%%%%%%%%%%%%.....%%%%%%%.....%%%%%%%........%%%%%%%.....%%%%%%%.....%%%%%%%%%%%%%%%%%%%%%%%%%%%%%%%....%
m .%%.....%%%%%.%%.%%.%.%.%.%%%%..%...%.%%%...%%%%..%%%...%%%..%%%%......%%%%..%%%...%%%..%%%%...%%%.%...%..%%%%.%.%.%.%%.%%.%%%%%....
m ..........................%%%..........%%.........%%%.........%%%......%%%.........%%%.........%%..........%%%......................
m ...........................%%..........%..........%%...........%........%...........%%..........%..........%%.......................
m ...........................%..........%%%..........%%..........%%......%%..........%%..........%%%..........%.......................
m ..........%..%%.%%%%%%....%%%...%.....%%%.%%..%...%%%%%..%%....%%......%%....%%..%%%%%...%..%%.%%%.....%...%%%....%%%%%%.%%..%......
m %%%%.....%%%%%%%%%%%%%%...%%%....%%....%%%%%%%%...%%%%%%%%%...%%........%%...%%%%%%%%%...%%%%%%%%....%%....%%%...%%%%%%%%%%%%%%.....
m %%%%%...%%%.%.%%...%%%%....%%....%.....%%%..%%%...%%%%%.%%%...%%%......%%%...%%%.%%%%%...%%%..%%%.....%....%%....%%%%...%%.%.%%%...%
m %%%%.................%%....%....%%.................%%...%%%....%........%....%%%...%%.................%%....%....%%.................
m %%%%.................%....%%%....%.................%%....%%...%%%......%%%...%%....%%.................%....%%%....%.................
m %%%%.................%%...%%%....%................%%.....%....%%........%%....%.....%%................%....%%%...%%.................
m %%%%%.%%.%.%.%.%%...%%%...%%....%%%.%.%.%.%.%%.%%.%%%....%....%%%......%%%....%....%%%.%%.%%.%.%.%.%.%%%....%%...%%%...%%.%.%.%.%%.%
m %%%%%%%%%%%%%%%%%...%%.....%%....%%%%%%%%%%%%%%%%%%%%...%%%....%........%....%%%...%%%%%%%%%%%%%%%%%%%%....%%.....%%...%%%%%%%%%%%%%
m %%%%%..%%%%.%%%......%.....%......%%%%%%%.%..%..%.........%....%%......%%....%.........%..%..%.%%%%%%%......%.....%......%%%.%%%%..%
m %%%%%...%%%..........%%...%%%..........%.......................%%......%%.......................%..........%%%...%%..........%%%...%
m %%%%....%%..........%%%....%...........%.......................%%......%%.......................%...........%....%%%..........%%....
m %%%%%...%%%.........%%.....%...........%%......................%........%......................%%...........%.....%%.........%%%...%
m %%%%.....%%....%%%%%%%.....%.....%%....%%.%%%%%...%%....%%.%%.%%%......%%%.%%.%%....%%...%%%%%.%%....%%.....%.....%%%%%%%....%%.....
m %%%%%....%.....%%%%%%%....%%.....%%....%%%%%%%%....%.....%%%%%%%........%%%%%%%.....%....%%%%%%%%....%%.....%%....%%%%%%%.....%....%
m %..%....%.%...%%%%%.%%.....%%...%%....%%%...%.%...%%%...%.%%%.%%........%%.%%%.%...%%%...%.%...%%%....%%...%%.....%%.%%%%%...%.%....
m ...............%.0..%%%....%%...%%................%%%..........%........%..........%%%................%%...%%....%%%..1.%...........
m ..............%%%....%.....%.....%................%%...........%........%...........%%................%.....%.....%....%%%..........
m ..............%%.....%%...%%.....%%................%%.........%%........%%.........%%................%%.....%%...%%.....%%..........
m ....%....%.....%%....%....%%%...%%%......%%.%.%....%%%...%%...%%%......%%%...%%...%%%....%.%.%%......%%%...%%%....%....%%.....%....%
m %%%%%...%%....%%....%%.....%....%%%....%%%%%%%....%%%%%%%%%%%%%%%......%%%%%%%%%%%%%%%....%%%%%%%....%%%....%.....%%....%%....%%...%
m %%%%%...%%%...%%....%%....%%%...%......%%%..%%....%...%%.%..%.%%........%%.%..%.%%...%....%%..%%%......%...%%%....%%....%%...%%%...%
m %%%%%.........%%...........%.................%............................................%.................%...........%%.........%
m %%%%%..........%%.........%%%................%%..........................................%%................%%%.........%%..........%
m %%%%...........%..........%%%................%%..........................................%%................%%%..........%...........
m %%%%%%..%.....%%%....%.%..%%....%...%%..%....%%%%%%%......%.....%%....%%.....%......%%%%%%%....%..%%...%....%%..%.%....%%%.....%..%%
m %%%%%%%%%%....%%%...%%%%%%%%.....%%%%%%%%...%%%%%%%%.....%.....%%%%%%%%%%.....%.....%%%%%%%%...%%%%%%%%.....%%%%%%%%...%%%....%%%%%%
m %%%%%%%%%%%...%%....%%%%%%%%%....%%%%%%%.....%%%%%%%%....%....%%%%%%%%%%%%....%....%%%%%%%%.....%%%%%%%....%%%%%%%%%....%%...%%%%%%%
m %%%%%%%%%%%...%%....%%%%%%%%%....%%%%%%%.....%%%%%%%%....%....%%%%%%%%%%%%....%....%%%%%%%%.....%%%%%%%....%%%%%%%%%....%%...%%%%%%%
