# map type: blank
# random seed: -1183420640
# hill distance 109, 47  45,109 100,104 102, 97  72, 82 107, 54  10, 14  32, 42  17, 12  60,  7  67,  5   5, 69
#       109, 47       0     126      80      71      86       9      66      70      75      91      84      50 
#        45,109     126       0      70      69      54     117      86     116      77      45      50     146 
#       100,104      80      70       0       9      50      71      84     126      91      75      66      86 
#       102, 97      71      69       9       0      45      62      91     117      94      84      75      77 
#        72, 82      86      54      50      45       0      77     126     146     117      69      70     116 
#       107, 54       9     117      71      62      77       0      75      69      84      94      91      45 
#        10, 14      66      86      84      91     126      75       0      50       9      71      80      70 
#        32, 42      70     116     126     117     146      69      50       0      45      77      86      54 
#        17, 12      75      77      91      94     117      84       9      45       0      62      71      69 
#        60,  7      91      45      75      84      69      94      71      77      62       0       9     117 
#        67,  5      84      50      66      75      70      91      80      86      71       9       0     126 
#         5, 69      50     146      86      77     116      45      70      54      69     117     126       0 
players 4
rows 132
cols 132
m %.......%%%%........%%%%%......%%%%%%%%%...............................%%%%%.......%%%%....................%%%%%%%%.............%%%%
m %.......%%%%%......%%%%%........%%%%%%%%...............................%%%%........%%%%%..................%%%%%%%%%.............%%%%
m %......%%%.%%......%%%%%.......%%%.%%%%%...............................%%%%%.......%%%%...................%%%%%%%%%.............%%%%
m %..................%%%%%%..............................................%%%%.......%%%%%%...................%%%%%%%%%%...........%%%%
m %...................%%%%%.............................................%%%%%........%%%%%...................%%%%%%%%%%%%%%......%%%%%
m %..................%%%%%%............................................1.%%%%%.......%%%%%..................%%%%%%%%%%%%%%%.......%%%%
m %...................%%%%%..................%%%%...%%......%.%..%......%%%%%.......%%%%%%......%....%..%...%%%%%%%%%%%%%%.......%%%%%
m %...................%%%%...................%%%%%%%%.......%%%%%........%%%%%.......%%%%%.......%%%%%%%%%%%%%%%%%%%%%%%%%%......%%%%%
m %...................%%%%...................%%%%%%%%.......%%%%%%......%%%%%%......%%%%%%.......%%%%%%%%%%%%%%%..%%..%..........%%%.%
m .%.%%..%.%%........%%%%%%......%%..........%%%%%%%%........%%%%........%%%%%......%%%%%%.......%%%%%%%%%%%%%........................
m .%%%%%%%%%%%..2....%%%%%........%%%%........%%%%%%%%.......%%%%........%%%%%.......%%%%%......%%%%%%%%%%%%%%........................
m .%%%%%%%%%%%.......%%%%%%.......%%%%........%%%%%%%%......%%%%%%......%%..%........%%%%.............%%%%%%%%........................
m .%%%%%%%%%%%.......%%%%%%.......%%%%%.......%%%%%%%%.......%%%%%..................%%%%%%............%%%%%%%%%.......................
m .%%%%%%%%%%%........%%%%%.......%%%%.......%%%%%%%%%......%%%%%...................%%%%%.............%%%%%%%%........................
m ...%%%.%%%%.%..........%%........%.........%...%%%%%.......%%%%%..................%%%%%.............%%%%%%%%........................
m ..........................................................%%%%%....................%%%%%................%%%%%........%%%%.......%%.%
m %.........................................................%%%%%...................%%%%%%................%%%%........%%%%%.......%%%%
m %...........2.............................................%%%%%....................%%%%%................%%%%........%%%%%......%%%%%
m %......................................................%%%%%%%%%...%.%..%.%.......%%%%%%.%%%..%%%.......%%%%........%%%%........%%%%
m %......................................................%%%%%%%%%%%%%%%%%%%%%.......%%%%%%%%%%%%%%.......%%%%........%%%%.......%%%%%
m %......................................................%%%%%%%%%%%%%%%%%%%%%......%%%%%%%%%%%%%%%.......%...%......%%%%%.......%..%%
m .......%%%%.....%%%...%........%%%.%%......%%%..%.%.%%%%%%%%%%%%%%%%%%%%%%%%......%%%%%%%%%%%%%%....................%%%%%...........
m ........%%%%%%%%%%%%%%%%%......%%%%%........%%%%%%%%%%%%%%%%%%%%%%%%%%%%%%%%.......%%%%%%%%%%%%%...................%%%%%............
m .......%%%%%%%%%%%%%%%%%........%%%%.......%%%%%%%%%%%%%%%%%%%%%%%%.%%%...%%.......%%%%%%%%%%%%%%...................%%%%............
m ........%%%%%%%%%%%%%%%%%.......%%%%%.......%%%%%%%%%%%%%%%%%%%%..................%%%%%%%%%%%%%%%...................%%%%............
m .......%%%%%%%%%%%%%%%%%%......%%%%%%.......%%%%%%%%%%%%%%%%%%%%..................%%%%%%%%%%%%%%%..................%%%%%%...........
m .......%.%%...%%%.%%%%%%........%%%%%......%.%..%%.%...%%%%%%%%%...................%%%%%%%%%%%%%....................%%%%............
m ...................%%%%%%.......%%%%%...................%%%%%......................%%%%%%%%%%%%%%%%%..%.%%%%%%%%.%.%%%%%%.......%%..
m %...................%%%%........%%%%....................%%%%%......................%%%%%%%%%%%%%%%%%%%%%%%%%%%%%%%%%%%%%.......%%%%%
m %...................%%%%%......%%%%%%...................%%%%%.....................%%%%%%%%%%%%%%%%%%%%%%%%%%%%%%%%%%%%%%........%%%%
m %..................%%%%%%.......%%%%%..................%%%%%.....................%%%%%%%%%%%%%%%%%%%%%%%%%%%%%%%%%%%%%%%%......%%%%%
m %..................%%%%%........%%%%%...................%%%%%..................%%%%%%%%%%%%%%%%%%%%%%%%%%%%%%%%%%%%%%%%%.......%%%%%
m %..................%%%%%%.......%%%%%.....3............%%%%%%..................%%%%%%%...%%..%%.%.%.%%%..%%.%..%...%.%%%%.......%%%%
m %.......%%..........%%%%.......%%%%%%....%.%.%..%.......%%%%%.........%%.%.%..%%%%%%%..........................................%%%%%
m .......%%%%%%......%%%%%%.......%%%%%%%%%%%%%%%%%.......%%%%..........%%%%%%%%%%%%%%............................................%%%%
m .......%%%%%.......%%%%%%.......%%%%%%%%%%%%%%%%.......%%%%%...........%%%%%%%%%%%%%...........................................%%%%%
m .......%%%%%.......%%%%%%......%%%%%%%%%%%%%%%%%........%%%%..........%%%%%%%%%%%%.............................................%%%%%
m %......%%%%%.......%%%%%%.......%%%%%%%%%%%%%%%%%......%%%%%%..........%%%%%%%%%%..............................................%%%%%
m %......%%%%%........%%%%%......%%..%.%.%..%.%%%%........%%%%%.........%%%%%%%%%%%...............................................%%%%
m ........%%%%%......%%%%%...............................................%%%%%%%%%%%.........%%%%%........%%%%.%..%.%.%..%%......%%%%%
m %.......%%%%%......%%%%%%..............................................%%%%%%%%%%..........%%%%%%......%%%%%%%%%%%%%%%%%.......%%%%%
m %.......%%%%%.......%%%%%.............................................%%%%%%%%%%%%..........%%%%........%%%%%%%%%%%%%%%%%......%%%%%
m %.......%%%%%.......%%%%%...........................................%%%%%%%%%%%%%...........%%%%%.......%%%%%%%%%%%%%%%%.......%%%%%
m %......%%%%%%.......%%%%............................................%%%%%%%%%%%%%%..........%%%%.......%%%%%%%%%%%%%%%%%.......%%%%%
m ..........%%.......%%%%%%..........................................%%%%%%%..%.%.%%.........%%%%%.......%..%.%.%....%%%%%%.......%%%%
m %..................%%%%%.......%%%%.%...%..%.%%..%%%.%.%.%%..%%...%%%%%%%..................%%%%%%............2.....%%%%%.......%%%%%
m %..................%%%%%%.......%%%%%%%%%%%%%%%%%%%%%%%%%%%%%%%%%%%%%%%%%..................%%%%%...................%%%%%........%%%%
m %..................%%%%%%......%%%%%%%%%%%%%%%%%%%%%%%%%%%%%%%%%%%%%%%%.....................%%%%%..................%%%%%.......%%%%%
m ...................%%%%%........%%%%%%%%%%%%%%%%%%%%%%%%%%%%%%%%%%%%%%.....................%%%%%...................%%%%%%......%%%%%
m ...................%%%%%%.......%%%%%%%%%%%%%%%%%%%%%%%%%%%%%%%%%%%%%......................%%%%%....................%%%%........%%%%
m %.....................%%.......%%%%%%.%.%%%%%%%%.%..%%%%%%%%%%%%%%%%%......................%%%%%...................%%%%%.......%%%%%
m %%.%%%...%%.%...................%%%%....................%%%%%%%%%%%%%...................%%%%%%%%%...%.%%..%.%......%%%%%........%%%%
m %%%%%%%%%%%%%..................%%%%%%..................%%%%%%%%%%%%%%%..................%%%%%%%%%%%%%%%%%%%%.......%%%%%%......%%%%%
m %%%%%%%%%%%%....................%%%%...................%%%%%%%%%%%%%%%..................%%%%%%%%%%%%%%%%%%%%.......%%%%%.......%%%%%
m %%%%%%%%%%%%%...................%%%%...................%%%%%%%%%%%%%%.......%%...%%%.%%%%%%%%%%%%%%%%%%%%%%%%.......%%%%........%%%%
m %%%%%%%%%%%%....................%%%%%...................%%%%%%%%%%%%%.......%%%%%%%%%%%%%%%%%%%%%%%%%%%%%%%%........%%%%%......%%%%%
m .%%%.....%%%%..................%%%%%....................%%%%%%%%%%%%%%......%%%%%%%%%%%%%%%%%%%%%%%%.%.%..%%%......%%.%%%........%..
m ...................%%%..%.......%%%%%......%...%.......%%%%%%%%%%%%%%%......%%%%%%%%%%%%%%%%%%%%%...................................
m ...................%%%%%%.......%%%%........%%%%.......%%%%%%%%%%%%%%.......%%%%%%%%%%%%%%%%%%%%%...................................
m ...................%%%%%........%%%%........%%%%.......%%%..%%%.%%%%%%.......%.%..%.%...%%%%%%%%%...................................
m .......3...........%%%%%%......%%%%%........%%%%................%%%%%....................%%%%%......................................
m ...................%%%%%.......%%%%%........%%%%................%%%%%%...................%%%%%......................................
m ....................%.%%.......%%%%........%%%%%................%%%%%....................%%%%%......................................
m .......%.%%%%.%%%...........................%%%%%%%%.............%%%%%..................%%%%%.......%%%%%...%.........%........%%...
m ........%%%%%%%%%%%.........................%%%%%%%%.............%%%%%...................%%%%%......%%%%%%%%%.......%%%%.......%%%%%
m %.......%%%%%%%%%%%........................%%%%%%%%%............%%%%%%..................%%%%%.......%%%%%%%%.......%%%%%.......%%%%%
m %.......%%%%%%%%%%%.........................%%%%%%%%.............%%%%........%..%%......%%%%%%......%%%%%%%%........%%%%.......%%%%%
m %....3..%%%%%%%%%%%.........................%%%%%%%%%%%%%%......%%%%%.......%%%%%........%%%%.......%%%%%%%%........%%%%........%%%%
m %........%%.%..%%.%.........................%%%%%%%%%%%%%.......%%%%%%......%%%%%........%%%%........%%%%%%%%..........%%......%%%%%
m ...................%%.%%%..........%..%%..%%%%%%%%%%%%%%%.......%%%%%%......%%%%%%......%%%%%%.......%%%%%%%%...................%%%%
m ...................%%%%%%......%%%%%%%%%%%%%%%%%%%%%%%%%%.......%%%%%.......%%%%%........%%%%%.......%%%%%%%%...................%%%%
m ...................%%%%%%.......%%%%%%%%%%%%%%...%..%....%......%%%%%%.......%%%%%......%..%.%......%%...%%%%..................%%%%%
m %..................%%%%%.......%%%%%%%%%%%%%%%..................%%%%%.......%%%%%.0............................................%%%%%
m ...................%%%%%%......%%%%%%%%%%%%%%...................%%%%%........%%%%%.............................................%%%%%
m %..................%%%%%...........%%%%%%%%%%...................%%%%%%.......%%%%..............................................%%%%%
m %......%%.%%%......%%%%%.............%%%%%%%%%...................%%%%.......%%%%%...............................%%%%%.%%%.......%%%%
m %......%%%%%.......%%%%%.............%%%%%%%%%..................%%%%%........%%%%...............................%%%%%%%%........%%%%
m ........%%%%.......%%%%%.............%%%%%%%%....................%%%%.......%%%%%...............................%%%%%%%%%......%%%%%
m .......%%%%%%......%%%%%................%%%%%............%.%..%.%%%%%%.......%%%%%%%%%.%%%%..%........%.........%%%%%%%%.......%%%%%
m .......%%%%%.......%%%%%%...............%%%%%%.......%%%%%%%%%%%%%%%%.......%%%%%%%%%%%%%%%%%%.......%%%%.......%%%%%%%%%.......%%%%
m .......%%%%%.......%%%%%%................%%%%.......%%%%%%%%%%%%%%%%%%.......%%%%%%%%%%%%%%%%........%%%%........%%%%%%%.......%..%.
m ........%%%%.......%%%%%.......%%%.......%%%%.......%%%%%%%%%%%%%%%%%%.......%%%%%%%%%%%%%%%%%......%%%%%.......%%%%%%%%%...........
m ........%%%%%......%%%%%.......%%%.......%%%%.......%%%%%%%%%%%%%%%%%%......%%%%%%%%%%%%%%%%%%.......%%%%%......%%%%%%%%%...........
m ........%%%%%......%%%%%.......%%%.......%%.%.......%%%...%...%.%..%.%......%.%..%...%...%..%%...........%......%.%.%.%%%...........
m ........%%%%.......%%%%%............................................................................................................
m .......%%%%%%......%%%%%%...........................................................................................................
m .......%%%%%.......%%%%%%...........................................................................................................
m .......%%%%%%......%%%%%%%%%................................................................................................%%%%..%.
m %.......%%%%%......%%%%%%%%%................................................................................................%%%%%%%%
m %.......%%%%%......%%%%%%%%%................................................................................................%%%%%%%%
m .......%%%%%%......%%%%%%%%%%%....%%.....%.%%%........%.%%.......%.%%.%.%%%.%%%%%.%.%%.%.%%.%.......%%%%.%..%%%%..%%.%......%%%%%%%%
m .......%%%%%.......%%%%%%%%%%%%%%%%%%%%%%%%%%%......%%%%%.......%%%%%%%%%%%%%%%%%%%%%%%%%%%%%.......%%%%%%%%%%%%%%%%%........%%%%%%%
m %......%%.%.%......%%%%%%%%%%%%%%%%%%%%%%%%%%%......%%%%%.......%%%%%%%%%%%%%%%%%%%%%%%%%%%%%%.......%%%%%%%%%%%%%%%%........%%%%%%%
m %..................%%%%%%%%%%%%%%%%%%%%%%%%%%........%%%%%.......%%%%%%%%%%%%%%%%%%%%%%%%%%%%........%%%%%%%%%%%%%%%%%......%%%%%%%%
m %..................%%%%%%%%%%%%%%%%%%%%%%%%%%%......%%%%%%.......%%%%%%%%%%%%%%%%%%%%%%%%%%%%........%%%%%%%%%%%%%%%%........%%%%%%%
m %...................%%%%%%%%%%%%%%%%%%%%%%%%%%.......%%%%%.......%%%%%%...%%.%%%%.%%%..%%%%%%.........%%%%...%.%%%...........%%..%%%
m ..............................................%%%%%.....................................%%%%%%......................................
m ...............................................%%%%......................................%%%%%......................................
m ..............................................%%%%%%....................................%%%%%%......................................
m ....%%%%.%...%.%..............................%%%%%%....................................%%%%%.......................................
m ....%%%%%%%%%%%................................%%%%%....................................%%%%%...........1...........................
m ....%%%%%%%%%%%%...............................%%%%......................................%%%%.......................................
m ....%%%%%%%%%%%.......%.%%%%.%.%%...%..%......%%%%%%......%.%.%%.......%%%%%....%........%%%%....1..%...........%%.%%%....%%%..%%%..
m .....%%%%%%%%%%........%%%%%%%%%%%%%%%%%.......%%%%%......%%%%%.......%%%%%%%%%%%........%%%%........%%%%.......%%%%%%%%%%%%%%%%%%..
m ....%%%%%%%%%%%.......%%%%%%%%%%%%%%%%%%......%%%%%%......%%%%%%......%%%%%%%%%%%.......%%%%%%......%%%%%%.......%%%%%%%%%%%%%%%%...
m .....%%%%%%%%%%%.......%%%%%%%%%%%%%%%%.......%%%%%%......%%%%%%.......%%%%%%%%%%%......%%%%%%......%%%%%%......%%%%%%%%%%%%%%%%%%..
m .....%%%%%%%%%%.......%%%%%%%%%%%%%%%%%%.......%%%%........%%%%........%%%%%%%%%%%.......%%%%%......%%%%%.......%%%%%%%%%%%%%%%%%...
m .....%%%%%%%%%%%......%%%..%%%....%%%.%%...........%..0....%%%%........%....%%%%%.......%%.%.%......%%%%%%......%..%...%%.%.%%%%.%..
m ....%%%%%%%%%%%%...........................................%%%%......................................%%%%...........................
m .....%%%%%%%%%%%...............................0...........%%%%%....................................%%%%%...........................
m ....%.%...%.%%%%...........................................%%%%%....................................%%%%%%..........................
m ..........................................................%%%%%%....................................%%%%%%..........................
m ..........................................................%%%%%......................................%%%%...........................
m ..........................................................%%%%%%.....................................%%%%%..........................
m ...................%%%%..%%...........%%%.%...%%%%.........%%%%%%..%%%.%%%%.%%...%%%%%%.......%%%%%.......%%%%%%%%%%%%%%%%%%%%%%%%%%
m %..................%%%%%%%%........%%%%%%%%%%%%%%%%........%%%%%%%%%%%%%%%%%%%%%%%%%%%%.......%%%%%%......%%%%%%%%%%%%%%%%%%%%%%%%%%
m %..................%%%%%%%%%......%%%%%%%%%%%%%%%%%........%%%%%%%%%%%%%%%%%%%%%%%%%%%%.......%%%%%........%%%%%%%%%%%%%%%%%%%%%%%%%
m %......%.%.%%......%%%%%%%%........%%%%%%%%%%%%%%%%.......%%%%%%%%%%%%%%%%%%%%%%%%%%%%%%.......%%%%%......%%%%%%%%%%%%%%%%%%%%%%%%%%
m %.......%%%%%.......%%%%%%%........%%%%%%%%%%%%%%%%%.......%%%%%%%%%%%%%%%%%%%%%%%%%%%%%.......%%%%%......%%%%%%%%%%%%%%%%%%%%%%%%%%
m %......%%%%%%.......%%%%%%%%......%.%%..%%%%..%.%%%%.......%.%%.%.%%.%.%%%%%.%%%.%.%%.%.......%%.%........%%%.%.....%%....%%%%%%%%%%
m %......%%%%%.......%%%%%%%%%................................................................................................%%%%%%%%
m %......%%%%%.......%%%%%%%%%................................................................................................%%%%%%%%
m %......%%%%%%........%..%%%%................................................................................................%%%%%%%%
m %.......%%%%%..................................................................................................................%%%%%
m %......%%%%%%..................................................................................................................%%%%%
m %.......%%%%....................................................................................................................%%%%
m %......%%%%%...................%%%.%.%.%......%...........%%..%...%...%..%.%......%.%..%.%...%...%%%.......%.%%.......%%%.......%%%%
m %......%%%%%...................%%%%%%%%%......%%%%%.......%%%%%%%%%%%%%%%%%%......%%%%%%%%%%%%%%%%%%.......%%%%.......%%%.......%%%%
m %.......%%%%...................%%%%%%%%%.......%%%%%......%%%%%%%%%%%%%%%%%.......%%%%%%%%%%%%%%%%%%.......%%%%.......%%%.......%%%%
m %.......%%%%%........%..%.......%%%%%%%........%%%%........%%%%%%%%%%%%%%%%.......%%%%%%%%%%%%%%%%%%.......%%%%................%%%%%
m %.......%%%%%.......%%%%.......%%%%%%%%%.......%%%%.......%%%%%%%%%%%%%%%%%%.......%%%%%%%%%%%%%%%%.......%%%%%%...............%%%%%
m %......%%%%%%.......%%%%%.......%%%%%%%%.........%........%..%%%%.%%%%%%%%%.......%%%%%%.%..%.%............%%%%%................%%%%
