# map type: blank
# random seed: 258324402
# hill distance  76, 79  82, 67 109, 56  58, 97  58, 26  46,103   5, 44  76, 44  35, 20 109, 67   5, 79  23, 26  23, 97  35,103  46, 20  82, 56
#        76, 79       0      38     104      36      79      54     106      79     104      65      59     106      79      77      81      77 
#        82, 67      38       0     102      54      77      72     104      77     102      31      65     104      81      89      89      75 
#       109, 56     104     102       0     104      81     102      38      65      72      75      77      54      77      89      89      31 
#        58, 97      36      54     104       0      59      38     106      79     104      81      79     106      79      77      65      77 
#        58, 26      79      77      81      59       0      65      79      36      77     104     106      79     106     104      38      54 
#        46,103      54      72     102      38      65       0     104      81     102      89      77     104      77      75      31      89 
#         5, 44     106     104      38     106      79     104       0      59      54      77      79      36      79      81      77      65 
#        76, 44      79      77      65      79      36      81      59       0      77     104     106      79     106     104      54      38 
#        35, 20     104     102      72     104      77     102      54      77       0      89      81      38      65      31      75      89 
#       109, 67      65      31      75      81     104      89      77     104      89       0      38      77      54      72     102     102 
#         5, 79      59      65      77      79     106      77      79     106      81      38       0      79      36      54     104     104 
#        23, 26     106     104      54     106      79     104      36      79      38      77      79       0      59      65      77      81 
#        23, 97      79      81      77      79     106      77      79     106      65      54      36      59       0      38     104     104 
#        35,103      77      89      89      77     104      75      81     104      31      72      54      65      38       0     102     102 
#        46, 20      81      89      89      65      38      31      77      54      75     102     104      77     104     102       0      72 
#        82, 56      77      75      31      77      54      89      65      38      89     102     104      81     104     102      72       0 
players 8
rows 110
cols 110
m ...............%.%%.%%%%%%.........%.........%%%%......%.%%%%%%%%%%.%......%%%%.........%.........%%%%%%.%%.%.
m .....%%%%......%%%%%%%%%%...........%%%......%%%%.......%%%%%%%%%%%%.......%%%%......%%%...........%%%%%%%%%%.
m ....%%%%%%......%%%%%%%%%..........%%%%%.....%%%%%......%%%%%%%%%%%%......%%%%%.....%%%%%..........%%%%%%%%%..
m ....%%%%%%......%%%%%%%%%%.........%%%%%......%%%......%%%%%%%%%%%%%%......%%%......%%%%%.........%%%%%%%%%%..
m .....%%%%......%.%%.%%..%%.........%%%%%......%%%%.....%%...%%%%...%%.....%%%%......%%%%%.........%%..%%.%%.%.
m .....%%%%..........................%%%%%....7.%%%%..........%%%%..........%%%%.4....%%%%%.....................
m .....%%%%...........................%%%%.....%%%%%..........%%%%..........%%%%%.....%%%%......................
m ....%%%%%%.........................%%%%%......%%%%..........%%%%..........%%%%......%%%%%.....................
m .....%%%%..........................%%%%.......%%%...........%%%%...........%%%.......%%%%.....................
m ....................................%%%......%%%%%..........%%%%..........%%%%%......%%%......................
m ...............................%%%%%%%%......%%%%......%...%%%%%%...%......%%%%......%%%%%%%%.................
m ...............................%%%%%%%%.......%%%%.....%%%%%%%%%%%%%%.....%%%%.......%%%%%%%%.................
m ...............................%%%%%%%%%.....%%%%.......%%%%%%%%%%%%.......%%%%.....%%%%%%%%%.................
m ...............................%%%%%%%%.......%%%......%%%%%%%%%%%%%%......%%%.......%%%%%%%%.................
m %............%%%.....%.%%%%.%%.%%%%%%%%%.......%.%.....%%%%%%%%%%%%%%.....%.%.......%%%%%%%%%.%%.%%%%.%.....%%
m %%..........%%%%......%%%%%%%%%%%%%%%%%.................%%%%%%%%%%%%.................%%%%%%%%%%%%%%%%%......%%
m %%%........%%%%.......%%%%%%%%%%%%%%%%%%................%%%%%%%%%%%%................%%%%%%%%%%%%%%%%%%.......%
m %%%........%%%%.......%%%%%%%%%%%%%%%%%%................%%%%%%%%%%%%................%%%%%%%%%%%%%%%%%%.......%
m %%..........%%%........%%%%%%....%.%.%%................%%%%%%%%%%%%%%................%%.%.%....%%%%%%........%
m %%..........%%%%.............................................%%.............................................%%
m %%..........%%%..............................................%%..............................................%
m %%%........%%%%..............................................%%..............................................%
m %%..........%%%%.............................................%%.............................................%%
m %%..........%%%%..........2..................................%%..................................3..........%%
m %%..........%%%%%%..%%%%...%..%%.%...........%.....%%.%......%%......%.%%.....%...........%.%%..%...%%%%..%%%%
m %%%........%%%%%%%%%%%%%%%%%%%%%%%%................%%%%......%%......%%%%................%%%%%%%%%%%%%%%%%%%%%
m %%..........%%%%%%%%%%%%%%%%%%%%%%%%................%%%%.....%%.....%%%%................%%%%%%%%%%%%%%%%%%%%%%
m %%..........%%%%%%%%%%%%%%%%%%%%%%%................%%%%%............%%%%%................%%%%%%%%%%%%%%%%%%%%%
m .%..........%.%%..%....%.%%%%.%.%..%.................%................%.................%..%.%.%%%%.%....%..%%
m ..................................................%..........%%..........%....................................
m .............................................%%.%..........................%.%%...............................
m .............................................%%%%............%%............%%%%...............................
m ..............................................%%%%...........%%...........%%%%................................
m .............................................%%%%..........................%%%%...............................
m .%..........%..%.....%..%%.....%%.%%...%.......%%......%............%......%%.......%...%%.%%.....%%..%.....%.
m %%%........%%%%.....2.%%%%......%%%%%%%%.....................%%.....................%%%%%%%%......%%%%.3.....%
m %%..........%%%%.....%%%%.......%%%%%%%%.....................%%.....................%%%%%%%%.......%%%%.....%%
m %%..........%%%%.....%%%%.......%%%%%%%%.....................%%.....................%%%%%%%%.......%%%%.....%%
m %%%........%%%%%.....%%%%......%%%%%%%%%............................................%%%%%%%%%......%%%%.....%%
m %%%%%%%%%%%%%%%%%%%%%%%%%%%%%%%%%%%%%%%%....................%%%%....................%%%%%%%%%%%%%%%%%%%%%%%%%%
m %%%%%%%%%%%%%%%%%%%%%%%%%%%%%%%%%%%%%%%%%%%%%%%%..%.%%..%%%.%%%%.%%%..%%.%..%%%%%%%%%%%%%%%%%%%%%%%%%%%%%%%%%%
m %%%%%%%%%%%%%%%%%%%%%%%%%%%%%%%%%%%%%%%%%%%%%%%%..%.%%..%%%.%%%%.%%%..%%.%..%%%%%%%%%%%%%%%%%%%%%%%%%%%%%%%%%%
m %%%%%%%%%%%%%%%%%%%%%%%%%%%%%%%%%%%%%%%%....................%%%%....................%%%%%%%%%%%%%%%%%%%%%%%%%%
m %%%........%%%%%.....%%%%......%%%%%%%%%............................................%%%%%%%%%......%%%%.....%%
m %%..........%%%%.....%%%%.......%%%%%%%%.....................%%.....................%%%%%%%%.......%%%%.....%%
m %%..........%%%%.....%%%%.......%%%%%%%%.....................%%.....................%%%%%%%%.......%%%%.....%%
m %%%........%%%%.....0.%%%%......%%%%%%%%.....................%%.....................%%%%%%%%......%%%%.1.....%
m .%..........%..%.....%..%%.....%%.%%...%.......%%......%............%......%%.......%...%%.%%.....%%..%.....%.
m .............................................%%%%..........................%%%%...............................
m ..............................................%%%%...........%%...........%%%%................................
m .............................................%%%%............%%............%%%%...............................
m .............................................%%.%..........................%.%%...............................
m ..................................................%..........%%..........%....................................
m .%..........%.%%..%....%.%%%%.%.%..%.................%................%.................%..%.%.%%%%.%....%..%%
m %%..........%%%%%%%%%%%%%%%%%%%%%%%................%%%%%............%%%%%................%%%%%%%%%%%%%%%%%%%%%
m %%..........%%%%%%%%%%%%%%%%%%%%%%%%................%%%%.....%%.....%%%%................%%%%%%%%%%%%%%%%%%%%%%
m %%%........%%%%%%%%%%%%%%%%%%%%%%%%................%%%%......%%......%%%%................%%%%%%%%%%%%%%%%%%%%%
m %%..........%%%%%%..%%%%...%..%%.%...........%.....%%.%......%%......%.%%.....%...........%.%%..%...%%%%..%%%%
m %%..........%%%%..........0..................................%%..................................1..........%%
m %%..........%%%%.............................................%%.............................................%%
m %%%........%%%%..............................................%%..............................................%
m %%..........%%%..............................................%%..............................................%
m %%..........%%%%.............................................%%.............................................%%
m %%..........%%%........%%%%%%....%.%.%%................%%%%%%%%%%%%%%................%%.%.%....%%%%%%........%
m %%%........%%%%.......%%%%%%%%%%%%%%%%%%................%%%%%%%%%%%%................%%%%%%%%%%%%%%%%%%.......%
m %%%........%%%%.......%%%%%%%%%%%%%%%%%%................%%%%%%%%%%%%................%%%%%%%%%%%%%%%%%%.......%
m %%..........%%%%......%%%%%%%%%%%%%%%%%.................%%%%%%%%%%%%.................%%%%%%%%%%%%%%%%%......%%
m %............%%%.....%.%%%%.%%.%%%%%%%%%.......%.%.....%%%%%%%%%%%%%%.....%.%.......%%%%%%%%%.%%.%%%%.%.....%%
m ...............................%%%%%%%%.......%%%......%%%%%%%%%%%%%%......%%%.......%%%%%%%%.................
m ...............................%%%%%%%%%.....%%%%.......%%%%%%%%%%%%.......%%%%.....%%%%%%%%%.................
m ...............................%%%%%%%%.......%%%%.....%%%%%%%%%%%%%%.....%%%%.......%%%%%%%%.................
m ...............................%%%%%%%%......%%%%......%...%%%%%%...%......%%%%......%%%%%%%%.................
m ....................................%%%......%%%%%..........%%%%..........%%%%%......%%%......................
m .....%%%%..........................%%%%.......%%%...........%%%%...........%%%.......%%%%.....................
m ....%%%%%%.........................%%%%%......%%%%..........%%%%..........%%%%......%%%%%.....................
m .....%%%%...........................%%%%.....%%%%%..........%%%%..........%%%%%.....%%%%......................
m .....%%%%..........................%%%%%....5.%%%%..........%%%%..........%%%%.6....%%%%%.....................
m .....%%%%......%.%%.%%..%%.........%%%%%......%%%%.....%%...%%%%...%%.....%%%%......%%%%%.........%%..%%.%%.%.
m ....%%%%%%......%%%%%%%%%%.........%%%%%......%%%......%%%%%%%%%%%%%%......%%%......%%%%%.........%%%%%%%%%%..
m ....%%%%%%......%%%%%%%%%..........%%%%%.....%%%%%......%%%%%%%%%%%%......%%%%%.....%%%%%..........%%%%%%%%%..
m .....%%%%......%%%%%%%%%%...........%%%......%%%%.......%%%%%%%%%%%%.......%%%%......%%%...........%%%%%%%%%%.
m ...............%.%%.%%%%%%.........%.........%%%%......%.%%%%%%%%%%.%......%%%%.........%.........%%%%%%.%%.%.
m ....................%%%%%%...................%%%%.......5...%%%%...6.......%%%%...................%%%%%%......
m ......................%%%.....................%%%...........%%%%...........%%%.....................%%%........
m .....................%%%%%....................%%%%..........%%%%..........%%%%....................%%%%%.......
m .....................%%%%%...................%%%%...........%%%%...........%%%%...................%%%%%.......
m ......................%%%....................%%%%...........%%%%...........%%%%....................%%%........
m ...............%.....%%..%.........%%...%..%%%%%%%.....%.%%%%%%%%%%.%.....%%%%%%%..%...%%.........%..%%.....%.
m .....%%%%..........................%%%%%%%%%%%%%%%......%%%%%%%%%%%%......%%%%%%%%%%%%%%%.....................
m .....%%%%..........................%%%%%%%%%%%%%%.......%%%%%%%%%%%%.......%%%%%%%%%%%%%%.....................
m .....%%%%...........................%%%%%%%%%%%%%%.....%%%%%%%%%%%%%%.....%%%%%%%%%%%%%%......................
m ....%%%%%%...........................%%...%...%.........%..%%%%%%..%.........%...%...%%.......................
m ...%%%%%%%%.................................................%%%%..............................................
m ..%%%%%%%%%%...........%%...%...............................%%%%...............................%...%%.........
m %%%%%%%%%%%%%%%.......%%%%%%%%..............................%%%%..............................%%%%%%%%.......%
m %%%%%%%%%%%%%%%.......%%%%%%%%..............................%%%%..............................%%%%%%%%.......%
m %%%%%%%%%%%%%%%.......%%%%%%%%..............................%%%%..............................%%%%%%%%.......%
m %%%%%%%%%%%%%%%.......%%%%%%%%..............................%%%%..............................%%%%%%%%.......%
m ..%%%%%%%%%%...........%%...%...............................%%%%...............................%...%%.........
m ...%%%%%%%%.................................................%%%%..............................................
m ....%%%%%%...........................%%...%...%.........%..%%%%%%..%.........%...%...%%.......................
m .....%%%%...........................%%%%%%%%%%%%%%.....%%%%%%%%%%%%%%.....%%%%%%%%%%%%%%......................
m .....%%%%..........................%%%%%%%%%%%%%%.......%%%%%%%%%%%%.......%%%%%%%%%%%%%%.....................
m .....%%%%..........................%%%%%%%%%%%%%%%......%%%%%%%%%%%%......%%%%%%%%%%%%%%%.....................
m ...............%.....%%..%.........%%...%..%%%%%%%.....%.%%%%%%%%%%.%.....%%%%%%%..%...%%.........%..%%.....%.
m ......................%%%....................%%%%...........%%%%...........%%%%....................%%%........
m .....................%%%%%...................%%%%...........%%%%...........%%%%...................%%%%%.......
m .....................%%%%%....................%%%%..........%%%%..........%%%%....................%%%%%.......
m ......................%%%.....................%%%...........%%%%...........%%%.....................%%%........
m ....................%%%%%%...................%%%%.......7...%%%%...4.......%%%%...................%%%%%%......
