# map type: blank
# random seed: 67983446
# hill distance  18, 63  41, 58  18, 30  41, 35
#        18, 63       0      28      57      65 
#        41, 58      28       0      65      61 
#        18, 30      57      65       0      28 
#        41, 35      65      61      28       0 
players 2
rows 70
cols 70
m %%......%%%%%%%%......%%%................%%%%%%%%%%%%................%
m %%%.....%%%%%%%%.....%%%%%...............%%%%%%%%%%%%...............%%
m %%.......%%%%%%.......%%%%................%%%%%%%%%%................%%
m %%%%%.%.%%%%%%%%.%.%%%%%%......%%%...%%.%%%%%%%%%%%%%%.%%...%%%......%
m %%%%%%%%%%%%%%%%%%%%%%%%%%......%%%%%%%%%%%%%%%%%%%%%%%%%%%%%%......%%
m %%%%%%%%%%%%%%%%%%%%%%%%%%.....%%%%%%%%%%%%%%%%%%%%%%%%%%%%%%%%.....%%
m %%%%%%%%%%%%%%%%%%%%%%%%%......%%%%%%%%%%%%%%%%%%%%%%%%%%%%%%%%......%
m %%.%.%.%%%%%%%%%%.%.%.%%%%.....%%%%%.....%%%%%%%%%%%%.....%%%%%.....%%
m ........%%%%%%%%................%%%%.....%%%%%%%%%%%%.....%%%%........
m ........%%%%%%%%...............%%%%%.....%%%%%%%%%%%%.....%%%%%.......
m ........%%%%%%%%................%%%%.....%%%%%%%%%%%%.....%%%%........
m ........%%%%%%%%...............%%%%......%%%%%%%%%%%%......%%%%.......
m ........%%%%%%%%................%%%%.....%%%%%%%%%%%%.....%%%%........
m ........%%%%%%%%........%..%%.%%%%%%......%%%%%%%%%%......%%%%%%.%%..%
m %%%......%%%%%%......%%%%%%%%%%%%%%%.....%%%%%%%%%%%%.....%%%%%%%%%%%%
m %%%.....%%%%%%%%.....%%%%%%%%%%%%%%......%%%%%%%%%%%%......%%%%%%%%%%%
m %%%......%%%%%%......%%%%%%%%%%%%%%.......%%%%%%%%%%.......%%%%%%%%%%%
m ..%.....%%%%%%%%.....%...%%....%%%%%.....%%%%.%%.%%%%.....%%%%%....%%.
m ........%%%%%%%%..............1.%%%%..........%%..........%%%%.0......
m .........%%%%%%................%%%%%..........%%..........%%%%%.......
m .........%%%%%%................%%%%...........%%...........%%%%.......
m .........%%%%%%.................%%%...........%%...........%%%........
m ........%%%%%%%%...............%%%%...........%%...........%%%%.......
m ..%.....%%%%%%%%.....%..%......%%%%%.......%%%%%%%%.......%%%%%......%
m %%%.....%%%%%%%%.....%%%%%......%%%......%%%%%%%%%%%%......%%%......%%
m %%%.....%%%%%%%%.....%%%%%......%%%.......%%%%%%%%%%.......%%%......%%
m %%%.....%%%%%%%%.....%%%%%.....%%%%.......%%%%%%%%%%.......%%%%.....%%
m ..%......%%..%%......%.........%%%%......%%%%%%%%%%%%......%%%%.......
m ................................%%%%......%%%%%%%%%%......%%%%........
m ................................%%%%.....%%%%%%%%%%%%.....%%%%........
m ................................%%%%......%%%%%%%%%%......%%%%........
m ................................%%%%......%%%%%%%%%%......%%%%........
m ...............................%%%%%......%%%%%%%%%%......%%%%%.......
m %.%.%%.%%......%%.%%.%.%........%%%%......%%%%%%%%%%......%%%%........
m %%%%%%%%%%%%%%%%%%%%%%%%%.......%%%......%%%%%%%%%%%%......%%%.......%
m %%%%%%%%%%%%%%%%%%%%%%%%%.......%%%.......%%%%%%%%%%.......%%%.......%
m %%%%%%%%%%%%%%%%%%%%%%%%%%......%%%%.....%%%%%%%%%%%%.....%%%%......%%
m .%...%%.%%%%%%%%.%%...%.%......%%%%.......%%%%%%%%%%.......%%%%......%
m ........%%%%%%%%.........................%%%%%%%%%%%%.................
m .........%%%%%%..........................%%%%%%%%%%%%.................
m ........%%%%%%%%.........................%%%%%%%%%%%%.................
m ........%%%%%%%%...................1.....%%%%%%%%%%%%.....0...........
m ........%%%%%%%%.........................%%%%%%%%%%%%.................
m .%.......%%%%%%.......%..%...%.%%%........%%%%%%%%%%........%%%.%...%.
m %%.......%%%%%%.......%%%%%%%%%%%%%%......%%%%%%%%%%......%%%%%%%%%%%%
m %%%......%%%%%%......%%%%%%%%%%%%%%%.....%%%%%%%%%%%%.....%%%%%%%%%%%%
m %%%.....%%%%%%%%.....%%%%%%%%%%%%%%%......%%%%%%%%%%......%%%%%%%%%%%%
m %%........%..%........%%%%%..%..%%.%.....%%%%%%%%%%%%.....%.%%..%..%%%
m %%%..................%%%%.................%%%%%%%%%%.................%
m %%%..................%%%%.................%%%%%%%%%%.................%
m %%....................%%%.................%%%%%%%%%%.................%
m %%....................%%%.................%%%%%%%%%%.................%
m %%%..................%%%%................%%%%%%%%%%%%................%
m %%.......%.%%.%.......%%%%.........%%%%%%%%%%%%%%%%%%%%%%%%.........%%
m %%%......%%%%%%......%%%%%......%%%%%%%%%%%%%%%%%%%%%%%%%%%%%%......%%
m %%......%%%%%%%%......%%%%.....%%%%%%%%%%%%%%%%%%%%%%%%%%%%%%%%.....%%
m %%%......%%%%%%......%%%%......%%%%%%%%%%%%%%%%%%%%%%%%%%%%%%%%......%
m %%......%%%%%%%%......%%%.......%.%%.%%..%.%..%%..%.%..%%.%%.%.......%
m %%%......%%%%%%......%%%%.....................%%.....................%
m %%......%%%%%%%%......%%%.....................%%.....................%
m %%.......%%%%%%.......%%%.....................%%.....................%
m %%%......%%%%%%......%%%%.....................%%.....................%
m %%.......%%%%%%.......%%%.....................%%.....................%
m %%%......%%%%%%......%%%%%%..%%.%%%......%%.%.%%.%.%%......%%%.%%..%%%
m %%.......%%%%%%.......%%%%%%%%%%%%%.......%%%%%%%%%%.......%%%%%%%%%%%
m %%......%%%%%%%%......%%%%%%%%%%%%%%......%%%%%%%%%%......%%%%%%%%%%%%
m %%%......%%%%%%......%%%%%%%%%%%%%%.......%%%%%%%%%%.......%%%%%%%%%%%
m %%%.....%%%%%%%%.....%%%%%%.....%.%.......%%%%%%%%%%.......%.%.....%%%
m %%%......%%%%%%......%%%%................%%%%%%%%%%%%................%
m %%.......%%%%%%.......%%%%...............%%%%%%%%%%%%...............%%
