# map type: blank
# random seed: -433440721
# hill distance 135, 76  91,105  11,113 111, 52 131, 89  63,  4  87, 28  67, 81 107, 65  35,137  39,124 139,  9  43, 57 115,129  15,100  59, 17  19, 33  83, 41
#       135, 76       0      73      57      48      17     144      96      87      39     105      96      95      95      73      48     127      87      87 
#        91,105      73       0      72      73      56      87      95      48      64     104      95      96      96      48      87     104     144      86 
#        11,113      57      72       0     105      48      87     127     104      96      48      39      64     104      56      17      96      86     144 
#       111, 52      48      73     105       0      57      96      48      73      17     127     144      87      87      95      96      87      95      39 
#       131, 89      17      56      48      57       0     127     105      72      48      96      87      86     104      64      39     144     104      96 
#        63,  4     144      87      87      96     127       0      48      95     105      39      48      87      73      95      96      17      73      57 
#        87, 28      96      95     127      48     105      48       0      73      57      87      96      95      73      87     144      39      87      17 
#        67, 81      87      48     104      73      72      95      73       0      56     104      87     144      48      96      95      86      96      64 
#       107, 65      39      64      96      17      48     105      57      56       0     144     127     104      72      86      87      96     104      48 
#        35,137     105     104      48     127      96      39      87     104     144       0      17      56      86      72      57      48      64      96 
#        39,124      96      95      39     144      87      48      96      87     127      17       0      73      95      87      48      57      73     105 
#       139,  9      95      96      64      87      86      87      95     144     104      56      73       0      96      48      73      72      48     104 
#        43, 57      95      96     104      87     104      73      73      48      72      86      95      96       0     144      87      64      48      56 
#       115,129      73      48      56      95      64      95      87      96      86      72      87      48     144       0      73     104      96     104 
#        15,100      48      87      17      96      39      96     144      95      87      57      48      73      87      73       0     105      95     127 
#        59, 17     127     104      96      87     144      17      39      86      96      48      57      72      64     104     105       0      56      48 
#        19, 33      87     144      86      95     104      73      87      96     104      64      73      48      48      96      95      56       0      72 
#        83, 41      87      86     144      39      96      57      17      64      48      96     105     104      56     104     127      48      72       0 
players 6
rows 144
cols 144
m %%%.......%%%%%%......%%%%%%%%%%%%%%%%%%......%%%%%.......%%%%%%......%%%%%%%%%%%%%%%%%%.......%%%%%%%%%%%%%%%%........%%%%%......%%%%%%%%%%%%%%
m %%%.......%%%%%.......%%%%%%%%%%%%%%%%%.......%%%%%.......%%%%%........%%%%%%%%%%%%%%%%........%%%%%%%%%%%%%%%%%......%%%%%%......%%%%%%%%%%%%%%
m %%%%......%%%%%.......%%..%.%%%%%%%%%%%.......%%.%........%%%%%........%%%%%...%%%....%%......%%%%%%%%%.%.%.%%.....................%%.%.%%.%.%%%
m %%%...............................%%%%%...................%%%%%.......%%%%%%..................%%%%%%..........................................%%
m %%%%..............................%%%%%%..................%%%%%%.......%%%%...................%%%%%............................................%
m %%%...............................%%%%%...................%%%%%%......%%%%%%..................%%%%%%...........................................%
m %%%%..............................%%%%%%..................%%%%%%......%%%%%...................%%%%%............................................%
m %%%...............................%%%%%...................%%%%%%......%%%%%...................%%%%%%..........................................%%
m %%%%..............................%%%%%...................%%%%%%.......%%%%...................%%%%%............................................%
m %%%%......%..%...........%........%%%%%%.%%....%%.........%%%%%%......%%%%%.........%%%%.......%%%%%..%.%.%.%%..........%%........%%..%%.......%
m %%%%......%%%%%.......%%%%%.......%%%%%%%%%%%%%%%%%.......%%%%%.......%%%%%........%%%%%.......%%%%%%%%%%%%%%%%........%%%%.......%%%%%........%
m %%%%.......%%%%.......%%%%%.......%%%%%%%%%%%%%%%%%.......%%%%%%......%%%%%%......%%%%%%.......%%%%%%%%%%%%%%%%..1....%%%%%.......%%%%%........%
m %%%%......%%%%%.......%%%%%%......%%%%%%%%%%%%%%%%%.......%%%%%.......%%%%%%......%%%%%%......%%%%%%%%%%%%%%%%%........%%%%........%%%%.......%%
m %%%%......%%%%%%......%%%%%%......%%%%%%%%%%%%%%%%%%......%%%%%........%%%%.......%%%%%%......%%%%%%%%%%%%%%%%%%......%%%%%%......%%%%%%.......%
m %%.%........%.%.......%%%%%.......%%%%%%%%%..%.%%.%%......%%...%......%%.%%.......%%%%%%......%.%%%%..%%%%.%%.%%.......%...%......%.%%........%%
m ......................%%%%%%......%%%%%...........................................%%%%%%............1...........................................
m .......................%%%%%......%%%%%%..........................................%%%%%.........................................................
m .......................%%%%%......%%%%%...........................................%%%%%%........................................................
m .......................%%%%%......%%%%%%..........................................%%%%%%........................................................
m ......................%%%%%%.....0%%%%%%..........................................%%%%%.........................................................
m .......................%%%%%......%%%%%%..........................................%%%%%%........................................................
m %%%........%%%%%%%%%%%%%%%%%......%%%%%.......%%.....%.....%%.%.........%.%.......%%%%%........%.%%%%...%%%%%%%%......%....%%%%%%%%%%%%%.......%
m %%%%.......%%%%%%%%%%%%%%%%.......%%%%%.......%%%%%%%%%%%%%%%%%........%%%%%......%%%%%%......%%%%%%%%%%%%%%%%%%.......%%%%%%%%%%%%%%%%%.......%
m %%%%......%%%%%%%%%%%%%%%%%%......%%%%%.......%%%%%%%%%%%%%%%%%%......%%%%%.......%%%%%........%%%%%%%%%%%%%%%%%.......%%%%%%%%%%%%%%%%........%
m %%%%......%%%%%%%%%%%%%%%%%.......%%%%%%......%%%%%%%%%%%%%%%%%%......%%%%%.......%%%%%%......%%%%%%%%%%%%%%%%%%.......%%%%%%%%%%%%%%%%........%
m %%%%......%%%%%%%%%%%%%%%%%.......%%%%%.......%%%%%%%%%%%%%%%%%.......%%%%%.......%%%%%........%%%%%%%%%%%%%%%%........%%%%%%%%%%%%%%%%%......%%
m ...........%%.%.%%.%.%%%%%%%......%%%%%.......%%..%.%%%%%%%%%%%.......%%.%........%%%%%........%%%%%...%%%....%%......%%%%%%%%%.%.%.%%..........
m ......................%%%%%...............................%%%%%...................%%%%%.......%%%%%%..................%%%%%%....................
m .......................%%%%%..............................%%%%%%..................%%%%%%.......%%%%...................%%%%%.....................
m .......................%%%%...............................%%%%%...................%%%%%%......%%%%%%..................%%%%%%....................
m .......................%%%%%..............................%%%%%%..................%%%%%%......%%%%%...................%%%%%.....................
m ......................%%%%%...............................%%%%%...................%%%%%%......%%%%%...................%%%%%%....................
m .......................%%%%%..............................%%%%%...................%%%%%%.......%%%%...................%%%%%.....................
m %%........%%..%%.......%%%%%......%..%...........%........%%%%%%.%%....%%.........%%%%%%......%%%%%.........%%%%.......%%%%%..%.%.%.%%..........
m %%%.......%%%%%........%%%%%......%%%%%.......%%%%%.......%%%%%%%%%%%%%%%%%.......%%%%%.......%%%%%........%%%%%.......%%%%%%%%%%%%%%%%........%
m %%%.......%%%%%........%%%%%.......%%%%.......%%%%%.......%%%%%%%%%%%%%%%%%.......%%%%%%......%%%%%%......%%%%%%.......%%%%%%%%%%%%%%%%..2....%%
m %%%........%%%%.......%%%%%%......%%%%%.......%%%%%%......%%%%%%%%%%%%%%%%%.......%%%%%.......%%%%%%......%%%%%%......%%%%%%%%%%%%%%%%%........%
m %%%%......%%%%%%.......%%%%%......%%%%%%......%%%%%%......%%%%%%%%%%%%%%%%%%......%%%%%........%%%%.......%%%%%%......%%%%%%%%%%%%%%%%%%......%%
m ...%......%.%%........%%%%.%........%.%.......%%%%%.......%%%%%%%%%..%.%%.%%......%%...%......%%.%%.......%%%%%%......%.%%%%..%%%%.%%.%%.......%
m ..............................................%%%%%%......%%%%%...........................................%%%%%%............2...................
m ...............................................%%%%%......%%%%%%..........................................%%%%%.................................
m ...............................................%%%%%......%%%%%...........................................%%%%%%................................
m ...............................................%%%%%......%%%%%%..........................................%%%%%%................................
m ..............................................%%%%%%.....1%%%%%%..........................................%%%%%.................................
m ...............................................%%%%%......%%%%%%..........................................%%%%%%................................
m ...%%%%%%%%%%%%%.......%%%%........%%%%%%%%%%%%%%%%%......%%%%%.......%%.....%.....%%.%.........%.%.......%%%%%........%.%%%%...%%%%%%%%......%.
m %%%%%%%%%%%%%%%%.......%%%%%.......%%%%%%%%%%%%%%%%.......%%%%%.......%%%%%%%%%%%%%%%%%........%%%%%......%%%%%%......%%%%%%%%%%%%%%%%%%.......%
m %%%%%%%%%%%%%%%........%%%%%......%%%%%%%%%%%%%%%%%%......%%%%%.......%%%%%%%%%%%%%%%%%%......%%%%%.......%%%%%........%%%%%%%%%%%%%%%%%.......%
m %%%%%%%%%%%%%%%........%%%%%......%%%%%%%%%%%%%%%%%.......%%%%%%......%%%%%%%%%%%%%%%%%%......%%%%%.......%%%%%%......%%%%%%%%%%%%%%%%%%.......%
m %%%%%%%%%%%%%%%%......%%%%%%......%%%%%%%%%%%%%%%%%.......%%%%%.......%%%%%%%%%%%%%%%%%.......%%%%%.......%%%%%........%%%%%%%%%%%%%%%%........%
m %%%%%%%.%.%.%%.....................%%.%.%%.%.%%%%%%%......%%%%%.......%%..%.%%%%%%%%%%%.......%%.%........%%%%%........%%%%%...%%%....%%......%%
m %%%%..........................................%%%%%...............................%%%%%...................%%%%%.......%%%%%%..................%%
m %%%............................................%%%%%..............................%%%%%%..................%%%%%%.......%%%%...................%%
m %%%%...........................................%%%%...............................%%%%%...................%%%%%%......%%%%%%..................%%
m %%%............................................%%%%%..............................%%%%%%..................%%%%%%......%%%%%...................%%
m %%%%..........................................%%%%%...............................%%%%%...................%%%%%%......%%%%%...................%%
m %%%............................................%%%%%..............................%%%%%...................%%%%%%.......%%%%...................%%
m %%%%..%.%.%.%%..........%%........%%..%%.......%%%%%......%..%...........%........%%%%%%.%%....%%.........%%%%%%......%%%%%.........%%%%.......%
m %%%%%%%%%%%%%%%........%%%%.......%%%%%........%%%%%......%%%%%.......%%%%%.......%%%%%%%%%%%%%%%%%.......%%%%%.......%%%%%........%%%%%.......%
m %%%%%%%%%%%%%%%..3....%%%%%.......%%%%%........%%%%%.......%%%%.......%%%%%.......%%%%%%%%%%%%%%%%%.......%%%%%%......%%%%%%......%%%%%%.......%
m %%%%%%%%%%%%%%%........%%%%........%%%%.......%%%%%%......%%%%%.......%%%%%%......%%%%%%%%%%%%%%%%%.......%%%%%.......%%%%%%......%%%%%%......%%
m %%%%%%%%%%%%%%%%......%%%%%%......%%%%%%.......%%%%%......%%%%%%......%%%%%%......%%%%%%%%%%%%%%%%%%......%%%%%........%%%%.......%%%%%%......%%
m %%%%..%%%%.%%.%%.......%...%......%.%%........%%%%.%........%.%.......%%%%%.......%%%%%%%%%..%.%%.%%......%%...%......%%.%%.......%%%%%%......%.
m ....3.................................................................%%%%%%......%%%%%...........................................%%%%%%........
m .......................................................................%%%%%......%%%%%%..........................................%%%%%.........
m .......................................................................%%%%%......%%%%%...........................................%%%%%%........
m .......................................................................%%%%%......%%%%%%..........................................%%%%%%........
m ......................................................................%%%%%%.....2%%%%%%..........................................%%%%%.........
m .......................................................................%%%%%......%%%%%%..........................................%%%%%%........
m .%%%%...%%%%%%%%......%....%%%%%%%%%%%%%.......%%%%........%%%%%%%%%%%%%%%%%......%%%%%.......%%.....%.....%%.%.........%.%.......%%%%%........%
m %%%%%%%%%%%%%%%%.......%%%%%%%%%%%%%%%%%.......%%%%%.......%%%%%%%%%%%%%%%%.......%%%%%.......%%%%%%%%%%%%%%%%%........%%%%%......%%%%%%......%%
m %%%%%%%%%%%%%%%%.......%%%%%%%%%%%%%%%%........%%%%%......%%%%%%%%%%%%%%%%%%......%%%%%.......%%%%%%%%%%%%%%%%%%......%%%%%.......%%%%%........%
m %%%%%%%%%%%%%%%%.......%%%%%%%%%%%%%%%%........%%%%%......%%%%%%%%%%%%%%%%%.......%%%%%%......%%%%%%%%%%%%%%%%%%......%%%%%.......%%%%%%......%%
m %%%%%%%%%%%%%%%........%%%%%%%%%%%%%%%%%......%%%%%%......%%%%%%%%%%%%%%%%%.......%%%%%.......%%%%%%%%%%%%%%%%%.......%%%%%.......%%%%%........%
m %%%%...%%%....%%......%%%%%%%%%.%.%.%%.....................%%.%.%%.%.%%%%%%%......%%%%%.......%%..%.%%%%%%%%%%%.......%%.%........%%%%%........%
m %%%%..................%%%%%%..........................................%%%%%...............................%%%%%...................%%%%%.......%%
m %%%...................%%%%%............................................%%%%%..............................%%%%%%..................%%%%%%.......%
m %%%%..................%%%%%%...........................................%%%%...............................%%%%%...................%%%%%%......%%
m %%%...................%%%%%............................................%%%%%..............................%%%%%%..................%%%%%%......%%
m %%%...................%%%%%%..........................................%%%%%...............................%%%%%...................%%%%%%......%%
m %%%...................%%%%%............................................%%%%%..............................%%%%%...................%%%%%%.......%
m %%%.........%%%%.......%%%%%..%.%.%.%%..........%%........%%..%%.......%%%%%......%..%...........%........%%%%%%.%%....%%.........%%%%%%......%%
m %%%........%%%%%.......%%%%%%%%%%%%%%%%........%%%%.......%%%%%........%%%%%......%%%%%.......%%%%%.......%%%%%%%%%%%%%%%%%.......%%%%%.......%%
m %%%%......%%%%%%.......%%%%%%%%%%%%%%%%..4....%%%%%.......%%%%%........%%%%%.......%%%%.......%%%%%.......%%%%%%%%%%%%%%%%%.......%%%%%%......%%
m %%%%......%%%%%%......%%%%%%%%%%%%%%%%%........%%%%........%%%%.......%%%%%%......%%%%%.......%%%%%%......%%%%%%%%%%%%%%%%%.......%%%%%.......%%
m %%%.......%%%%%%......%%%%%%%%%%%%%%%%%%......%%%%%%......%%%%%%.......%%%%%......%%%%%%......%%%%%%......%%%%%%%%%%%%%%%%%%......%%%%%........%
m .%%.......%%%%%%......%.%%%%..%%%%.%%.%%.......%...%......%.%%........%%%%.%........%.%.......%%%%%.......%%%%%%%%%..%.%%.%%......%%...%......%%
m ..........%%%%%%............4.................................................................%%%%%%......%%%%%.................................
m ..........%%%%%................................................................................%%%%%......%%%%%%................................
m ..........%%%%%%...............................................................................%%%%%......%%%%%.................................
m ..........%%%%%%...............................................................................%%%%%......%%%%%%................................
m ..........%%%%%...............................................................................%%%%%%.....3%%%%%%................................
m ..........%%%%%%...............................................................................%%%%%......%%%%%%................................
m %.%.......%%%%%........%.%%%%...%%%%%%%%......%....%%%%%%%%%%%%%.......%%%%........%%%%%%%%%%%%%%%%%......%%%%%.......%%.....%.....%%.%.........
m %%%%......%%%%%%......%%%%%%%%%%%%%%%%%%.......%%%%%%%%%%%%%%%%%.......%%%%%.......%%%%%%%%%%%%%%%%.......%%%%%.......%%%%%%%%%%%%%%%%%........%
m %%%.......%%%%%........%%%%%%%%%%%%%%%%%.......%%%%%%%%%%%%%%%%........%%%%%......%%%%%%%%%%%%%%%%%%......%%%%%.......%%%%%%%%%%%%%%%%%%......%%
m %%%.......%%%%%%......%%%%%%%%%%%%%%%%%%.......%%%%%%%%%%%%%%%%........%%%%%......%%%%%%%%%%%%%%%%%.......%%%%%%......%%%%%%%%%%%%%%%%%%......%%
m %%%.......%%%%%........%%%%%%%%%%%%%%%%........%%%%%%%%%%%%%%%%%......%%%%%%......%%%%%%%%%%%%%%%%%.......%%%%%.......%%%%%%%%%%%%%%%%%.......%%
m .%........%%%%%........%%%%%...%%%....%%......%%%%%%%%%.%.%.%%.....................%%.%.%%.%.%%%%%%%......%%%%%.......%%..%.%%%%%%%%%%%.......%%
m ..........%%%%%.......%%%%%%..................%%%%%%..........................................%%%%%...............................%%%%%.........
m ..........%%%%%%.......%%%%...................%%%%%............................................%%%%%..............................%%%%%%........
m ..........%%%%%%......%%%%%%..................%%%%%%...........................................%%%%...............................%%%%%.........
m ..........%%%%%%......%%%%%...................%%%%%............................................%%%%%..............................%%%%%%........
m ..........%%%%%%......%%%%%...................%%%%%%..........................................%%%%%...............................%%%%%.........
m ..........%%%%%%.......%%%%...................%%%%%............................................%%%%%..............................%%%%%.........
m %.........%%%%%%......%%%%%.........%%%%.......%%%%%..%.%.%.%%..........%%........%%..%%.......%%%%%......%..%...........%........%%%%%%.%%....%
m %%%.......%%%%%.......%%%%%........%%%%%.......%%%%%%%%%%%%%%%%........%%%%.......%%%%%........%%%%%......%%%%%.......%%%%%.......%%%%%%%%%%%%%%
m %%%.......%%%%%%......%%%%%%......%%%%%%.......%%%%%%%%%%%%%%%%..5....%%%%%.......%%%%%........%%%%%.......%%%%.......%%%%%.......%%%%%%%%%%%%%%
m %%%.......%%%%%.......%%%%%%......%%%%%%......%%%%%%%%%%%%%%%%%........%%%%........%%%%.......%%%%%%......%%%%%.......%%%%%%......%%%%%%%%%%%%%%
m %%%%......%%%%%........%%%%.......%%%%%%......%%%%%%%%%%%%%%%%%%......%%%%%%......%%%%%%.......%%%%%......%%%%%%......%%%%%%......%%%%%%%%%%%%%%
m %.%%......%%...%......%%.%%.......%%%%%%......%.%%%%..%%%%.%%.%%.......%...%......%.%%........%%%%.%........%.%.......%%%%%.......%%%%%%%%%..%.%
m ..................................%%%%%%............5.................................................................%%%%%%......%%%%%.........
m ..................................%%%%%................................................................................%%%%%......%%%%%%........
m ..................................%%%%%%...............................................................................%%%%%......%%%%%.........
m ..................................%%%%%%...............................................................................%%%%%......%%%%%%........
m ..................................%%%%%...............................................................................%%%%%%.....4%%%%%%........
m ..................................%%%%%%...............................................................................%%%%%......%%%%%%........
m .....%.....%%.%.........%.%.......%%%%%........%.%%%%...%%%%%%%%......%....%%%%%%%%%%%%%.......%%%%........%%%%%%%%%%%%%%%%%......%%%%%.......%%
m %%%%%%%%%%%%%%%........%%%%%......%%%%%%......%%%%%%%%%%%%%%%%%%.......%%%%%%%%%%%%%%%%%.......%%%%%.......%%%%%%%%%%%%%%%%.......%%%%%.......%%
m %%%%%%%%%%%%%%%%......%%%%%.......%%%%%........%%%%%%%%%%%%%%%%%.......%%%%%%%%%%%%%%%%........%%%%%......%%%%%%%%%%%%%%%%%%......%%%%%.......%%
m %%%%%%%%%%%%%%%%......%%%%%.......%%%%%%......%%%%%%%%%%%%%%%%%%.......%%%%%%%%%%%%%%%%........%%%%%......%%%%%%%%%%%%%%%%%.......%%%%%%......%%
m %%%%%%%%%%%%%%%.......%%%%%.......%%%%%........%%%%%%%%%%%%%%%%........%%%%%%%%%%%%%%%%%......%%%%%%......%%%%%%%%%%%%%%%%%.......%%%%%.......%%
m ..%.%%%%%%%%%%%.......%%.%........%%%%%........%%%%%...%%%....%%......%%%%%%%%%.%.%.%%.....................%%.%.%%.%.%%%%%%%......%%%%%.......%%
m ..........%%%%%...................%%%%%.......%%%%%%..................%%%%%%..........................................%%%%%.....................
m ..........%%%%%%..................%%%%%%.......%%%%...................%%%%%............................................%%%%%....................
m ..........%%%%%...................%%%%%%......%%%%%%..................%%%%%%...........................................%%%%.....................
m ..........%%%%%%..................%%%%%%......%%%%%...................%%%%%............................................%%%%%....................
m ..........%%%%%...................%%%%%%......%%%%%...................%%%%%%..........................................%%%%%.....................
m ..........%%%%%...................%%%%%%.......%%%%...................%%%%%............................................%%%%%....................
m .%........%%%%%%.%%....%%.........%%%%%%......%%%%%.........%%%%.......%%%%%..%.%.%.%%..........%%........%%..%%.......%%%%%......%..%..........
m %%%.......%%%%%%%%%%%%%%%%%.......%%%%%.......%%%%%........%%%%%.......%%%%%%%%%%%%%%%%........%%%%.......%%%%%........%%%%%......%%%%%.......%%
m %%%.......%%%%%%%%%%%%%%%%%.......%%%%%%......%%%%%%......%%%%%%.......%%%%%%%%%%%%%%%%..0....%%%%%.......%%%%%........%%%%%.......%%%%.......%%
m %%%%......%%%%%%%%%%%%%%%%%.......%%%%%.......%%%%%%......%%%%%%......%%%%%%%%%%%%%%%%%........%%%%........%%%%.......%%%%%%......%%%%%.......%%
m %%%%......%%%%%%%%%%%%%%%%%%......%%%%%........%%%%.......%%%%%%......%%%%%%%%%%%%%%%%%%......%%%%%%......%%%%%%.......%%%%%......%%%%%%......%%
m %%%.......%%%%%%%%%..%.%%.%%......%%...%......%%.%%.......%%%%%%......%.%%%%..%%%%.%%.%%.......%...%......%.%%........%%%%.%........%.%.......%%
m %%%%......%%%%%...........................................%%%%%%............0.................................................................%%
m %%%%......%%%%%%..........................................%%%%%................................................................................%
m %%%%......%%%%%...........................................%%%%%%...............................................................................%
m %%%%......%%%%%%..........................................%%%%%%...............................................................................%
m %%%%.....5%%%%%%..........................................%%%%%...............................................................................%%
m %%%%......%%%%%%..........................................%%%%%%...............................................................................%
m %%%%......%%%%%.......%%.....%.....%%.%.........%.%.......%%%%%........%.%%%%...%%%%%%%%......%....%%%%%%%%%%%%%.......%%%%........%%%%%%%%%%%%%
m %%%.......%%%%%.......%%%%%%%%%%%%%%%%%........%%%%%......%%%%%%......%%%%%%%%%%%%%%%%%%.......%%%%%%%%%%%%%%%%%.......%%%%%.......%%%%%%%%%%%%%
m %%%%......%%%%%.......%%%%%%%%%%%%%%%%%%......%%%%%.......%%%%%........%%%%%%%%%%%%%%%%%.......%%%%%%%%%%%%%%%%........%%%%%......%%%%%%%%%%%%%%
