# map type: blank
# random seed: 545247018
# hill distance   5, 80  60, 16  17, 75  72, 20  77,  8  13, 63
#         5, 80       0      49      79      77      24      39 
#        60, 16      49       0      68      92      39      74 
#        17, 75      79      68       0     110      77      92 
#        72, 20      77      92     110       0      79      68 
#        77,  8      24      39      77      79       0      49 
#        13, 63      39      74      92      68      49       0 
players 2
rows 84
cols 84
m %%%%%%%%...............................%%%%%.........................%%%%%........%%
m %%%%%%%%...............................%%%%...................%.......%%%%.......%%%
m %%%%%%%%...............................%%%%%..........................%%%%........%%
m %%%%%%%%...............................%%%%...................%......%%%%%........%%
m ..%%%%%%..............................%%%%%...................%.......%%%%%.......%.
m .......................................%%%%%.........................%%%%%%.....1...
m .........%%%%%..%.........%%........%%%%%%%%......%.......%%%%%.......%%%%%.........
m .........%%%%%%%%%%.......%%%%%%%%%%%%%%%%%%......%.......%%%%.......%%%%%%.........
m .........%%%%%%%%%%%......%%%%%%%%%%%%%%%%%%......%.......%%%%%.......%%%%..........
m .........%%%%%%%%%%.......%%%%%%%%%%%%%%%%%...............%%%%%......%%%%%%.........
m .........%%%%%%%%%%%.......%%%%%%%%%%%%%%%%.......%......%%%%%........%%%%%.........
m %%........%%%%%%%%%..........%%%.%%%.%..%%.%......%......%%%%%%......%%%%%%.%%%%..%.
m %%........%%%%%%%%%%.....................................%%%%%%.......%%%%%%%%%%%%%%
m %%.......%%%%%%%%%%%..............................%.......%%%%%1......%%%%%%%%%%%%%%
m %%........%%%%%%%%%%..............................%......%%%%%%.......%%%%%%%%%%%%%%
m %%%.......%%%%%%%%%%..............................%.......%%%%.......%%%%%%%%%%%%%%%
m %%.........%.%.%%%%%..............................%......%..%%.......%%%%%%.%.%%.%%%
m %%....................................................................%%%%%1......%%
m %%...................%%%%%.%.%%%......%..............................%%%%%.......%%%
m %%%..................%%%%%%%%%%.......%...............................%%%%........%%
m %%%..................%%%%%%%%%%%......%..............................%%%%%%.......%%
m %%%..................%%%%%%%%%%%......%...............................%%%%.......%%%
m %%%..................%%%%%%%%%%.......%...............................%%%%.......%%%
m %%%......%%%%.........%%%%%%%%%%......%............%.%..%..%...%.%%%%%%%%%.......%%%
m %%.......%%%%%.......%%%%%%%%%%%..............%%%%%%%%%%%%%%%%%%%%%%%%%%%%%......%%%
m %%%.......%%%%........%%%%%%%%%%.............%%%%%%%%%%%%%%%%%%%%%%%%%%%%%%.......%%
m %%%.......%%%%%......%%%%%%%%%%%..............%%%%%%%%%%%%%%%%%%%%%%%%%%%%........%%
m %%%.......%%%%%......%%%%%%%%%%%..............%%%%%%%%%%%%%%%%%%%%%%%%%%%%.......%%%
m %%%.......%%%%%......%.%%.%%%%%%..............%.%..%%.%%.%%%%%%%..%..%%...%.......%%
m %%........%%%%........................%...................%%%%....................%%
m %%%.......%%%%%..................%%%%%%...................%%%%%..................%%%
m %%........%%%%%..................%%%%%%..................%%%%%....................%%
m %%........%%%%%..................%%%%%%..................%%%%%%..................%%%
m %%.......%%%%%...................%%%%%%...................%%%%%..................%%%
m %%.......%%%%%%..................%%%%%%..................%%%%%%..................%%%
m %%%....%.%%%%%.......%%%%%%.....%%%%%%%.%%..%...%%........%%%%........%..%.......%%%
m %%%%%%%%%%%%%%.........................%%%%%%%%%%%........%%%%........%%%%%.......%%
m %%%%%%%%%%%%%%%.......................%%%%%%%%%%%%.......%%%%%........%%%%%......%%%
m %%%%%%%%%%%%%%%.......................%%%%%%%%%%%%%.......%%%%%......%%%%%.......%%%
m %%%%%%%%%%%%%%.........................%%%%%%%%%%%%.......%%%%%......%%%%%%.......%%
m %%%%.%..%%%%..%........................%%%%%%%.%%%..........%%%.......%.%.........%%
m %%%...................................%%%%%%%....................................%%%
m %%..........................%..........%%%%%.....................................%%%
m %%%........................%%%%%.......%%%%.......................................%%
m %%.........................%%%%........%%%%%......................................%%
m %%.........................%%%%%......%%%%%%.....................................%%%
m %%.........................%%%%.......%%%%%%......................................%%
m %%%......%%%.%%.%%%%.......%%%%..........%%.......%%%%%.%%%%..........%%%%........%%
m %%%.......................%%%%%%..................%%%%%%%%%%%%.......%%%%%%......%%%
m %%.........................%%%%%..................%%%%%%%%%%%%........%%%%........%%
m %%........................%%%%%...................%%%%%%%%%%%%.......%%%%%.......%%%
m %%%........................%%%%%..................%%%%%%%%%%%%%......%%%%%.......%%%
m %..........................%%%%%...................%%%%%%%%%%%%.......%.%%.........%
m ..........................%%%%%...................%%%%%%%%%%%%......................
m .............%%%.%.%.......%%%%%..%%.%..%.........%%%%%%%%%%%%%.....................
m .........%%%%%%%%%%........%%%%%%%%%%%%%%%%.......%%%%%%%%%%%%......................
m .........%%%%%%%%%%.......%%%%%%%%%%%%%%%%%.......%%%%%%%%%%%%%.....................
m .........%%%%%%%%%%%.......%%%%%%%%%%%%%%%%%.......%%%%%%%%%%%......................
m .........%%%%%%%%%%%.......%%%%%%%%%%%%%%%%%.......%%%%%%%%%%%......................
m %.%.%.%%.%.%%.%%%%.........%%%%%.%.%%%...%%%..........%%.%.%..%......%.%%...%.%%%.%.
m ................0.........%%%%%%..........................................%%%%%%....
m ...........................%%%%............................................%%%%%....
m ..........................%%%%%...........................................%%%%%.....
m ..........................%%%%%%..........................................%%%%%%....
m ..........................%%%%%.............................................%.%.....
m ..........................%%%%%.....................................................
m ..%%..%.%.%.%.%...%%.%.%..%%%%%%.........%%........%.%%.......%.....................
m ...%%%%%%%%%%%%%%%%%%%%%%%%%%%%%......%%%%%%......%%%%%%............................
m ...%%%%%%%%%%%%%%%%%%%%%%%%%%%%........%%%%.......%%%%%.......%.....................
m ...%%%%%%%%%%%%%%%%%%%%%%%%%%%%........%%%%%......%%%%%%......%.....................
m ..%%%%%%%%%%%%%%%%%%%%%%%%%%%%%.......%%%%%.......%%%%%%............................
m .......%%%%.%%%%%%%%%..%...%%..%.......%%.%........%...........%.%%.......%.%%.%....
m ...............%%%%.0..........................................%%%%........%%%%.....
m ..............%%%%%%..........................................%%%%%%......%%%%%.....
m ..............%%%%%............................................%%%%.......%%%%%%....
m ..............%%%%%%..........................................%%%%%%.......%%%%.....
m ..............%%%%%%..........................................%%%.%.......%..%.%....
m ........0......%%%%...........................................%.....................
m %%..%..........%%%%%.%..%%%%..%..%.%%%%.%%..%%..%..%.%%..........................%%%
m %%%%%%%%......%%%%%%%%%%%%%%%%%%%%%%%%%%%%%%%%%%%%%%%%%.......%..................%%%
m %%%%%%%........%%%%%%%%%%%%%%%%%%%%%%%%%%%%%%%%%%%%%%%%%.........................%%%
m %%%%%%%.......%%%%%%%%%%%%%%%%%%%%%%%%%%%%%%%%%%%%%%%%%%......%..................%%%
m %%%%%%%.......%%%%%%%%%%%%%%%%%%%%%%%%%%%%%%%%%%%%%%%%%..........................%%%
m %%%%%%%%..........%...%%%%%.%%%%.%....%%%%%%%.%...%%..%.......%......%...%........%%
