# map type: blank
# random seed: -1069037359
# hill distance  66, 57  58, 85  50, 12  21, 73  58,  0 113, 65 113, 20  13, 85   5, 57  78, 65  50, 73  78, 20   5, 28  21, 12  13,  0  66, 28
#        66, 57       0      36      61      61      71      55     106      81      59      20      32      71      90      90     110      51 
#        58, 85      36       0      55      71      41      81     122      91      81      40      20      81     110     106     126      71 
#        50, 12      61      55       0      90      20     110      71     106      90      81      59      36      61      51      71      32 
#        21, 73      61      71      90       0     106      36      81      20      32      71      51     110      61      59      55      90 
#        58,  0      71      41      20     106       0     122      81     126     110      81      55      40      81      71      91      36 
#       113, 65      55      81     110      36     122       0      91      40      20      41      71     126      71      81      81     106 
#       113, 20     106     122      71      81      81      91       0      81      71     126     110      41      20      36      40      55 
#        13, 85      81      91     106      20     126      40      81       0      36      81      71     122      71      55      41     110 
#         5, 57      59      81      90      32     110      20      71      36       0      55      61     106      51      61      71      90 
#        78, 65      20      40      81      71      81      41     126      81      55       0      36      91     106     110     122      71 
#        50, 73      32      20      59      51      55      71     110      71      61      36       0      81      90      90     106      61 
#        78, 20      71      81      36     110      40     126      41     122     106      91      81       0      55      71      81      20 
#         5, 28      90     110      61      61      81      71      20      71      51     106      90      55       0      32      36      59 
#        21, 12      90     106      51      59      71      81      36      55      61     110      90      71      32       0      20      61 
#        13,  0     110     126      71      55      91      81      40      41      71     122     106      81      36      20       0      81 
#        66, 28      51      71      32      90      36     106      55     110      90      71      61      20      59      61      81       0 
players 8
rows 120
cols 120
m .....%%%%%%%......%%%%.......%%%%%.......%%%%.......%%%%%.......%%%%......%%%%%%%.......%%%%%.......%%%%%%.......%%%%%..
m ......%%%%%.......%%%%.......%%%%%.......%%%%.......%%%%%.......%%%%.......%%%%%.......%%%%%........%%%%%%........%%%%%.
m .....%%%%%%%......%%%%%.......%%%%%......%%%%......%%%%%.......%%%%%......%%%%%%%.......%%%%%......%%%%%%%%......%%%%%..
m ......%%%%%.......%%%%%......%%%%%%......%%%%......%%%%%%......%%%%%.......%%%%%........%%%%%.......%%%%%%.......%%%%%..
m ......%%.%.%......%..%.......%....%......%%%%......%....%.......%..%......%.%.%%..........%.%......%%%%%%%%......%.%....
m ............................1............%%%%............0..........................................%%%%%%..............
m .........................................%%%%.......................................................%%%%%%..............
m .........................................%%%%......................................................%%%%%%%%.............
m .........................................%%%%......................................................%%%%%%%%.............
m .........................................%%%%......................................................%%%%%%%%.............
m .........................................%%%%......................................................%%%%%%%%.............
m .......%%%%%......%%%...........%%%%.....%%%%.....%%%%...........%%%......%%%%%.......%%%%%%%%%%%%%%%%%%%%%%%%%%%%%%%%%%
m ......%%%%%.......%%%%%.......%%%%%%%%%%%%%%%%%%%%%%%%%%.......%%%%%.......%%%%%......%%%%%%%%%%%%%%%%%%%%%%%%%%%%%%%%%%
m 1......%%%%.......%%%%........%%%%%%%%%%%%%%%%%%%%%%%%%%........%%%%.......%%%%......0.%%%%%%%%%%%%%%%%%%%%%%%%%%%%%%%%.
m ......%%%%%%.......%%%%......%%%%%%%%%%%%%%%%%%%%%%%%%%%%......%%%%.......%%%%%%......%%%%%%%%%%%%%%%%%%%%%%%%%%%%%%%%%%
m ......%..%%........%.%%.......%%%%%%%%%........%%%%%%%%%.......%%.%........%%..%.......%%.%%%%.%.%%..%..%..%%.%.%%%%.%%.
m ........................................................................................................................
m ........................................................................................................................
m ........................................................................................................................
m ........................................................................................................................
m ........................................................................................................................
m ............6............................................................5..............................................
m .......%%.%%.........%.......%%..%%%......%%......%%%..%%.......%.........%%.%%........%...%......%%.%..%.%%......%...%.
m .......%%%%........%%%%......%%%%%%%......%%......%%%%%%%......%%%%........%%%%.......%%%%%%.......%%%%%%%%.......%%%%%%
m ......%%%%%........%%%%.......%%%%%.......%%.......%%%%%.......%%%%........%%%%%......%%%%%........%%%%%%%%........%%%%%
m ......%%%%%.......%%%%%.......%%%%%................%%%%%.......%%%%%.......%%%%%.......%%%%.......%%%%%%%%%%.......%%%%.
m .......%%%%.......%%%%%......%%%%%%%..............%%%%%%%......%%%%%.......%%%%........%%%%%.......%%%%%%%%.......%%%%%.
m .........%%%......%%%%%......%%%%%%................%%%%%%......%%%%%......%%%..........%%%%........%%%%%%%%........%%%%.
m ..................%%%%%......%%..%.%..............%.%..%%......%%%%%...................%%%%........%%%%%%%%........%%%%.
m ...................%%%%........................................%%%%....................%%%%.......%%%%%%%%%%.......%%%%.
m ...................%%%%........................................%%%%....................%%%%........%%%%%%%%........%%%%.
m ...................%%%%........................................%%%%....................%%%%.......%%%%%%%%%%.......%%%%.
m ...................%%%..........................................%%%...................%%%%%%......%%%%%%%%%%......%%%%%%
m ...................%%%..........................................%%%...................%%%%%.......%%%%%%%%%%.......%%%%%
m %%%%%%%%%%%%%%%%%%%%%%...................%%%%...................%%%%%%%%%%%%%%%%%%%%%%%%%%%%%%%%%%%%%%%%%%%%%%%%%%%%%%%%
m %%%%%%%%%%%%%%%%%%%%%%.......%%%.........%%%%.........%%%.......%%%%%%%%%%%%%%%%%%%%%%%%%%%%%%%%%%%%%%%%%%%%%%%%%%%%%%%%
m %%%%%%%%%%%%%%%%%%%%%%.......%%%.........%%%%.........%%%.......%%%%%%%%%%%%%%%%%%%%%%%%%%%%%%%%%%%%%%%%%%%%%%%%%%%%%%%%
m %%%%%%%%%%%%%%%%%%%%%%...................%%%%...................%%%%%%%%%%%%%%%%%%%%%%%%%%%%%%%%%%%%%%%%%%%%%%%%%%%%%%%%
m ...................%%%..........................................%%%...................%%%%%.......%%%%%%%%%%.......%%%%%
m ...................%%%..........................................%%%...................%%%%%%......%%%%%%%%%%......%%%%%%
m ...................%%%%........................................%%%%....................%%%%.......%%%%%%%%%%.......%%%%.
m ...................%%%%........................................%%%%....................%%%%........%%%%%%%%........%%%%.
m ...................%%%%........................................%%%%....................%%%%.......%%%%%%%%%%.......%%%%.
m ..................%%%%%......%%..%.%..............%.%..%%......%%%%%...................%%%%........%%%%%%%%........%%%%.
m .........%%%......%%%%%......%%%%%%................%%%%%%......%%%%%......%%%..........%%%%........%%%%%%%%........%%%%.
m .......%%%%.......%%%%%......%%%%%%%..............%%%%%%%......%%%%%.......%%%%........%%%%%.......%%%%%%%%.......%%%%%.
m ......%%%%%.......%%%%%.......%%%%%................%%%%%.......%%%%%.......%%%%%.......%%%%.......%%%%%%%%%%.......%%%%.
m ......%%%%%........%%%%.......%%%%%.......%%.......%%%%%.......%%%%........%%%%%......%%%%%........%%%%%%%%........%%%%%
m .......%%%%........%%%%......%%%%%%%......%%......%%%%%%%......%%%%........%%%%.......%%%%%%.......%%%%%%%%.......%%%%%%
m .......%%.%%.........%.......%%..%%%......%%......%%%..%%.......%.........%%.%%........%...%......%%.%..%.%%......%...%.
m ............4............................................................7..............................................
m ........................................................................................................................
m ........................................................................................................................
m ........................................................................................................................
m ........................................................................................................................
m ........................................................................................................................
m ......%..%%........%.%%.......%%%%%%%%%........%%%%%%%%%.......%%.%........%%..%.......%%.%%%%.%.%%..%..%..%%.%.%%%%.%%.
m ......%%%%%%.......%%%%......%%%%%%%%%%%%%%%%%%%%%%%%%%%%......%%%%.......%%%%%%......%%%%%%%%%%%%%%%%%%%%%%%%%%%%%%%%%%
m 3......%%%%.......%%%%........%%%%%%%%%%%%%%%%%%%%%%%%%%........%%%%.......%%%%......2.%%%%%%%%%%%%%%%%%%%%%%%%%%%%%%%%.
m ......%%%%%.......%%%%%.......%%%%%%%%%%%%%%%%%%%%%%%%%%.......%%%%%.......%%%%%......%%%%%%%%%%%%%%%%%%%%%%%%%%%%%%%%%%
m .......%%%%%......%%%...........%%%%.....%%%%.....%%%%...........%%%......%%%%%.......%%%%%%%%%%%%%%%%%%%%%%%%%%%%%%%%%%
m .........................................%%%%......................................................%%%%%%%%.............
m .........................................%%%%......................................................%%%%%%%%.............
m .........................................%%%%......................................................%%%%%%%%.............
m .........................................%%%%......................................................%%%%%%%%.............
m .........................................%%%%.......................................................%%%%%%..............
m ............................3............%%%%............2..........................................%%%%%%..............
m ......%%.%.%......%..%.......%....%......%%%%......%....%.......%..%......%.%.%%..........%.%......%%%%%%%%......%.%....
m ......%%%%%.......%%%%%......%%%%%%......%%%%......%%%%%%......%%%%%.......%%%%%........%%%%%.......%%%%%%.......%%%%%..
m .....%%%%%%%......%%%%%.......%%%%%......%%%%......%%%%%.......%%%%%......%%%%%%%.......%%%%%......%%%%%%%%......%%%%%..
m ......%%%%%.......%%%%.......%%%%%.......%%%%.......%%%%%.......%%%%.......%%%%%.......%%%%%........%%%%%%........%%%%%.
m .....%%%%%%%......%%%%.......%%%%%.......%%%%.......%%%%%.......%%%%......%%%%%%%.......%%%%%.......%%%%%%.......%%%%%..
m .....%%%%%%%.......%.%%........%%........%%%%........%%........%%.%.......%%%%%%%......%%%%.%......%%%%%%%%......%.%%%%.
m .....%%%.%...............................%%%%...............................%.%%%..................%%%%%%%%.............
m .........................................%%%%.......................................................%%%%%%..............
m .........................................%%%%.......................................................%%%%%%..............
m .........................................%%%%......................................................%%%%%%%%.............
m .........................................%%%%.......................................................%%%%%%..............
m ....................4....................%%%%....................7..................................%%%%%%..............
m ..................%%.%........%%.......%%%%%%%%.......%%........%.%%..................%%%%.%%.......%%%%%%.......%%.%%%%
m ......%.%.........%%%%%......%%%%%%%%%%%%%%%%%%%%%%%%%%%%......%%%%%.........%.%......%%%%%%.......%%%%%%%%.......%%%%%%
m ......%%%%%.......%%%%%.......%%%%%%%%%%%%%%%%%%%%%%%%%%.......%%%%%.......%%%%%......%%%%%%%......%%%%%%%%......%%%%%%%
m ......%%%%%.......%%%%........%%%%%%%%%%%%%%%%%%%%%%%%%%........%%%%.......%%%%%......%%%%%%%.......%%%%%%.......%%%%%%%
m ......%%%%%%......%%%%%.......%%%%%%%%%%%%%%%%%%%%%%%%%%.......%%%%%......%%%%%%.......%%%%%%......%%%%%%%%......%%%%%%.
m .......%%%%.......%%%%%......%%..%.....%.%%%%.%.....%..%%......%%%%%.......%%%%.......%%%%%%........%%%%%%........%%%%%%
m ......%%.%%%......%%%%%..................%%%%..................%%%%%......%%%.%%......%.%%%.%.......%%%%%%.......%.%%%.%
m ..................%%%%%..................%%%%..................%%%%%................................%%%%%%..............
m ..................%%%%...................%%%%...................%%%%...............................%%%%%%%%.............
m ..................%%%%%..................%%%%..................%%%%%...............................%%%%%%%%.............
m ..................%%%%...................%%%%...................%%%%...............................%%%%%%%%.............
m ..................%%%%%..................%%%%..................%%%%%...............................%%%%%%%%.............
m ..................%%%%%......%..%...%.%%%%%%%%%%.%...%..%......%%%%%..............................%%%%%%%%%%............
m ..%..%%..%.%..%%%%%%%%.......%%%%%%%%%%%%%%%%%%%%%%%%%%%%.......%%%%%%%%..%.%..%%..%...%%.%...%%%%%%%%%%%%%%%%%%...%.%%.
m %%%%%%%%%%%%%%%%%%%%%%........%%%%%%%%%%%%%%%%%%%%%%%%%%........%%%%%%%%%%%%%%%%%%%%%%%%%%%%%%%%%%%%%%%%%%%%%%%%%%%%%%%%
m %%%%%%%%%%%%%%%%%%%%%%%......%%%%%%%%%%%%%%%%%%%%%%%%%%%%......%%%%%%%%%%%%%%%%%%%%%%%%%%%%%%%%%%%%%%%%%%%%%%%%%%%%%%%%%
m %%%%%%%%%%%%%%%%%%%%%%........%%%%%%%%%%%%%%%%%%%%%%%%%%........%%%%%%%%%%%%%%%%%%%%%%%%%%%%%%%%%%%%%%%%%%%%%%%%%%%%%%%%
m %%%%%%%%%%%%%%%%%%%%%%........%%%%%%%%%%%%%%%%%%%%%%%%%%........%%%%%%%%%%%%%%%%%%%%%%%%%%%%%%%%%%%%%%%%%%%%%%%%%%%%%%%%
m %%%%%%%%%%%%%%%%%%%%%%%......%%%%%%%%%%%%%%%%%%%%%%%%%%%%......%%%%%%%%%%%%%%%%%%%%%%%%%%%%%%%%%%%%%%%%%%%%%%%%%%%%%%%%%
m %%%%%%%%%%%%%%%%%%%%%%........%%%%%%%%%%%%%%%%%%%%%%%%%%........%%%%%%%%%%%%%%%%%%%%%%%%%%%%%%%%%%%%%%%%%%%%%%%%%%%%%%%%
m ..%..%%..%.%..%%%%%%%%.......%%%%%%%%%%%%%%%%%%%%%%%%%%%%.......%%%%%%%%..%.%..%%..%...%%.%...%%%%%%%%%%%%%%%%%%...%.%%.
m ..................%%%%%......%..%...%.%%%%%%%%%%.%...%..%......%%%%%..............................%%%%%%%%%%............
m ..................%%%%%..................%%%%..................%%%%%...............................%%%%%%%%.............
m ..................%%%%...................%%%%...................%%%%...............................%%%%%%%%.............
m ..................%%%%%..................%%%%..................%%%%%...............................%%%%%%%%.............
m ..................%%%%...................%%%%...................%%%%...............................%%%%%%%%.............
m ..................%%%%%..................%%%%..................%%%%%................................%%%%%%..............
m ......%%.%%%......%%%%%..................%%%%..................%%%%%......%%%.%%......%.%%%.%.......%%%%%%.......%.%%%.%
m .......%%%%.......%%%%%......%%..%.....%.%%%%.%.....%..%%......%%%%%.......%%%%.......%%%%%%........%%%%%%........%%%%%%
m ......%%%%%%......%%%%%.......%%%%%%%%%%%%%%%%%%%%%%%%%%.......%%%%%......%%%%%%.......%%%%%%......%%%%%%%%......%%%%%%.
m ......%%%%%.......%%%%........%%%%%%%%%%%%%%%%%%%%%%%%%%........%%%%.......%%%%%......%%%%%%%.......%%%%%%.......%%%%%%%
m ......%%%%%.......%%%%%.......%%%%%%%%%%%%%%%%%%%%%%%%%%.......%%%%%.......%%%%%......%%%%%%%......%%%%%%%%......%%%%%%%
m ......%.%.........%%%%%......%%%%%%%%%%%%%%%%%%%%%%%%%%%%......%%%%%.........%.%......%%%%%%.......%%%%%%%%.......%%%%%%
m ..................%%.%........%%.......%%%%%%%%.......%%........%.%%..................%%%%.%%.......%%%%%%.......%%.%%%%
m ....................6....................%%%%....................5..................................%%%%%%..............
m .........................................%%%%.......................................................%%%%%%..............
m .........................................%%%%......................................................%%%%%%%%.............
m .........................................%%%%.......................................................%%%%%%..............
m .........................................%%%%.......................................................%%%%%%..............
m .....%%%.%...............................%%%%...............................%.%%%..................%%%%%%%%.............
m .....%%%%%%%.......%.%%........%%........%%%%........%%........%%.%.......%%%%%%%......%%%%.%......%%%%%%%%......%.%%%%.
