# map type: blank
# random seed: 1887177720
# hill distance  86, 77 116, 21 117,  8  71, 62 111, 22 111, 77  57, 68  57, 31  80,  8   6, 62  70, 67  81, 21  81, 78   6, 37   7, 67   7, 32 117, 91  20, 31  86, 22  70, 32  80, 91  71, 37  20, 68 116, 78
#        86, 77       0     126     126      54     122      85      58     103      69      95      48      83       6     120      99     124      93     128      89      99      20      95      87      89 
#       116, 21     126       0      20     124       6      83     132      81      97      99     128      93     130      48      95      42      63      52      89      95     120      99     105      77 
#       117,  8     126      20       0     128      20      69     120      91     101      87     132      97     120      58      81      52      49      62      93     105     106     103      91      63 
#        71, 62      54     124     128       0     120      95      20      93      87      89       6      99      48     122      83     126     103     126      95      89      58      85      69      99 
#       111, 22     122       6      20     120       0      89     128      87      93      95     124      89     126      54      99      48      69      58      85      99     126      95     103      83 
#       111, 77      85      83      69      95      89       0      87     128     126      54      99     126      89      95      48      99      20     103     122     124      93     120      58       6 
#        57, 68      58     132     120      20     128      87       0     101      91      69      20     105      52     126      63     120      91     106     103      97      62      93      49      81 
#        57, 31     103      81      91      93      87     128     101       0      62     126      97      52     105      69     120      63     120      49      58      20      91      20     106     132 
#        80,  8      69      97     101      87      93     126      91      62       0     128      81      20      63     103     132     105     106      91      20      52      49      58     120     120 
#         6, 62      95      99      87      89      95      54      69     126     128       0      83     124      99      85       6      89      58      93     120     126     103     122      20      48 
#        70, 67      48     128     132       6     124      99      20      97      81      83       0      95      42     126      77     130     105     120      99      93      52      89      63      95 
#        81, 21      83      93      97      99      89     126     105      52      20     124      95       0      77      99     128      95     120      81       6      42      63      48     132     130 
#        81, 78       6     130     120      48     126      89      52     105      63      99      42      77       0     124      95     128      97     132      83      95      20      99      81      93 
#         6, 37     120      48      58     122      54      95     126      69     103      85     126      99     124       0      89       6      87      20      95      83     128      89      93      99 
#         7, 67      99      95      81      83      99      48      63     120     132       6      77     128      95      89       0      93      52      97     124     130     105     126      20      42 
#         7, 32     124      42      52     126      48      99     120      63     105      89     130      95     128       6      93       0      81      20      99      77     132      83      97      95 
#       117, 91      93      63      49     103      69      20      91     120     106      58     105     120      97      87      52      81       0      91     126     132     101     128      62      20 
#        20, 31     128      52      62     126      58     103     106      49      91      93     120      81     132      20      97      20      91       0      87      63     120      69     101     105 
#        86, 22      89      89      93      95      85     122     103      58      20     120      99       6      83      95     124      99     126      87       0      48      69      54     128     126 
#        70, 32      99      95     105      89      99     124      97      20      52     126      93      42      95      83     130      77     132      63      48       0      81       6     120     128 
#        80, 91      20     120     106      58     126      93      62      91      49     103      52      63      20     128     105     132     101     120      69      81       0      87      91      97 
#        71, 37      95      99     103      85      95     120      93      20      58     122      89      48      99      89     126      83     128      69      54       6      87       0     126     124 
#        20, 68      87     105      91      69     103      58      49     106     120      20      63     132      81      93      20      97      62     101     128     120      91     126       0      52 
#       116, 78      89      77      63      99      83       6      81     132     120      48      95     130      93      99      42      95      20     105     126     128      97     124      52       0 
players 8
rows 120
cols 120
m %%...%%...%%%%......%..%%%.%%...............%%........%%...............%%.%%%..%......%%%%...%%...%%%%..%%%......%%%..%%
m %%...%%%%%%%%%...%%%%%%%%%%%%...............%%........%%...............%%%%%%%%%%%%...%%%%%%%%%...%%%%%%%%........%%%%%%
m .....%%......%....%%..%%%%%%................%%%......%%%................%%%%%%..%%....%......%%......%%%.%........%.%%%.
m ........................%%%%%.%....%%.%%%....%%......%%....%%%.%%....%.%%%%%............................................
m .......................%%%%%%%%%%%%%%%%%....%%%......%%%....%%%%%%%%%%%%%%%%%...........................................
m ........................%.%%%.%..%...%%%%....%........%....%%%%...%..%.%%%.%............................................
m %%%...%%.....%%.%%%.%.....%%.........1.%.....%........%.....%.0.........%%.....%.%%%.%%.....%%...%%%%.%%..%......%..%%.%
m %%%%%%%%%%%%%%%%%%%%%%.....%....1......%%....%........%....%%......0....%.....%%%%%%%%%%%%%%%%%%%%%%%%%%%%........%%%%%%
m .%..%.%%%..%%..%.%%%%%%....%%..........%%...%%........%%...%%..........%%....%%%%%%.%..%%..%%%.%..%.%%..%.%......%.%..%%
m ..................%%%%....%%....%%%....%.....%%......%%.....%....%%%....%%....%%%%......................................
m ..................%%%%%...%%....%%%...%%....%%%......%%%....%%...%%%....%%...%%%%%......................................
m ....................%%%....%....%%%...%%.....%%......%%.....%%...%%%....%....%%%........................................
m %%.........%.........%%..........%..........%%........%%..........%..........%%.........%.........%%..%%.%........%.%%..
m %%%%%%%%....%.......%%..........%%...........%%......%%...........%%..........%%.......%....%%%%%%%%%%%%%%%%%%%%%%%%%%%%
m %%%...%%....%........%%.........%%%..........%%......%%..........%%%.........%%........%....%%...%%%%%%%%%%%.%%.%%%%%%%%
m %..........%%%.......%%...%%%.%.%%%....%%.%%%%........%%%%.%%....%%%.%.%%%...%%.......%%%..........%%..................%
m %%.........%%%%%....%%.....%%%%%%%%...%%%%%%%%%......%%%%%%%%%...%%%%%%%%.....%%....%%%%%.........%%....................
m %%.........%%%..%...%%.....%%...%.....%%%%%.%%%......%%%.%%%%%.....%...%%.....%%...%..%%%.........%%%..................%
m %%...%.%.%%..........%.....%%...............%%%......%%%...............%%.....%..........%%.%.%...%%%.%%%%%......%%%%%.%
m %%...%%%%%%..........%.....%................%%........%%................%.....%..........%%%%%%...%%%%%%%%%......%%%%%%%
m %.....%.%%..........%%.....%...7............%%%......%%%............4...%.....%%..........%%.%.....%%%%%%%%......%%%%%%%
m .........%%...%%....%%%....%........%.%.....%%........%%.....%.%........%....%%%....%%...%%.............................
m ........%%....%%....%%%...%%%....%%%%%%%%....%%......%%....%%%%%%%%....%%%...%%%....%%....%%............................
m .........%%....%.....%....%%%...%%%.%.%.....%%%......%%%.....%.%.%%%...%%%....%.....%....%%.............................
m .%%.%..........%....%%.......................%........%.......................%%....%..........%.%%.%..%..%......%..%..%
m %%%%...........%.....%......................%%........%%......................%.....%...........%%%%%%%%%%........%%%%%%
m ..%%%.........%%.....%%.....................%%........%%.....................%%.....%%.........%%%.....%.%........%.%...
m ...%%....%%%%.%%%...%%%....%%%%..%.%%.%.%..%%%%......%%%%..%.%.%%.%..%%%%....%%%...%%%.%%%%....%%.......................
m ...%....%%%%%%%%%....%%....%%%%%%%%%%%%%%%%%%%........%%%%%%%%%%%%%%%%%%%....%%....%%%%%%%%%....%.......................
m ...%%...%%%%.%%%....%%%....%%..%...%.%.%%..................%%.%.%...%..%%....%%%....%%%.%%%%...%%.......................
m ...%....%%....%%....%%....%%%..........................................%%%....%%....%%....%%....%.......................
m ...%....%%%...%%%....%%...%%............................................%%...%%....%%%...%%%....%........%........%.....
m ..%%%...%%%...%%%....%%...%%............................................%%...%%....%%%...%%%...%%%.......%%......%%.....
m ...%....%%%...%%....%%.....%%....%%.%%%...%..%........%..%...%%%.%%....%%.....%%....%%...%%%....%.......%%........%%....
m ..%%....%%%...%%%....%....%%%...%%%%%%%%%%%%%%........%%%%%%%%%%%%%%...%%%....%....%%%...%%%....%%....%%%%%......%%%%%..
m ....%...%%%...%%....%.%.....%...%%%.%%.%%..%............%..%%.%%.%%%...%.....%.%....%%...%%%...%.......%.%........%.%...
m ..............%%................%%%..............................%%%................%%.....................%....%.......
m ...............%.................%%..............................%%.................%.......................%%%%........
m ..............%%.................%%..............................%%.................%%......................%%%%........
m ..............%%.................%%..............................%%.................%%......................%%%%........
m ...............%.................%%..............................%%.................%.......................%%%%........
m ..............%%................%%%..............................%%%................%%.....................%....%.......
m ....%...%%%...%%....%.%.....%...%%%.%%.%%..%............%..%%.%%.%%%...%.....%.%....%%...%%%...%.......%.%........%.%...
m ..%%....%%%...%%%....%....%%%...%%%%%%%%%%%%%%........%%%%%%%%%%%%%%...%%%....%....%%%...%%%....%%....%%%%%......%%%%%..
m ...%....%%%...%%....%%.....%%....%%.%%%...%..%........%..%...%%%.%%....%%.....%%....%%...%%%....%.......%%........%%....
m ..%%%...%%%...%%%....%%...%%............................................%%...%%....%%%...%%%...%%%.......%%......%%.....
m ...%....%%%...%%%....%%...%%............................................%%...%%....%%%...%%%....%........%........%.....
m ...%....%%....%%....%%....%%%..........................................%%%....%%....%%....%%....%.......................
m ...%%...%%%%.%%%....%%%....%%..%...%.%.%%..................%%.%.%...%..%%....%%%....%%%.%%%%...%%.......................
m ...%....%%%%%%%%%....%%....%%%%%%%%%%%%%%%%%%%........%%%%%%%%%%%%%%%%%%%....%%....%%%%%%%%%....%.......................
m ...%%....%%%%.%%%...%%%....%%%%..%.%%.%.%..%%%%......%%%%..%.%.%%.%..%%%%....%%%...%%%.%%%%....%%.......................
m ..%%%.........%%.....%%.....................%%........%%.....................%%.....%%.........%%%.....%.%........%.%...
m %%%%...........%.....%......................%%........%%......................%.....%...........%%%%%%%%%%........%%%%%%
m .%%.%..........%....%%.......................%........%.......................%%....%..........%.%%.%..%..%......%..%..%
m .........%%....%.....%....%%%...%%%.%.%.....%%%......%%%.....%.%.%%%...%%%....%.....%....%%.............................
m ........%%....%%....%%%...%%%....%%%%%%%%....%%......%%....%%%%%%%%....%%%...%%%....%%....%%............................
m .........%%...%%....%%%....%........%.%.....%%........%%.....%.%........%....%%%....%%...%%.............................
m %.....%.%%..........%%.....%...5............%%%......%%%............6...%.....%%..........%%.%.....%%%%%%%%......%%%%%%%
m %%...%%%%%%..........%.....%................%%........%%................%.....%..........%%%%%%...%%%%%%%%%......%%%%%%%
m %%...%.%.%%..........%.....%%...............%%%......%%%...............%%.....%..........%%.%.%...%%%.%%%%%......%%%%%.%
m %%.........%%%..%...%%.....%%...%.....%%%%%.%%%......%%%.%%%%%.....%...%%.....%%...%..%%%.........%%%..................%
m %%.........%%%%%....%%.....%%%%%%%%...%%%%%%%%%......%%%%%%%%%...%%%%%%%%.....%%....%%%%%.........%%....................
m %..........%%%.......%%...%%%.%.%%%....%%.%%%%........%%%%.%%....%%%.%.%%%...%%.......%%%..........%%..................%
m %%%...%%....%........%%.........%%%..........%%......%%..........%%%.........%%........%....%%...%%%%%%%%%%%.%%.%%%%%%%%
m %%%%%%%%....%.......%%..........%%...........%%......%%...........%%..........%%.......%....%%%%%%%%%%%%%%%%%%%%%%%%%%%%
m %%.........%.........%%..........%..........%%........%%..........%..........%%.........%.........%%..%%.%........%.%%..
m ....................%%%....%....%%%...%%.....%%......%%.....%%...%%%....%....%%%........................................
m ..................%%%%%...%%....%%%...%%....%%%......%%%....%%...%%%....%%...%%%%%......................................
m ..................%%%%....%%....%%%....%.....%%......%%.....%....%%%....%%....%%%%......................................
m .%..%.%%%..%%..%.%%%%%%....%%..........%%...%%........%%...%%..........%%....%%%%%%.%..%%..%%%.%..%.%%..%.%......%.%..%%
m %%%%%%%%%%%%%%%%%%%%%%.....%....3......%%....%........%....%%......2....%.....%%%%%%%%%%%%%%%%%%%%%%%%%%%%........%%%%%%
m %%%...%%.....%%.%%%.%.....%%.........3.%.....%........%.....%.2.........%%.....%.%%%.%%.....%%...%%%%.%%..%......%..%%.%
m ........................%.%%%.%..%...%%%%....%........%....%%%%...%..%.%%%.%............................................
m .......................%%%%%%%%%%%%%%%%%....%%%......%%%....%%%%%%%%%%%%%%%%%...........................................
m ........................%%%%%.%....%%.%%%....%%......%%....%%%.%%....%.%%%%%............................................
m .....%%......%....%%..%%%%%%................%%%......%%%................%%%%%%..%%....%......%%......%%%.%........%.%%%.
m %%...%%%%%%%%%...%%%%%%%%%%%%...............%%........%%...............%%%%%%%%%%%%...%%%%%%%%%...%%%%%%%%........%%%%%%
m %%...%%...%%%%......%..%%%.%%...............%%........%%...............%%.%%%..%......%%%%...%%...%%%%..%%%......%%%..%%
m %%..........%...........%........%......%.%.%%........%%.%.%......%........%...........%..........%%....................
m %%..........%%.........%%%......%%%...%%%%%%%%%......%%%%%%%%%...%%%......%%%.........%%..........%%....................
m %.......3...%...........%........%%...%%%....%........%....%%%...%%........%...........%...2.......%%..................%
m %....%.....%%%%%.%%%.5..%.....%.%%%..............................%%%.%.....%..6.%%%.%%%%%.....%....%.....%%%....%%%.....
m %%...%%.....%%%%%%%%...%%....%%%%%................................%%%%%....%%...%%%%%%%%.....%%...%%....%%%%%%%%%%%%....
m %....%%.....%%%..%%%....%.....%%%..................................%%%.....%....%%%..%%%.....%%....%....%%%%%%%%%%%%....
m %%....%.................%%...........%%%....%.%......%.%....%%%...........%%.................%....%%%....%........%....%
m %%...%%%................%%..........%%%%%....%%......%%....%%%%%..........%%................%%%...%%....%%%......%%%....
m %.....%...............5%%..........%%%%%.....%%......%%.....%%%%%..........%%6...............%.....%%...%%%......%%%...%
m %%...%%%...%%....%%....%%%....%%...%%%........................%%%...%%....%%%....%%....%%...%%%...%%....%%........%%....
m %.....%....%%%...%%%%%%%%%....%%...%%%........................%%%...%%....%%%%%%%%%...%%%....%.....%%....%%......%%....%
m %%....%....%%%......%%.%.%...%%%....%..........................%....%%%...%.%.%%......%%%....%....%%%....%%......%%....%
m %..........%%.................%..........%.%%..........%%.%..........%.................%%..........%.....%........%.....
m %..........%%%...............%%...........%%%%........%%%%...........%%...............%%%..........%....%%........%%....
m %%..........%%................%..........%%%%.%......%.%%%%..........%................%%..........%%.....%%......%%.....
m %%%%.%.%%%%%%%..%.%.%...%.%%%%%....%.....%%%............%%%.....%....%%%%%.%...%.%.%..%%%%%%%.%.%%%%.....%........%.....
m %%%%%%%%%%%%%%%%%%%%%%%%%%%%%%%%....%%....%..............%....%%....%%%%%%%%%%%%%%%%%%%%%%%%%%%%%%%%....%%........%%....
m .%...%%.%.%%%.%%.%%%....%%%...%....%%%.....%............%.....%%%....%...%%%....%%%.%%.%%%.%.%%...%.....................
m ................................................%%%%....................................................................
m ...............................................%%%%%%...................................................................
m ...............................................%%%%%%...................................................................
m ...............................................%%%%%%...................................................................
m ...............................................%%%%%%...................................................................
m ................................................%%%%....................................................................
m .%...%%.%.%%%.%%.%%%....%%%...%....%%%.....%............%.....%%%....%...%%%....%%%.%%.%%%.%.%%...%.....................
m %%%%%%%%%%%%%%%%%%%%%%%%%%%%%%%%....%%....%..............%....%%....%%%%%%%%%%%%%%%%%%%%%%%%%%%%%%%%....%%........%%....
m %%%%.%.%%%%%%%..%.%.%...%.%%%%%....%.....%%%............%%%.....%....%%%%%.%...%.%.%..%%%%%%%.%.%%%%.....%........%.....
m %%..........%%................%..........%%%%.%......%.%%%%..........%................%%..........%%.....%%......%%.....
m %..........%%%...............%%...........%%%%........%%%%...........%%...............%%%..........%....%%........%%....
m %..........%%.................%..........%.%%..........%%.%..........%.................%%..........%.....%........%.....
m %%....%....%%%......%%.%.%...%%%....%..........................%....%%%...%.%.%%......%%%....%....%%%....%%......%%....%
m %.....%....%%%...%%%%%%%%%....%%...%%%........................%%%...%%....%%%%%%%%%...%%%....%.....%%....%%......%%....%
m %%...%%%...%%....%%....%%%....%%...%%%........................%%%...%%....%%%....%%....%%...%%%...%%....%%........%%....
m %.....%...............7%%..........%%%%%.....%%......%%.....%%%%%..........%%4...............%.....%%...%%%......%%%...%
m %%...%%%................%%..........%%%%%....%%......%%....%%%%%..........%%................%%%...%%....%%%......%%%....
m %%....%.................%%...........%%%....%.%......%.%....%%%...........%%.................%....%%%....%........%....%
m %....%%.....%%%..%%%....%.....%%%..................................%%%.....%....%%%..%%%.....%%....%....%%%%%%%%%%%%....
m %%...%%.....%%%%%%%%...%%....%%%%%................................%%%%%....%%...%%%%%%%%.....%%...%%....%%%%%%%%%%%%....
m %....%.....%%%%%.%%%.7..%.....%.%%%..............................%%%.%.....%..4.%%%.%%%%%.....%....%.....%%%....%%%.....
m %.......1...%...........%........%%...%%%....%........%....%%%...%%........%...........%...0.......%%..................%
m %%..........%%.........%%%......%%%...%%%%%%%%%......%%%%%%%%%...%%%......%%%.........%%..........%%....................
m %%..........%...........%........%......%.%.%%........%%.%.%......%........%...........%..........%%....................
