# map type: blank
# random seed: -482665748
# hill distance  98, 51  77, 24  66, 95  11, 34  56, 69  55,  2  28, 85  88, 13  29, 96  10, 23  45, 68  87, 50
#        98, 51       0      48      92      34      90      92      68      48      90      44      68      26 
#        77, 24      48       0      44      48      80      44      92      22      80      48      92      36 
#        66, 95      92      44       0      92      36      22      48      44      48      80      48      80 
#        11, 34      34      48      92       0      90      92      68      48      90      26      68      44 
#        56, 69      90      80      36      90       0      48      44      80      54     112      26      84 
#        55,  2      92      44      22      92      48       0      48      44      36      80      48      80 
#        28, 85      68      92      48      68      44      48       0      92      26      90      34      90 
#        88, 13      48      22      44      48      80      44      92       0      80      36      92      48 
#        29, 96      90      80      48      90      54      36      26      80       0      84      44     112 
#        10, 23      44      48      80      26     112      80      90      36      84       0      90      54 
#        45, 68      68      92      48      68      26      48      34      92      44      90       0      90 
#        87, 50      26      36      80      44      84      80      90      48     112      54      90       0 
players 4
rows 104
cols 104
m ............%%..............................%%%.....%%%%.....%%...................%%.....%%.%.....%.....
m ...........%%%%..............................%%%....%%%%.....%%%..................%%%.....%%......%.....
m ...........%%%..............................%%%......%%%.....%%...................%%%....%%%%.....%.....
m ............%%%............................%%%%......%%.....%%%.....%%.%.%%%%.....%.......%......%%.....
m %%.%.......%%%%.%%.%%%.....%%%%....%..%.%.%%%%%......%%.....%%%.....%%%%%%%%%....................%%%..%%
m %%%%%%%....%%%%%%%%%%%......%%%.....%%%%%%%%%%%......%%......%%%.....%%%%%%%%.....................%%%%%%
m %%%%%%.....%%%%%%%%%%%.....%%%......%%%%%%%%%%%%.....%%.....%%%......%.%%%%%%....................%%%%%%%
m ...%%.%....%%%%%%...%%.....%%%.......%%%.%....%%....%%%%.....%%%........%%%%......................%%%%%.
m ...........%%%.............%%%%..........................................%%%%....%%.%.....%.......%%%%%.
m ...........%%%.............%%%............................................%%.....%%%%.....%%......%%%%..
m ............%%.........0....%%...........................................%%%%....%%%.....%%%......%%%%..
m ...........%%%.............%%%%...3.................................%......%%.....%.......%%.....%.%.%%.
m .%%%..%....%%%.....%%..%.%.%%%%%%..%%..%%%.....%....%.......%%%%..........................%%............
m .%%%%%%.....%%%.....%%%%%%%%%%%%%%%%%%%%%%%%%%%%.....%%.....%%%...........................%%............
m .%%%%%%.....%%......%%%%%%%%%%%%%%%%%%%%%%%%%%%%.....%%......%%%..........................%%%...........
m .%%%%%......%%......%%.%%%%.%...%..%%%%%%%%....%.............%%%%.........................%%%...........
m .%%%%%.....%%%%.............................................%%%%%%.%....%.%...%..%.%...%%%%%%%.%.%%%%...
m .%%%%%......%%%..............................................%%%%%%%....%%%%%%%%%%%%%%%%%%%%%%%%%%%%....
m .%%%%%%.....%%%..............................................%%%%%%%....%%%%%%%%%%%%%%%%%%%%%%%%%%%%%...
m ..%%%%%....%%%.............................................%%..%..%%.....%.%%....%....%..%..%..%%%%%%...
m ..%%%....%%%%%.....%%%%%%..%..%..%....%....%%.%.....%%..%..%%...........................................
m .%%%.....%%%%%%....%%%%%%%%%%%%%%%%%%%%%%%%%%%%%....%%%%%%%.............................................
m .%%%......%%%%%.....%%%%%%%%%%%%%%%%%%%%%%%%%%%%....%%%%%%%.............................................
m .%%%%.....%%%%%....%%%%.%.%%%%%%%...%.%..%...%.%....%.%%%%%%............................................
m ..%%......%%%%%............%%%.........................%%%%.............%....%%%%%%%%..%...%.%%%%.%%....
m ..%%.....%%%%%%............%%%..........................%%%......%%.....%%%%%%%%%%%%%%%%%%%%%%%%%%%%....
m .%%%.....%%%%%%.............%%...........................%%%.....%%.....%%%%%%%%%%%%%%%%%%%%%%%%%%%%....
m ..%%%....%..%%%.............%%..........................%%%%.......%....%.....%%%..%%..%%%%%%.%.%..%%...
m ..%%%............%%.%.%.....%%.......%.....%%......%.................................2...%%%%...........
m ..%%..............%%%%......%%%.....%%%....%%%%...........................................%%....1.......
m ..%%%.............%%%%......%%.....%%%%.....%%............................................%%%...........
m ..%%%............%%%%%.......%.....%.%%....%%%%..........................................%%%%...........
m %%%%%....%.%%....%%%%%......................%%%%........%%%.....%%%%....%%....%.%%%.......%%%.....%%...%
m %%%%%.....%%%%%%%%%%%%%....................%%%%%%.%......%%%.....%%.....%%%%%%%%%%%%......%%%.....%%%%%%
m %%%%%....%%%%%%%%%%%%%.....................%%%%%%%%.....%%%......%%......%%%%%%%%%%%.....%%%......%%%%%%
m .%%%%.......%.%%%%..%%%....................%%%%%%%%%.....%%%.....%%......%%%%%.%.%..%....%%%%.....%%%.%%
m .%%%.................%%......%.......%.....%%%%.%.%%.....%%%.....%%......%%%%...........................
m ..%%%................%.....%%%%....%%%...................%%.....%%%......%%%............................
m .%%%%................%......%%.....%%%..................%%%.....%%%%....%%%.............................
m ..%%.................%.....%.%%.....%%...................%%.....%%%%.....%%%............................
m ..%%.......%%....%%..%..............%%%%.................%%.....%%%%....%%%.....%%.%%......%..%...%.....
m ..%%......%%.....%%%%%..............%%%%........%%%.....%%%%....%%%.....%%%%....%%%%......%%%%%%%%%%%...
m .%%%%....%%%%....%%%%%%.............%%%%%%%%....%%%%.....%%.....%%%.....%%%......%%%%....%%%%%%%%%%%%...
m .%%%%....%%%.....%.%.%.............%%%%%%%%......%%.....%%%.....%%%%.....%%.....%%%%%....%%..%%%%%%%%...
m .%%%......%%.........%%....%%%%%%.%%%....%%.....%%.......%%.....%%%%.......%....%.%%%.............%%%...
m .%%%%.....%%.........%......%%%%%%%%.....................%%......%%.0............................%%%%...
m ..%%%.....%%.........%%....%%%%%%%%......................%%%.....%%...............................%%%...
m .%%%.....%%%.........%......%%%%%%%%....................%%%.....%%%%.............................%%%....
m .%%%%%%.%%%%%......%%%%.....%%%%%%%%....................%%%......%%%....................%%.%.....%%%....
m ..%%%%%%%%%%%.....%%%%.....%%%%%%%%%....%.%.......%.....%%%%.....%%%%..%..%%......%%....%%%%......%%%...
m .%%%%%%%%%%%%.....%%%%......%%%%%%%%....%%%%....%%%%%%%%%%%......%%%%%%%%%%%.....%%%.....%%%.....%%%....
m .%.%%%.%.%%%.....%%%%%%....%%%%%%%%%.....%%......%%%%%%%%%%.....%%%%%%%%%%%%....%%%.....%%%%.....%......
m ..........%%%........%.....%%.%..%.%....%.%...........%%%%%%.....%%%%.%%%%.%.....%%.........%...........
m .........%%%%........%%.................................%%%.....%%%..............%%%....................
m ..........%%.........%...................................%%.....%%%%............%%%%....................
m ..0......%%%.........%..................................%%%%....%%%..............%%%....................
m .%.%%....%%%.....%%%%%%%.................................%%%....%%%%.3...........%%%............%%.%....
m ..%%......%%......%%%%%%..%.%..%.%.%.%.....%%.%....%....%%%%.....%%..............%%%.%.%%.%%....%%%%%...
m .%%%%.....%%.....%%%%%%%%%%%%%%%%%%%%%%%%%%%%%%%%%%.....%%%%....%%%.....%%%%....%%%%%%%%%%%......%%%....
m .%........%.........%%%%....%%%%.....%%.....%%%%%%%%....%%%%....%%%%....%%%%.....%%%%%%%%%%.....%%%%%...
m .....................%%%....%%%%....%%%......%%%%%%.....%.%%.......%.....%%%.....%%%%%%..%.......%.%%...
m .....................%%%....%%%......%%%.....%%%%%%%.....................%%.............................
m .....................%.%....%.......%%%%....%%%%%..%.....................%%%............................
m ............................................%%%.........................%%%%............................
m %%%.%....%%.%..%............................%%%.........................%%%.............................
m %%%%%.....%%%%%.............................%%%.....%%%%%%%..%%%..%.....%%%%%.%...%%%%.%%.%%....%.%%....
m %%%%......%%%%%..............................%%.....%%%%%%%%%%%%%%%%%%%%%%%%%%%%%%%%%%%%%%%....2.%%.....
m .%%%.....%%%%%%%..........%%.%%%.....%.%....%%%%....%%%%%%%%%%%%%%%%%%%%%%%%%%%%%%%%%%%%%%%%....%%%.....
m %%..%.....%%%%%......%%%%%%%%%%%%%%%%%%%.....%%%.....%%%%%%%%..%...%%.%%%%%%.%%...%%.%%.%%%%....%.%.....
m .........%%%%%%%....%%%%%%%%%%%%%%%%%%%......%%......%%%%%%%............................%%%%............
m .........%%.%..%.......%%.%.%%%%%...%%.......%.%....%%%...%%............................%%%.............
m .............................%%%.........................................................%%%............
m ............................%%%.........................................................%%%.............
m %..%.%%......................%%%............................%%...%%%....%.%.......%%...%%%%%.%.%%.......
m %%%%%%%.....................%%%%............................%%%%%%%......%%......%%%%%%%%%%%%%%%%%%%....
m .%%%%%.....%..%%.....%.%....%%%%.%%.%%...%%.%%%%%%.%%...%..%%%%%%%%.....%%%.....%%%%%%%%%%%%%%%%%%%.....
m %%%%%%%.....%%%......%%%....%%%%%%%%%%%%%%%%%%%%%%%%%%%%%%%%%%%%%%%%....%%%%....%.%.....%%%.%%..........
m .%%%%%......%%%%.....%%.3....%%%%%%%%%%%%%%%%%%%%%%%%%%%%%%%%%%%%%%%.....%%.............................
m .%%%%%.....%%%%%....%%.%....%%.%%.%%%%...%.%%%%%.....%..%%%..%%%%%%%.....%%%............................
m %..%.%%....%.%%%.............................%%%.........................%%%............................
m ............................................%%%%.........................%%%............................
m ............................................%%%.....................%..%%%%%....%%%%.......%....%.%.....
m .............................................%%.....................%%%%%%%.....%%%......%%%....%%%.....
m ...................%%.%.......%..%%%%%%.....%%%.....%.......%%.%.....%%%%%%......%%%....%%%%....%%%.....
m .....%........%....%%%%%.....%%%%%%%%%%.....%%%%....%%%%....%%%%....%%%%%%%%.....%%.....%%%%....%%%%....
m ....%%.....%%%%.....%%%......%%%%%%%%%%%....%%%%.....%%%....%%%%.....%%%%%%%%%%%%%%%%%%%%%%%%%%%%%%%%%%.
m ....%%......%%.....%%%%%....%%.%%.%.%%%..............%%.....%%%%....%....%.%%.....%.%.%.%..%.%..%%%%%%..
m ....%%%....%%.%.....%.%%............%%%...........2.%%%%....%%%.................................%%%%%%%.
m ....%%%......1......................%%%..............%%%....%%%%..................................%.....
m ....%%..............................%%%%............%%%%.....%%...................................%.....
m ...%%%%.............................%%%..............%%%.....%%%.................................%%.....
m ...%%%.....................%.........%%.....%.%%%%.%%%%.....%%%%%%...........%.%....%.%..%.%%.....%.....
m ....%%%.%.%%%.%.......%.....%%%%.....%%%....%%%%%%%%%%%%.....%%%%%%%%%%......%%.....%%%%%%%%%....%%%%%%.
m ...%%%%%%%%%%%%.....%%%.....%%%.....%%%.....%%%%%%%%%%%......%%%%%%%%%%%....%%%%....%%%%%%%%......%%%%..
m ...%%%%%%%%%%%.....%%%......%%%%....%%......%%..%..%%%%.....%%%%.....%.......%.%....%%%%%%%%%.....%%%%..
m ...%%%%%.%%%%%%.....%%%.....%.%%....................%%%......%%%....................%%%%%%%%.....%%%%...
m ....%%%.....%%%.....%%%.............................%%%%.....%%%....................%%%%%%%%......%.....
m ....%%.....%%%.....%%%...............................%%.....%%%......................%%%%%%%%....%%.....
m ....%%.....%%%%....%%%%............................1.%%......%%.....................%%%%%%%%......%.....
m ....%%......%%%....%%%.............%%%.%....%.......%%%%.....%%.......%%.....%%....%%%.%%%%%%....%%.....
m ....%%%....%%%%....%%%%%%%%..%%....%%%%%.....%%.....%%%%.....%%%.....%%......%%%%%%%%.............%.%.%.
m ...%%%%....%%%%....%%%%%%%%%%%%....%%%%......%%%.....%%%.....%%.....%%%%....%%%%%%%%.............%%%%%%.
m ....%%......%%.....%%%%%%%%%%%......%%%%....%%%%.....%%%....%%%%.....%%%........%%%%..............%%%%%.
m ...%%.......%%.......%...%..%......%%.%%.....%%%....%%%%.....%%.................%%%%..............%..%%.
