# map type: blank
# random seed: -101949017
# hill distance  61, 22  63, 28  32, 59  26, 57
#        61, 22       0       8      58      66 
#        63, 28       8       0      66      74 
#        32, 59      58      66       0       8 
#        26, 57      66      74       8       0 
players 2
rows 66
cols 66
m %....%..%%%%%%%..%%....%%....%%%...%%%%%%%%....%%....%%%.....%%%%%
m %...........%....%%%..........%...........%%...%%%...%%%....%%.%%%
m %%.........%%....%%..........%%%..........%%....%.................
m %..........%%%...%%%.........%%...........%%....%.................
m %%%...%%...%%.....%....%%.....%.....%.....%.....%%%...............
m %%%%%%%....%%.....%%...%%....%%%....%.....%%....%%%..%.%%%%.%..%%%
m %%%%%%%....%%%...%%%....%%...%.....%%%....%%...%%%%%%%%%%%%%%%%%%%
m .%%%%%%%................%%..........%..........%%....%%.%%.....%%%
m ......%%...............%%...........%.............................
m ......%................%%%..........%%............................
m ......%%...%..%.%%.%...%%%.%.%%.%..%%%%%%.%%%.....................
m .%.....%...%%%%%%%%%...%%%%%%%%%%%%%%%%%%%%%%...%%.%%%.%%.%%%%%...
m %%....%%...%%%....%.....%%%..%%.%%%.%%...%%%%...%%%%%%%%%%%%%%%...
m %%.....%%%%%%...........%%...............%%%..........%%%.%%%%....
m .%%.........%..........%%..................%%.........%%.....%....
m .%..........%%.........%%..................%%.........%%%...%%%...
m %%..........%%..%%......%%%..%.....%%.%....%%.........%%....%%%...
m .%%.........%%%%%%%.....%%%%%%%%....%%....%%%%..%.....%%%...%%....
m %%.....%%%%%%%%%%.%....%...%%%......%%%...%%%%%%%%%...%%....%%....
m .%....%%..%%%%%%%..................%..%....%%...%.....%%.....%%...
m .............%%...........................%%.................%....
m .............%............................%%.................%....
m .............%....%%%%..%....%%.%.........%%%................%....
m .%%%.%.%.....%....%%%%%%%%...%%%.....%.....%.....%..%.%.%%..%%%%.%
m %%%%%%%%.....%%....%%%%%.....%%%%....%....%%%....%%%%%%%%%%%%%%%%%
m %%%.%%..%...%%%...%.%%%......%%%%...%%%...%%%...%%.%%.%%%.%%%%....
m .%...........%......................%%.....%...........%.0........
m .%%..........%%.....................%%.....%%..........%..........
m .%%..........%............%..........%%...%%...........%..........
m %%%...%.%..%%%%...%%%....%.....%.....%%..%%%%%.%%......%....%%....
m %%....%%%%%%%%....%%%...%......%%....%%%%%%%%%%%%%%...%%%...%%....
m %%.....%%..%%%.....%..........%%....%..%%..%%%%..%%...%%....%%....
m %%....%%%.........%%.........%%%...........................0%%....
m .%....%%%.........%%.........%%%%...........................%%%...
m .%%...%%%.........%%%...%%...%%%%............................%....
m .%%...%%%....%%...%%%%%%%%....%%%..........%%...%%.%.%......%%%...
m .%%....%.....%%...%%%%%.%%...%.%%...%%....%%....%%%%%%%%....%%%...
m ......%%....%%.......................%%....%%...%..%%%%%%...%%....
m ......%%%...%%.....................%%%%....%%..........%.....%%...
m ......%%....%%.....................%%%.....%...........%%...%%%...
m ......%%....%%....%%.....%.%.%%...%%%%.....%%.........%%....%%....
m %%..%.%%.....%%%%%%%...%%%%%%%%%%%%%%%%%..%%....%..%..%%%....%%%%%
m %%%%%%%%%.....%%%%.....%%%...%.....%%%%%%%%%....%%%%%%%%.....%%%%%
m %%%%..%................%%%.........%%....%%%%...%%%%%.%%......%...
m %%%.....................%..........%%....%............%%%.........
m %%%.....................%...........%....%............%%..........
m %%..........%...%..%%%%%%%...%......%....%............%%..........
m .%%....%....%%%%%%%%%%%%%.....%%...%%....%%%%.%%..%....%%..%%.%...
m .%.........%%%%%%%.%%%%.%%....%....%......%.%%%%%%%....%%%%%%%%...
m %%..........%................%%%...............%%%....%%%%..%%%...
m ............%%...............%%................%%%...........%....
m ...........%%.................%%...............%%%..........%%....
m .......%.%%%%.....%%%....%%%.%%%.....%..%......%%%%..........%%...
m %%...%%%%%%%%%....%%%%%%%%%%%%%%...%%%%%%%%%...%%%%.%........%....
m %%...%..%%%%%%........%%%%...%%.....%.%..%%.....%%%%%%%%....%%....
m ............%%................%%...............%%%...%%%..........
m ............%%................%................%%%...%%%..........
m ............%%................%%...............%%%...%%%..........
m ..%..%%%...%%%.%%.%%.%........%%...%..%%..%%....%.....%%%.........
m %%%%%%%.....%%%%%%%%%%%%%%...%%%%%%%%%%%%%%%....%....%%%%...%%....
m %..%.%%%......%%.%%%.%%%%%...%%%....%%%%.%%%....%%...%..%...%%....
m ......%%..............1......%%..........%%%....%.................
m ......%......................%%..........%%%....%%................
m .....%%.....................1.%%..........%....%%%................
m .....%%%..%..%.%.%......%....%%%.....%.%.%%%...%%%.....%%...%%%...
m %....%%%%%%%%%%%%%%....%%%%%%%%....%%%%%%%%%....%%...%%%%....%%%%%
