# map type: blank
# random seed: 602080960
# hill distance  66,  7   3, 15  36,  7  41, 78  28, 62  93, 70   3, 45  80, 15  74, 70  58, 53  66, 84  11,  1  74, 40  11, 78  49, 23  19, 32
#        66,  7       0      71      40      60      79      60      75      52      71      54      19      65      55      80      33      78 
#         3, 15      71       0      55      75      78      65      40      19      80      79      60      52      60      71      54      33 
#        36,  7      40      55       0      40      59      90      81      74      75      68      49      55      81      60      29      62 
#        41, 78      60      75      40       0      29      74      81      90      55      62      55      49      81      40      59      68 
#        28, 62      79      78      59      29       0      73      62      93      54      49      74      52      68      33      66      49 
#        93, 70      60      65      90      74      73       0      55      54      19      52      41      41      49      52      93      74 
#         3, 45      75      40      81      81      62      55       0      49      60      59      90      74      40      55      68      29 
#        80, 15      52      19      74      90      93      54      49       0      65      74      41      41      55      60      73      52 
#        74, 70      71      80      75      55      54      19      60      65       0      33      52      60      40      71      78      79 
#        58, 53      54      79      68      62      49      52      59      74      33       0      73      93      29      78      49      66 
#        66, 84      19      60      49      55      74      41      90      41      52      73       0      54      74      65      52      93 
#        11,  1      65      52      55      49      52      41      74      41      60      93      54       0      90      19      74      73 
#        74, 40      55      60      81      81      68      49      40      55      40      29      74      90       0      75      62      59 
#        11, 78      80      71      60      40      33      52      55      60      71      78      65      19      75       0      79      54 
#        49, 23      33      54      29      59      66      93      68      73      78      49      52      74      62      79       0      49 
#        19, 32      78      33      62      68      49      74      29      52      79      66      93      73      59      54      49       0 
players 4
rows 96
cols 96
m ...%%%......%.....%%%%%%%%%%......%%%....%%%%%%%%%%%%.....%%%%%%%%%%%%%%%%%%%%%%%%%%%%%%%%%%%...
m ....%%......%....%%%%%%%%%%%.....%%%%.....%%%%%%%%%%%.....%%%%%%%%%%%%%%%%%%%%%%%%%%%%%%%%%%%...
m ....%%%....%%....%%.%%%%%%%%.....%%%.....%.%%.%.%%%%......%%.%%%%.%..%.%.%%%%%%%...%.%%%.%..%...
m ....%%%....%%..2.........%%%.....%%%.........0....%%......................%%....................
m ...%%%%.....%.............%%%....%%%%............%%%%....................%%%....................
m ...%%%%...%%%.............%%%.....%%.............%%%.....................%%%....................
m ....%%%%%%%%%.............%%%....%%%.............%%%......................%%%...................
m ...%%%%%%%%%%%%%%..%......%%......%%%.....%..%%%%%%%%%..%%..%......%.....%%%%.%%..%.%.......%%%.
m ....%%%.%%.%.%%.%..%%....%%%......%%%.....%%%%%%%%%%%%%%%%%%%.....%%%.....%%%%%%%%%%.....%%%%...
m ...%%%.............%......%%%....%%%%.....%%%%%%%%%%%%%%%%%%......%%%....%%.....................
m ...%%%%.............%....%%......%%%%....%..%%%.%.%.%%.%%...%....%..%....%%.....................
m .0..%%.............%%............%%%......................................%...0.................
m ....%%%............%%.............%%%....................................%%.....................
m ....%%......%%%.....%............%%%...........................................%%.%.........%%%.
m ...%%%.....%%%.....%%............%%%%..........................................%%%%.........%%..
m ....%%%.....%%......%%%.....%....%%%%....%%%%%.%.%......%%%...%%%%.%.%%.%%%.....%%..........%%..
m ....%%........%....%%%.....%......%%%....%%%%%%%%%%%%%%%%%%%%%%%%%%%%%%%.%.....%%%%.........%.%.
m ...%%%%............%%%%....%%.....%%......%%%%%%%%%%%%%%%%%%%%%%%%%............%%%%.............
m ...%%%%............%%%.....%%....%%.%.....%%%..%%%%..%.....%.%..%.%............%%%%.............
m ...%%%%............%%%.....%%...1.........%%...................................%%%..............
m ...%%%%.............%%%.....%.............%%%..................................%%%..............
m ...%%%.....%%.%.....%%.....%%............%%%%..........................%.%....%%%%%........%.%..
m %%%%%%%.....%%......%%%.....%.............%%%..........................%%%%%%%%%%%.........%%%%%
m %%%%%%%.....%%.....%%%.....%%%%%%%%%%....%%%%.............%.%.%%%%......%%%%%%%%%%.........%%%%%
m %%.........%%%.....%%%............%%.....%%%......%%......%%%%%%%.%.....%..%%%.............%.%%.
m ...........%%%%....%%%....................%%......%%%.....%.....................................
m ............%%%.....%%.............%......%%%....%%%%.....%.....................................
m ............%%......%%..............%.....................%.....................................
m ...........%%%%.....%%%............%%.....................%...2.................................
m ...%%%..%..%%%%.....%%.......%%....%%.....................%....%..%%%.%%%..%.%%%%..........%%%..
m ...%%%%%%%%%%%......%%......%%%.....%....................%%....%%%%%%%%%%%%%%%%%%%%........%%%%.
m ...%%%%%%%%%%%%.....%%%.....%%%.....%%%%%%%.........%%.%.%%.....%%%%%%%%%%%%%%%%%%%.........%%%.
m ...%%%%.%%%%%%.....%%%%.......%.........%..%......%%%%%...%....%.%%%.%.%%%%..%..%%..............
m ....%%%....%%%%.....%%%...........................%.............................................
m ...%%%.....%%%.....%%%%....................%%.....%.............................................
m ....%%%....%%%%.....%%.....................%%.....%.............................................
m ....%%.2...%%%%....%%%......................%....%%.............................................
m ....%%%.....%%%....%%%%.%%%%..%.......%%%%%%%.....%......%%.%....%%....%.......%.%......%%%.%.%.
m ...%%%%.....%%.....%%%%%%%%%%%%.....%.%%.%%%%.....%....%%%%%%%%%%%%.....%%%.....%%......%%%%%%..
m ....%%.....%%%.....%%%%%%%%%%%%....%.....%%%%.%%.%.....%%%%%%%%%%%%.....%%.....%%%%.....%%%%%%..
m ....%.%.......%....%%....%.%%......%.....%%%%%%%.......%..%%%%.%%%%....%%%.....%%%.....%.%.%%%..
m ...................................%%....%......................%%%....%%%%...3.%%..............
m ...................................%.....%%.....................%%.....%%%%....%%%..............
m ...................................%.....%%....................%%%%.....%%%.....%%%.............
m ...................................%...........................%%%.....%%%%....%%%..............
m ....%%..%..%%%%.%.%%%.%....%...%%%%%......%..%.........%.......%%%%.....%%%%%%.%%%%.............
m ...%%%%%%%%%%%%%%%%%%%.....%%.%.%%.........%%%%%%%.....%%%.....%%%.....%%%%%%%%%%%%....%%%......
m ...%%%%%%%%%%%%%%%%%%%%....%%....................%.....%%%......%%......%%%%%%%%%%%....%%%%.....
m .....%%%%.%..%%%.%%%..%....%.....................%%....%%.......%%.....%%%%..%..%%%.....%%%.....
m .......................3...%.....................%%............%%%.....%%%%.....................
m ...........................%.....................%..............%%......%%......................
m ...........................%.....%%%%....%%%......%.............%%.....%%%......................
m ...........................%.....%%%......%%....................%%%....%%%%.....................
m ........%%%..%.....%.%%%%%%%......%%......%%%.....%%............%%%.....%%%.........%%.%%.%.....
m ....%%%%%%%%%%......%%%%.%.%.............%%%%....%%%%%%%%%%.....%%%.....%%.....%%%%%%%%%%%%.....
m ....%%%%%%%%%%%..........................%%%.............%.....%%%......%%.....%%%%%%%%%%%%.....
m ...%%%%%....%.%..........................%%%%............%%.....%%.....%.%%.....%%%.....%.%.....
m ....%%%..................................%%%.............%.....%%%.............%%%%.............
m ....%%%...................................%%.........0...%%.....%%%............%%%%.............
m ...%%%%............%.%..%.%.....%..%%%%..%%%.....%.%%....%%.....%%%............%%%%.............
m ...%%%%............%%%%%%%%%%%%%%%%%%%%%%%%%......%%.....%%....%%%%............%%%%.............
m ...%%%%.....%.%%%%%%%%%%%%%%%%%%%%%%%%%%%%%%%....%%%......%.....%%%....%........%%.....%.%......
m ....%%.....%%%.%%.%.%%%%...%%%......%.%.%%%%%....%%%%....%.....%%%......%%.....%%%......%%......
m ...%%%%..........................................%%%%............%%.....%%%.....%%%.....%%......
m ...%.%%...........................................%%%............%.....%%%......%%.....%%%......
m ...........%%....................................%%%.............%%............%%%..............
m .......1...%......................................%%%............%%.............%%..1...........
m ...........%%....%..%....%...%%.%%.%.%.%%%..%....%%%%......%%....%.............%%%%.............
m ...........%%....%%%......%%%%%%%%%%%%%%%%%%.....%%%%....%%%......%.............%%%.............
m ..%%%%%%%%%%.....%%%.....%%%%%%%%%%%%%%%%%%%.....%%%......%%%....%%..%.%%.%.%%.%%%.......%%%%...
m .%.%..%%.%%%%.....%......%..%%..%%%%%%%%%..%.....%%%......%%......%..%%%%%%%%%%%%%%....%%%......
m .........%%%......................%%%.............%%%....%%%.............%%%%%%%%%..............
m ..........%%%.....................%%%.............%%.....%%%.............%%%...%%%%.............
m ..........%%%....................%%%%............%%%%....%%%.............%.....%%%%.............
m ..........%%......................%%....1.........%%%.....%%%.........3..%%....%%%..............
m %.%...%%%%%%%.%.%..%.%%%%.%%......%%%%.%.%%.%.....%%%.....%%%%%%%%.%%....%%....%%%.......%..%.%%
m %%%%%%%%%%%%%%%%%%%%%%%%%%%%.....%%%%%%%%%%%.....%%%%.....%%%%%%%%%%%....%......%%.......%%%%%%%
m %%%%%%%%%%%%%%%%%%%%%%%%%%%%.....%%%%%%%%%%%%....%%%......%%%%%%%%%%.....%......%%%......%%%%%%%
m ..%.%...%%.%.%%...%..%%%%%%%.....%%%%.%...%.......%%........%..%%%.%%....%%.....%%.......%.%..%.
m ..........................%%.............................................%.....%%%%.............
m ...............2..........%%%.............................................%.....%%..............
m ..........................%%%..................................................%%%..............
m ..........................%%...................................................%%%..............
m ...........%.....%..%.....%%%.....%%.....%.....................................%%%%....%%%.%.%%.
m ...........%.....%%%.....%%%%....%%%......%%%...................................%%.....%%%%%%%%.
m ...%%%%....%%....%%%%.....%%.....%%%.....%%%%............................%.....%%%......%%%%%%%.
m ....%%......%............%%%%....%%.......%%%............................%......%%%....%%%%%%%..
m ...%%%......%............................%%%.......%%....%%%%............%......%%......%%%%%%%.
m ....%%%.....%............................%%%%.....%%%.....%%.....%%%%....%%....%%%%....%%%%%%%..
m ....%%...................................%%%......%%%....%%%%.....%%%.....%............%%%%%%%%.
m ...%%%%.....................................%.....%%.....%%%.....%..%.....%............%%.%.%%%.
m ....%%%...................................................%%....................................
m ....%%%..................................................%%%....................................
m ....%%.....%.............................................%%%..........3.........................
m ...%%%%.....%.............................................%%....................................
m ....%%.....%%....%%.%%%..%........%%.......%...%.%%%%.....%%%%%%%..%...%%.%.%%...%.%...%..%.%...
