# map type: blank
# random seed: 565569627
# hill distance 107, 16  29, 82  44, 26  74, 12  88, 26  18, 71  74, 56  84,103
#       107, 16       0      82     109      41      29      80     137      46 
#        29, 82      82       0     125     101     105      22     103      80 
#        44, 26     109     125       0     146     130     103     100     137 
#        74, 12      41     101     146       0      28     105     130      29 
#        88, 26      29     105     130      28       0     101     146      41 
#        18, 71      80      22     103     105     101       0     125      82 
#        74, 56     137     103     100     130     146     125       0     109 
#        84,103      46      80     137      29      41      82     109       0 
players 2
rows 110
cols 110
m %%.....%%%%%..............................%%%%%%%%%%%%%%%%%%%%%%%%......%%%%.....%%%%%%%%%%%...............%%%
m %%.....%%%%%.............................%%%%%%%%%%%%%%%%%%%%%%%%%.....%%%%.......%%%%%%%%%%................%%
m %.......%%%%..............................%%%%%%%%%%%%%%%%%%%%%%%......%%%%%.....%%%%%%%%%%%...............%%%
m %%......%%%..............................%%%%%%..%..%.%%.%%..%.........%%%%......%.%..%.%%%%................%%
m %%......%%%..........................%%%%%%%%...........................%%%.................................%%
m %......%%%%%%.%%.%..%%%%%%....%.......%%%%%%%..........................%%%%%..........................%%%.%%%%
m %%......%%%%%%%%%%%%%%%%%%%%%%%%......%%%%%%%%.........................%%%%%.........................%%%%%%%%%
m %%......%%%%%%%%%%%%%%%%%%%%%%%%.....%%%%%%%%%..........................%%%..........................%%%%%%%%%
m %%.....%%%%%%%%%%%%%%%%%%%%%%%%%.....%%%%%%%%...........................%%%..........................%%%%%%%%%
m ........%....%...%%%%.%..%%%%.%%.....%%..%%%%%.%%%%%%%.%.......%.%...%.%%%%%.%%.%.%..%%....%.....%%%%%.......%
m ...............................................%%%%%%%%%......%%%%%%%%%%%%%%%%%%%%.....%%%%......%%%%%........
m ...............................................%%%%%%%%%......%%%%%%%%%%%%%%%%%%%%......%%%......%%%%%........
m ...............................................%%%%%%%%%.....%%%%%%%%%%%%%%%%%%%%%.....%%%%......%%%%.........
m ...............................................%%%%%%%%......%..%...%..%.%%%.....%.....%%.%.......%%%.........
m ...............................................%%%%%%%%%...................................%.....%%%%%........
m %.....%...........%%.%.....%.%..%.....%........%%%%%%%%%...................................%......%%%%.%%%....
m %%%%%%%%%%%.......%%%......%%%%%%%%%%%%%%%......%%%%%%%%..........................................%%%%%%%%%%%%
m %%%%%%%%%%%%.....%%%%%......%%%%%%%%%%%%%%......%%%%%%%%.........................................%%%%%%%%%%%%%
m %%%%%%%%%%%.......%%%%.....%%%%%%%%%%%%%%%.....%%%%%%%%%...............0...................%......%%%%%%%%%%%%
m %.%..%...%........%%%.........%.%%.%.%%%%......%%...%%%%%%...%%%%.%%..%%.%.%...........%%%%......%%.%%.%....%%
m ..................%%%%................%%%................%%%%...........................%%%%..................
m ..................%%%................%%%%%................%%%...........................%%%...................
m .................%%%%%................%%%.................%%%...........................%%%%..................
m .................%%%%.................%%%................%%%%...........................%%%%..................
m .................%%%%%...............%%%%.................%%%...........................%%%...................
m %%.....%%.%......%%%%%...............%%%%%..%.%.%%%%.....%%%%%.......%%.%%%%.....%.....%%%%%..%%..%.%%.%%.%...
m %%......%%%%.....%%%%%......%%%......%%%%%%%%%%%%%%......%%%%%.....%%%%%%%%%...........%%%%%%%%%%%%%%%%%%%%%%%
m %%......%%%%......%%%......%%%%.......%%%%%%%%%%%%%......%%%%%......%%%%%%%%.....%.....%%%%%%%%%%%%%%%%%%%%%%%
m %......%%%%%.....%%%%%.....%%%%.......%%%%%%%%%%%%%.......%%%......%%%%%%%%%............%%%%%%%%%%%%%%%%%%%%%%
m %%.....%%.%%......%..%......%%%......%%%%%.%.%%%.%%%.....%%%%%......%%%%%%%......%1....%%%%%..%%.%%%.%.%%.%%%%
m %%..........................%%%%......%%%%................%%%%.....%%%%%%%%%.....%......%%%.................%%
m %..........................%%%%.......%%%.................%%%......%%%%%%%%%............%%%%................%%
m %...........................%%%.......%%%................%%%%%.....%%%%%%%%............%%%%.................%%
m %...........................%%%......%%%%%................%%%%.....%%%%.%.%......%......%%%.................%%
m %...........................%%%%.....%%%%................%%%%....................%......%%%................%%%
m %%%%%..%%%...........%%%%%.%%%%%.%%%%%%%%%.....%%.%.......%%%%%%%%......................%%%%.......%%%.....%%%
m %%%%%%%%%%%%......%%%%%%%%%%%%%%%%%%%%%%%......%%%%......%%%%%%%%%...............%.....%%%%.......%%%%......%%
m %%%%%%%%%%%%......%%%%%%%%%%%%%%%%%%%%%%%%......%%%%.....%%%%%%%%%...............%......%%%%......%%%......%%%
m %%%%%%%%%%%.......%%%%%%%%%%%%%%%%%%%%%%%......%%%%......%%%%%%%%%...............%......%%%.......%%%%......%%
m %%%%%%....%%.....%%%%%%%.%%%%%..%.%...%..%......%%%%......%%%%%%%%.%%.%%.%%%.....%.....%%........%%%%%......%%
m %%...............%%%%%.........................%%%%......%%%%%%%%%%%%%%%%%%%%%%%%.................%%%......%%%
m %................%%%%%.........................%%%%......%%%%%%%%%%%%%%%%%%%%%%%%.................%%%......%%%
m %%...............%%%%%.........................%%%%%.....%%%%%%%%%%%%%%%%%%%%%%%%................%%%%.......%%
m %%...............%%%%%..........................%%%%.....%%%%.%%%.%.%..%.%%%.%..%%...............%%%%......%%%
m %%................%%%.....1.....................%%%..............................%................%%%......%%%
m %%.......%.%...%%%%%%%%%.%%.%...%..%..%.%....%.%%%%%%%%%.........................%%%%%%.%%%%.....%%%%.......%%
m %......%%%%%%%%%%%%%%%%%%%%%%%%%%%%%%%%%%%%%%%%%%%%%%%%%.........................%%%%%%%%%%......%%%%.......%%
m %......%%%%%%%%%%%%%%%%%%%%%%%%%%%%%%%%%%%%%%%%%%%%%%%%%.........................%%%%%%%%%%%......%%%%.....%%%
m %%......%%%%%%%%%%%%%%%%%%%%%%%%%%%%%%%%%%%%%%%%%%%%%%%%.........................%%%%%%%%%%%.....%%%%%......%%
m %%.....%%.%.....%%%.%..%%..%%%%%..%..%%%%%%..%.%%%%%%%%%.%%..%.%.......%...%......%%%%%%%%%%......%%%......%%%
m %...........................%%%................%%%%%%%%%%%%%%%%%%%.....%%%%%......%%%%%%%%%%......%%%......%%%
m %..........................%%%%................%%%%%%%%%%%%%%%%%%......%%%%%......%%%%%%%%%%.....%%%%%.....%%%
m %..........................%%%%................%%%%%%%%%%%%%%%%%%%......%%%%.....%%%%%%%%%%%......%%%%.....%%%
m %..........................%%%%................%%%%%%%%%..%%%.%.%%.....%%%%......%%..%%%%%%%......%%%.......%%
m %..........................%%%%%....................%%%................%%%%%.....................%%%%.......%%
m %%.%..%%..%.%%..%%.%%......%%%%%.....%%%%.%%%%.....%%%%%...............%%%%................%.%%..%%%%......%%%
m %%%%%%%%%%%%%%%%%%%%%.......%%%%......%%%%%%%%......%%%.................%%%%...............%%%%%%%%%%%.....%%%
m %%%%%%%%%%%%%%%%%%%%%.......%%%.......%%%%%%%%......%%%................%%%%................%%%%%%%%%%.......%%
m %%%%%%%%%%%%%%%%%%%%%%.....%%%%%......%%%%%%%%.....%%%%.................%%%................%%%%%%%%%%.......%%
m .%..%%%.%....%%%%.%%%........%.......%%%%%%%%......%%%%......%.%.%.%..%%%%%%...%..%%%......%%%%%%%.%.%......%.
m .....................................%%%%%%%%%.....%%%%%......%%%%%%%%%%%%%%%%%%%%%%%.......%%%%%.............
m .....................................%%%%%%%%%.....%%%%.......%%%%%%%%%%%%%%%%%%%%%%%.......%%%%%.............
m .....................................%%%%%%%%%.....%%%%%.....%%%%%%%%%%%%%%%%%%%%%%%%%.....%%%%%%.............
m .....................................%%%%%...%.....%%%%.......%%%%%%...%..%%%..%.%%%%......%%%..%.............
m ....................................................%%%.......%%%%................%%%.........................
m %%......%..%.%%..%%.%%%....%....%%%%................%%%%......%%%%...............%%%%................%.....%.%
m %.......%%%%%%%%%%%%%%%%%%%%%%%%%%%%...............%%%%......%%%%%................%%%................%......%%
m %......%%%%%%%%%%%%%%%%%%%%%%%%%%%%%................%%%.......%%%%...............%%%%................%.....%%%
m %.......%%%%%%%%%%%%%%%%%%%%%%%%%%%%................%%%%.....%%%%................%%%%%...............%.....%%%
m %......%%%%%%%.%.%%....%%%%%%%%%%%%.......%.%%%....%%%%.......%%%%%...%...........%%%......%%%%......%.....%%%
m %%......%%%%...............%%%%%%%%.......%%%%%%%%%%%%%.......%%%%%%%%%%%%%......%%%%......%%%%%.....%%%%%%%%%
m %%......%%%................%%%%%%%%......%%%%%%%%%%%%%%......%%%%%%%%%%%%%%.......%%%%......%%%......%%%%%%%%%
m %.......%%%%...............%%%%%%%%.......%%%%%%%%%%%%%%.....%%%%%%%%%%%%%%.......%%%......%%%%.......%%%%%%%%
m %%......%%%................%%%%%%%%%......%..%%%%%.%%%%......%%%%%...%..%%........%.%%.....%%%%.......%%%%%%%%
m .......%%%%%1..................%%%%.................%%%%0....%%%%..........................%%%%......%%%%.....
m ........%%%......%.%.%%%%%.....%%%%.................%%%%.....%%%%%.........................%%%%%......%%%%....
m .%......%%%%.....%%%%%%%%%.....%%%%................%%%%.......%%%%..........................%%%%.....%%%%%....
m .%......%%%%......%%%%%%%%.....%%%%................%%%%%.....%%%%%..........................%%%%......%%%.....
m .%.....%%%%.......%%%%%%%%......%%%%................%%%%.....%%%%%.........................%%%%%.....%%%%%....
m .%.......%.%.....%%%%%%%%%......%%%%......%.........%%%%.%%%%%%%%%.....%%.%%%.%.%.%%.%......%%%%.....%%%%%....
m .................%%%%%%%%.......%%%%.....%%%%%.....%%%%%%%%%%%%%%.......%%%%%%%%%%%%%......%%%%%......%%%.....
m .................%%%%%%%%%......%%%......%%%%%......%%%%%%%%%%%%%.......%%%%%%%%%%%%%%.....%%%%......%%%%.....
m .................%%%%%%%%......%%%%%.....%%%%......%%%%%%%%%%%%%%......%%%%%%%%%%%%%%%.....%%%%.......%%%.....
m .%...............%%%%%..%%.....%%%%%......%%%%.....%%%%%.%%%%%..........%.%%%%%....%.......%%%%%.....%%%......
m .%..............................%%%......%%%%%.....%%%%%....................................%%%........0......
m .%......%..%%%%%...............%%%%......%%%%.......%%%%....................................%%%%..............
m ........%%%%%%%%................%%%%.....%%%%.......%%%.....................................%%%%..............
m .%.....%%%%%%%%%...............%%%%%.....%%%%%......%%%....................................%%%%...............
m .......%%%%%%%%%..........0....%%%%.......%%%%......%%%.....................................%%%%..............
m .%.....%%%%%%%%%.....%.%%.%.%.%%%%%%......%%%.......%%%%.....%.%%......%%%%........%........%%%%..%%%%%%%.....
m .......%%%%%%%%.......%%%%%%%%%%%%%.......%%%%.....%%%%......%%%%......%%%%%......%%%.......%%%%%%%%%%%%%%....
m .......%%%%%%%%......%%%%%%%%%%%%%%.......%%%.......%%%%......%%%%......%%%......%%%%.......%%%%%%%%%%%%%.....
m .......%%%%%%%%%......%%%%%%%%%%%%%%.....%%%%......%%%%.......%%%%.....%%%%%......%%%......%%%%%%%%%%%%%%%....
m .......%%%%%%%........%...%....%.%........%%%%.....%.%%.......%%%%.....%%..%......%%%.......%..%...%%%%%%%....
m .........................................%%%%%................%%%.................%%%%................%%%.....
m .%%%%%...................................%%%%................%%%%................%%%%................%%%%.....
m .%%%%%...................................%%%%................%%%%%................%%%................%%%%%....
m .%%%%%....................................%%%%...............%%%%%................%%%................%%%%.....
m .%%%%%....................................%%%................%%%%%...............%%%%.................%%%%....
m .%%%%%.....%.%.%%%...%%%%..%.%%....%.....%%%%%.....%%..%%%%.%%%%%%....%%.%%%......%%%.......%%%.%%.%%%%%%.....
m ...........................%%%%%%%%%......%%%%%%%%%%%%%%%%%%%%%%%%%%%%%%%%%%.....%%%%%......%%%%%%%%%%........
m ...........................%%%%%%%%%......%%%%%%%%%%%%%%%%%%%%%%%%%%%%%%%%%......%%%%......%%%%%%%%%%%........
m ...........................%%%%%%%%......%%%%%%%%%%%%%%%%%%%%%%%%%%%%%%%%%%......%%%%.......%%%%%%%%%%........
m ...........................%%%%%%%.%........%%..%%%%.%..%%.%%..%.%%....%%%%.......%%%.......%%%%..%.%.........
m ...........................%%%%........................................%%%%%......%%%.......%%%%..............
m ..%.%..%%.%..........%%.%%.%%%%.........................................%%%.......%%%%......%%%...............
m .%%%%%%%%%%%......%%%%%%%%%%%%%........................................%%%%%......%%%%......%%%%..............
m .%%%%%%%%%%%....1%%%%%%%%%%%%%%........................................%%%%%.....%%%%%......%%%%..............
m .%%%%%%%%%%%.....%%%%%%%%%%%%%%.........................................%%%.......%%%.......%%%%..............
m %%.%%%.%%%%%.....%.%.%%.%.%..%%%%%%%.....%..%...%%..%%.......%%.%%.....%%%%%.....%%%%%%..%%%%%%......%......%%
