# map type: blank
# random seed: 1072315716
# hill distance  29,103 115, 61
#        29,103       0      84 
#       115, 61      84       0 
players 2
rows 128
cols 128
m .......%%%....%%%.............%%%......................%%%............%%%%................%%%%.....%%%.............%%%......%%%.
m ....%%.%%%.....%%..............%%......................%%.............%%%..................%%%%....%%%%....%.%%%%%%%%%......%%%.
m ....%%%%%%.....%%.............%%%.....................%%%%.............%%..................%%%.....%%%......%%%%%%%%%%.....%%%%.
m ....%%%%%%.....%%.............%%%.....................%%%.............%%%%.................%%%......%%.....%%%%%%%%%%%%.....%%..
m ...%..%.%.%%%%%%%%....%.%%.....%%%....%%..%.%.%.......%%%%%.%.%.%%.....%%%....%..%...%%....%..%......%.....%.%%...%%%%.....%%%%.
m ...........%%%%%%......%%%.....%%%.....%%%%%%%%%%%.....%%%%%%%%%%......%%.....%%%%%%%%%.............................%%.....%%%%.
m ...........%%%%%%.....%%%.....%%%%....%%%%%%%%%%%......%%%%%%%%%%.....%%%%....%%%%%%%%..............................%%.....%%%..
m ...........%%%%%%%....%%%%.....%%%.....%%%%%.%%%%.......%%..%%%.%%............%.%%%%%%.............................%%%.....%%%..
m ............%%%%%%....%%%%............%%%......%%.................................%%%%.............................%%%%.....%%%.
m .%%%%.%.....%%%%%%.....%%%.............%%%....%%%%.................................%%%%......%%....%%%%.%%%%........%%%.....%%%.
m %%%%%%%.....%%%%%%.....%%.............%%%.....%%%%.................................%%%.....%%%.....%%%%%%%%%%%%....%%%%....%%%%%
m %%%%%%......%%%%%%....%%%.............%%%%....%%%%..................................%%......%%%....%%%%%%%%%%%......%%......%%%%
m %%%%%%%.....%.%...%%%%%%%%.....%%%.%%%%%%%.....%%%...%.%.%%%%%%...%.%%.%.%....%....%%%%....%%%......%%....%.%...............%.%.
m ...%%%..............%%%%%......%%%%%%%%%%%.....%%%%%%%%%%%%%%%%%%%%%%%%%%.......................................................
m ....%%..............%%%%%......%%%%%%%%%%.....%%%%%%%%%%%%%%%%%%%%%%%%%%%%......................................................
m ...%%%..............%%%%%%.......%...%%%%.......%.%%%.%%%%%.%.%...%.%.%%%.......................................................
m ....%%.............%%%%%%%.............................%%%.............%%%%.....................................................
m ....%%.........%%.%%%%%%%%.............................%%%............%%%%%.%.%.....%.%%..%..%%....%.%.%.%%%%..%.%.%%%%.....%%%.
m ....%%......%%%%%%%%%%%%%%.............................%%.............%%%%%%%%......%%%%%%%%%%%%%%%%%%%%%%%%%%%%%%%%%%%.....%%..
m ....%%......%%%%%%%%%%%%%%............................%%%.............%%%%%%%%%.....%%%%%%%%%%%%%%%%%%%%%%%%%%%%%%%%%%.....%%%..
m ...%%%......%......%.%%%%%%%%%...%%%%.%..%%..%.%.%....%%%%.......%..%%%%%%.%%%......%..%.%%%%%%%%.%.....%.%%%%..%%%%%%%.....%%%.
m ...%%%%....................%%%%%%%%%%%%%%%%%%%%%%%....%%%%.....%%%%%%%%.....%%%.............%%......................%%......%%..
m ...%%%%....................%%%%%%%%%%%%%%%%%%%%%%%.....%%%.....%%%%%%%%....%%%%............%%%%.....................%%.....%%%..
m ....%%%....................%%%%%%%%....%.%.%%%.%%.....%%%......%%%%%%%......%%..............%%......................%%.....%%%%.
m ...%%%.....................%%%%%%%.............................%%%%%%%.....%%%%............%%%.....................%%%.....%%%..
m ...%%%%%.%%..%.%.%.%%%%.....%%.................................%%%%%%%%.....%%.....%..%.....%%%.....%%.%.%%...%....%%%%...%%%%..
m ...%%%%%%%%%%%%%%%%%%%%.....%%%................................%%%%%%%......%%.....%%%%....%%%%....%%%%%%%%%%%.....%%%%%%%%%%%%.
m ....%%%%%%%%%%%%%%%%%%......%%.................................%%%%%%%......%%......%%.....%%%%....%%%%%%%%%%%%....%%%%%%%%%%%%.
m ....%%%.%.%%..%%%.%%%.%....%.%%....%%%%%%.....%.%..%.%%.......%............%%%%....%%%%....%..%....%.%%.%.%%%%.....%%.%....%%%..
m ...%%%.................................%%%....%%%%%%%%%%%%..................%%%....%%%.................0....%%%............%%%%.
m ....%%%................................%%......%%%%%%%%%%..................%%%%....%%%%....................%%%%............%%%%.
m ...%%%.................................%%......%%....%%%%%..................%%%.....%%......................%%.............%%%%.
m ....%%%...............................................%%%%%................%%%%.....%%%....................%%%.............%%%..
m ....%%%......%%.%..%%...%..%%%%....%.%................%%%%%%.%......%%%..%%%%%%....%%%%.%.%%%%%..%.%%%......%%%....%.%%....%%%%.
m ....%%......%%%%%%%%%%%%%%%%%%%....%%%................%%%%%%%%.....%%%%%%%%%%%.....%%%%%%%%%%%%%%%%%%%%.....%%.....%%%.....%%%%.
m ...%%%......%%%%%%%%%%%%%%%%%%......%%................%%%%%%%%.....%%%%%%%%%%%%.....%%%%%%%%%%%%%%%%%%%....%%%%.....%%......%%%.
m ...%%%.....%%%%%%%%%.%%...%%%%.......%%.%.....%.%%....%%%%%%%%%....%.%%%...%%%........%%%..%%%%...%..%......%.......%%......%%%.
m ...%%%.....%%%..............%%%........%%%.....%%%%%%%.....%%%%.............%%%.............%%......................%%%.....%%..
m ....%%%....%%%%.............%%%........%%%.....%%%%%%%......%%.............%%%..............%%%....................%%%%....%%%%.
m ...%%%%.....%%.............%%%.........%%......%%%%%%%......%%%............%%%.............%%%......................%%......%%..
m ....%%%....%%%..............%%.........%%%....%%%%%%%%......%%.............%%%.............%%%%....................%%%.....%%%%.
m ....%%%....%%%%....%.%.%.%%%%%.....%...%%%.....%%%%%%%%.....%%......%%%.....%%%%%%...%.....%%%%.....%...%..%%.%..%%%%%......%%..
m ...%%%......%%.....%%%%%%%%%%%......%%%%%.....%%%%%%%%%....%%%%....%%%.....%%%%%%%%%%%.....%%%%.....%%%%%%%%%%%%%%%%%%%.....%%%.
m ...%%%%.....%%%.....%%%%%%%%%%.....%%%%%%......%%%%%%%.....%%%.....%%%%.....%%%%%%%%%%.....%%%%.....%%%%%%%%%%%%%%%%%%......%%%.
m ...%%%.....%%%..........%%%%%%%.....%%%%%%..%.%.%.%...%......%%.....%%......%..%%%.%%%%....%%%%....%..%.%%..%.%%%%%.%.%....%%%..
m ...%%%%.....%%.............%%%......%%%%%%%%%%.....................%%%%............%%%.....%%%..............................%%..
m ....%%%....%%%%.............%%%.....%%%%%%%%%%%....................%%%..............%%%....%%%.............................%%%%.
m ...%%%......%%.............%%%%.....%%%%%%%%%%.....................%%%.............%%%.....%%%%.............................%%..
m ....%%......%%..............%%%....%%%%%%%%%%%......................%%%............%%%%.....%%%............................%%%..
m ....%%......%%......%%......%%%....%%%%%%%%%%%%..%%.%%.......%.....%%%%......%%%.%.%%%.....%%%%%%%..%.....%.%%.%%%%...%.%..%%%..
m ....%%%.....%%%.....%%.....%%%......%%%%%%%%%%%%%%%%%%%....%%%%.....%%.....%%%%%%%%%%%.....%%%%%%%%%%%%%%%%%%%%%%%%%%%%%%%%%%%%.
m ...%%%%....%%%%.....%%......%%......%%%%%%%%%%%%%%%%%%.....%%%%....%%%.....%%%%%%%%%%%%.....%%%%%%%%%%%%%%%%%%%%%%%%%%%%%%%%%%%.
m ...%%%......%%%....%%%......%.......%%%%%%%%%%%%%.....%.......%.....%%%....%%%%%%.%.%.%.....%%%%%%%.%...%%%.%%..%...%.%..%.%....
m ...%%%%.....%%%....%%%..............%%%%%%%%%%%%%.....%%%%....%.....%%.....%%%%............%%%..................................
m ....%%......%%%.....%%%............%%%%%%%%%%%%%%......%%.....%.....%%%.....%%%.............%%%.................................
m ...%%%......%%.....%%%..............%....%%....%.%......%%....%.....%%%.....%%%.............%%%.................................
m ...%%%%.....%%.....%%%%............................................%%%%.....%%.............%%%..................................
m ...%%%%.....%%%.....%%%..%.%%%....................................%%%%%....%%%%....%%%%....%%%%..%%%%%.......%%...%%%%...%.%%.%.
m %%%%%%.....%%%%.....%%%%%%%%%%....................................%%%%......%%%....%%%%%%%%%%%%%%%%%%%.....%%%%%%%%%%%%%%%%%%%%%
m %%%%%%%.....%%%.....%%%%%%%%%%....................................%%%%......%%%....%%%%%%%%%%%%%%%%%%%%.....%%%%%%%%%%%%%%%%%%%%
m %..%..%....%%%%......%%%%%.%%%...........%%%%.%.....%%..%%....%.%.%%%%..............%..%%.%%%%%%.....%.....%%%%%....%%..%%%.%%.%
m ...........%%%..............%%%%%%.....%%%%%%%%%%%%%%%%%%%....%%%%%%%%%....................%%%..............%%%.................
m ...........%%%.............%%%%%%%....%%%%%%%%%%%%%%%%%%%%.....%%%%%%%%....................%%%%.............%%..................
m ...........%%%%.............%.%%%%......%..%.%%%%%.%..%%%%....%...%%%%%....................%%%.............%%%..................
m ...........%%%%................%%.............%%%%....%%%.............%.....................%%.............%%%%.................
m ..%%%.%.%.%%%%.......%%%.%....%%%%............%%%%.....%%.............%%%%%%..%..%%%.%%.....%%%........%%.%%%%%.....%%%%...%.%..
m %%%%%%%%%%%%%%%.....%%%%%.....%%%.............%%%......%%%............%%%%%%%%%%%%%%%%%.....%%%.....%%%%%%%%%%%.....%%%%%%%%%%%%
m %%%%%%%%%%%%%%.....%%%%%%%....%%%..............%%%.....%%.............%%%%%%%%%%%%%%%%......%%%....%%%%%%%%%%%......%%%%%%%%%%%%
m ..%%%%%%%%%.%.%....%%%%%%%....%%%%%.%..........%%.....%%%.....%.%%....%%%%%%%%%%..%%%.%.....%.%....%%%%%%%.%%%......%%%.%.%%%..%
m ...%%%..............%%%%%%....%%%%%%%%%%%%.....%%%....%%%......%%%....%%%%%%%%%....................%%%%.............%%..........
m ....%%..............%%%%%......%%%%%%%%%%%.....%%......%%%....%%%%.....%%%%%%%%.....................%%%............%%%%.........
m ....%%.............%..%%..........%%.%%.........%%....%%%%....%%%%....%%%%%...%....................%%%%.............%%..........
m ....%%................................................%%%.....%%%......%%%....%....................%%%..............%%%.........
m %%.%%%........%.......................................%%%......%%%.....%%......%%%%%..%......%%..%.%%%%%.%..%%%.....%%%.....%%%%
m %%%%%%.....%%%%%%.....................................%%%%....%%%......%%%.....%%%%%%%%%%%%%%%%%%%%%%%%%%%%%%%%.....%%%....%%%%%
m %%%%%%%.....%%%%%.....................................%%%.....%%%%.....%%%.....%%%%%%%%%%%%%%%%%%%%%%%%%%%%%%%%....%%%......%%%%
m ..%%..%.....%%%%%%....%.%.%%..%%%%..%%%%%...%..%.%..%.%%%%....%%%......%%.....%%%%%%%%%...%%.%...%%%%.%%%%.%%%%....%%%......%%%%
m ............%%%%%......%%%%%%%%%%%%%%%%%%%%%%%%%%%%%%%%%%%.....%%%.....%%......%%%%%%%%.............................%%.....%%%..
m ............%%%%%.....%%%%%%%%%%%%%%%%%%%%%%%%%%%%%%%%%%%......%%.....%%%.....%%%%%%%%%.............................%%......%%..
m ................%......%%%%%%%%.%......%....%.%..%%.%%%.......%%%..................%%%%............................%%%%....%%%..
m ......................%%%%....................................%%%%....................%.............................%%%....%%%%.
m ...%...%..............%%%......................................%%%.....................%%%%%%%%....%%%.%.%%%.%.%.%%%%%%....%%%..
m ...%%%%%%.............%%%%....................................%%%.....................%%%%%%%%.....%%%%%%%%%%%%%%%%%%%.....%%%%.
m ...%%%%%%%............%%%......................................%%%.....................%%%%%%%%....%%%%%%%%%%%%%%%%%%%.....%%%..
m ...%%%%%%.....%%......%%%%....%%.%%..%.%%...%%.%.%%%%....%%.%.%%%%.%%%........%.%%....%%%..........%%.%%%..%%%%%.%%...%.....%.%.
m ...%%%%%%......%%%%%%%%%%......%%%%%%%%%%%%%%%%%%%%%%%%%%%%%%%%%%%%%%%%%%%%%%%%%%......%%%....%.............%%%.................
m ....%%%%%......%%%%%%%%%%%.....%%%%%%%%%%%%%%%%%%%%%%%%%%%%%%%%%%%%%%%%%%%%%%%%%%%.....%%%....%.............%%..................
m .....%%%%%....%%%%...%%%%%....%%%%%%.%%%...%.%%%%..%.%%%...%.%..%%%.%%%....%.%%%%%....%.......%.............%%..................
m ..............%%%.....%%%%.....%%.............................................%%%%..........................%%..................
m ...............%%%.....%%......%%.............................................%%%%................%..%.....%%%%%.%.%%.%%.%..%.%%
m %..............%%%.....%%.....%%%.............................................%%%.................%%%%......%%%%%%%%%%%%%%%%%%%%
m %%............%%%%....%%%.....%%%..............................................%%.................%%%%%....%%%%%%%%%%%%%%%%%%%%%
m %%....%.%.%...%%%%.....%%......%%%.....%%...%..%%.%.%.%%%%.%%%.%%..%..%..%....%%%%%..%%.%%%.%%%...%%%%%.........%%.%%%.....%%%%%
m %......%%%%%%%%%%%.....%%%....%%%......%%%%%%%%%%%%%%%%%%%%%%%%%%%%%%%%%%%.....%%%%%%%%%%%%%%%%%%%%%%%%....................%%%%%
m %%....%%%%%%%%%%%%....%%%.....%%%%.....%%%%%%%%%%%%%%%%%%%%%%%%%%%%%%%%%%%....%%%%%%%%%%%%%%%%%%%%%%%%%....................%%%%%
m %......%%%%%.%..%.....%%%%.....%%%....%%%%%.%.%...%.%...%%%%%%%%%%%%%..%........%..%%%%.%...%%..%%.%.%%....................%%%%%
m %.....................%%%.....%%%......%%......................%%%.............................................................%
m %%.....................%%.....%%%%....%%%......................%%..............................................................%
m %.....................%%%.....%%%......%%%.....................%%..............................................................%
m %%.....................%%%.....%%......%%......................%%..............................................................%
m %%....%..%%%....%%%.%.%%%%.....%%.....%%%%....%.%...%%...%....%%%%....%.%%......%%%....%...%%.%..%%.....%.....%%..%.%.%........%
m %......%%%%%%%%%%%%%%%%%%%....%%%%.....%%......%%%%%%%%%%%.....%%%%%%%%%%%.....%%%%%%%%%%%%%%%%%%%%%%%%%%%....%%%%%%%%........%%
m %%.....%%%%%%%%%%%%%%%%%%%....%%%%....%%%.....%%%%%%%%%%%.....%%%%%%%%%%%%.....%%%%%%%%%%%%%%%%%%%%%%%%%%%....%%%%%%%%%.......%%
m %%.....%%%.%..%%....%..........%%%.....%%......%%%%.%...%%....%%%%%...%%%%......%.%%..%%%%%%.%...%...%..%%.....%%%%%%%........%%
m %.....%%%%.....................%%%.....%%%....%%%%....................%%%.............%%%%.....................%%%%%%%%........%
m %%....%%%%.....................%%......%%%....%%%%....................%%%%.............%%%.....................%%%%%%%........%%
m %......%%......................%%.....%%%%....%%%.....................%%%..............%%%.....................%%%%%%%........%%
m %%....%%%%....................%%%......%%%....%%%......................%%%.............%%%....................%%%%%%%%%........%
m %%...%%%%.....%%%%......%%%..%%%%%.....%%.....%%%%.....%.%..%%.%.%.....%%.......%.....%%%%....%%........%%.%.%%%....%%%........%
m %%%%%%%%%%....%%%%....%%%%%%%%%%%%....%%%%.....%%......%%%%%%%%%%.....%%%......%%.....%%%%....%%%......%%%%%%%%................%
m %%%%%%%%%.....%%%%....%%%%%%%%%%%.....%%%%....%%%%....%%%%%%%%%%%.....%%%%....%%%......%%.....%%%%....%%%%%%%%.................%
m .%....%%%%....%%%.....%%%%%%..%.%......%%......%%%.....%..%.%.%%%.....%%%%.....%%%....%%.%.....%%.....%%%%%%%%%................%
m .......%%%.....%%......%%%............%%%%.....%%.............%%%%....%%%%....%%%%.....................%%%%%%%..................
m .......%%%....%%%%....%%%.............%%%.....%%%..............%%%.....%%%.....%%%.....................%%%%%%%%....%%%..........
m ......%%%.....%%%.....%%%%............%%%.....%%%%............%%%.....%%%......%%%....................%%%%%%%%%....%%%%.........
m ......%%%%....%%%%....%%%%.............%%......%%............1.%%%.....%%%.....%%.....................%%%%%%%%......%%..........
m ......%%%.....%%%%.%%%%%%......%.......%%.....%%%......%%.....%%%......%%......%%%.......%.%%..%..%%..%%%..%%.......%%.....%%%%%
m %%.....%%%.....%%%%%%%%%%.....%%%%.....%%......%%.....%%%%....%%%%.....%%%....%%%%....%%%%%%%%%%%%%%%%.............%%%.....%%%%%
m %.....%%%%....%%%%%%%%%%%......%%%....%%%%.....%%%.....%%%.....%%%.....%%.....%%%%.....%%%%%%%%%%%%%%%..............%%......%%%%
m %.....%%%%....%%%%%%.%%%.......%%%.....%%.....%........%%%....%%%......%%%.....%%%......%%%.%%%%%%%%%%%.............%%.....%%%%%
m %%............%%%..............%%%....%%%.............%%%.............%%%.....................%%%%%%%%%.............%%%.....%%%%
m ..............%%%%.............%%%....%%%%.............%%%.............%%......................%%%%%%%......%......%%%%....%%%..
m ...............%%..............%%.....%%%%.............%%.............%%%.....................%%%%%%%%.....%%%......%%.....%%%..
m ...............%%.............%%%.....%%%%.............%%.............%%%......................%%%%%%%%....%%%%.....%%......%%..
m ...%%%.%.%.....%%%....%%%%..%.%%%%.%%.%%%%%%..%%%%%.%.%%%%....%%%%..%.%%%%.....%.%....%..%.%%%%.%.%%%%......%%%.....%%%.....%%%.
m .......%%%....%%%%.....%%%%%%%%%%%%%%%%%%%%%%%%%%%%%%%%%%%.....%%%%%%%%%%%....%%%%.....%%%%%%%%....%%%.............%%%.....%%%%.
m .......%%%.....%%.....%%%%%%%%%%%%%%%%%%%%%%%%%%%%%%%%%%%%.....%%%%%%%%%%.....%%%......%%%%%%%%....%%%%.............%%%....%%%%.
m .......%%%....%%%..........%%%%%%%%..%..%%.%%%%%%%%%..%%%%....%%%.%.%.%%%.....%.%.....%%%%%%%%%.....%%%............%%%%.....%%..
