# map type: blank
# random seed: -1610159283
# hill distance 135, 12 130, 33  66,119  59,139 110, 40  87,114
#       135, 12       0      72     126     131     131     124 
#       130, 33      72       0     128     133     133     126 
#        66,119     126     128       0     133     133      72 
#        59,139     131     133     133       0     102     131 
#       110, 40     131     133     133     102       0     131 
#        87,114     124     126      72     131     131       0 
players 2
rows 150
cols 150
m ....%%.....%%%%%................%%%%..........................%%%%...............%%%%..............................%%%.......%%%%.....%%%%............
m ....%%%.%%.%%%%%......%%%%.....%%%%%.....%%%%%.....%%%........%%%%%..%.%%%%......%%%%%.....%...%%%%................%%%%.....%%%%%......%%%............
m ....%%%%%%%%%%%.......%%%%.....%%%%.......%%%%%%%%%%%%%%.....%%%%%%%%%%%%%%......%%%%......%%%%%%%%...............%%%%%......%%%.......%%%............
m ....%%%%%%%%%%%%.....%%%%%.....%%%%.......%%%%%%%%%%%%%......%%%%%%%%%%%%%%%.....%%%%......%%%%%%%%...............%%%%.......%%%.......%%%%...........
m ....%%%%%%%%%%%%.....%%%%%.....%%%%%.....%%%%%%%%%%%%%%......%%%%%%%%%%%%%%%......%%%%......%%%%%%%......%.%.......%%%%.....%%%%%.....%%%%%.....%%%%..
m ....%%%%%%%%%%%%......%%%.......%%%%........%..%.%.%%%%%.....%%.%.%.%%%%%%%.......%%%......%%%%%%%......%%%%%.....%%%%%.....%%%%.......%%%%%%%%%%%%%%.
m .....%%%%%%%%%%......%%%%.......%%%%...............%%%%%................%%%%......%%%......%%%%%%%......%%%%......%%%%.......%%%......%%%%%%%%%%%%%%%.
m .....%%%%%%%%%%......%%%%.......%%%%...............%%%%%...............%%%%......%%%%......%%%%%%%.......%%%.......%%%.......%%%%.....%%%%%%%%%%%%%%..
m .......%.%%%%%%......%%%%%.....%%%%%................%%%%...............%%%%.......%%%%.....%%%%.%%%......%%%......%%%%.......%%.......%...%%.%%%%%%%%.
m ..............%%......%%%%......%%%................%%%%%................%%%.......%%%...................%%%%%.....%%%%%.........................%%%%%.
m ..............%%......%%%%......%%%................%%%%%................%%%.......%%%...................%%%%%......%%%..........................%%%%%.
m ..............%%%.%%%%%%%......%%%%%%.%%%....%......%%%......%%.%%...%%%%%%%.....%%%%%%%%...............%%%%.......%%%%.........................%%%%..
m ..............%%%%%%%%%%%%......%%%%%%%%%%%%%%......%%%%.....%%%%%%%%%%%%%%.......%%%%%%%...............%%%%%.....%%%%%..........................%%%..
m ..............%%%%%%%%%%%......%%%%%%%%%%%%%%.......%%%......%%%%%%%%%%%%%%......%%%%%%%%................%%%.......%%%%..........................%%%..
m .%.%.%.........%%%%%%%%%%%......%%%%%%%%%%%%%%.....%%%%%.....%%%%%%%%%%%%%%......%%%%%%%%..%...%..%..%..%%%%......%%%%%...%..%%%%.....%..%%%.%%.%%%%%%
m %%%%%%%%%......%%%%%%%%%%%............%...%%%%.....%%%%%......%%%%..%%....%%.....%%%%%%%%%%%%%%%%%%%%%%%%%%%.......%%%%%%%%%%%%%......%%%%%%%%%%%%%%%%
m %%%%%%%%%......%%%%%%%%%%%.........................%%%%.......%%%%...............%%%%%%%%%%%%%%%%%%%%%%%%%%%%......%%%%%%%%%%%%%%.....%%%%%%%%%%%%%%%%
m %%%%%%%%.......%%%%%%%%%%%..........................%%%......%%%%%...............%%%%%%%%%%%%%%%%%%%%%%%%%%%.......%%%%%%%%%%%%%......%%%%%%%%%%%%%%%%
m %%.%.%%.%.....%%%%%%%%%%%%.........................%%%%%......%%%%...............%%%%%%.%...%...%%%%%..%%%%%.......%.%...%%%%%%.%.....%%%.%%%%%%.%%.%%
m ..............%%%%......%..........................%%%%%......%%%%......................................%%%%%.........................................
m ...............%%%......%%.........................%%%%......%%%%%......................................%%%%%.........................................
m ..............%%%%%.....%%%%.%%....%...%.%.%%.%...%%%%%......%%%%%.......%..%%%.........................%%%%%.........................................
m ..............%%%%%.....%%%%%%%%%%%%%%%%%%%%%%%%%%%%%%%......%%%%.......%%%%%%%..........................%%%..........................................
m ..............%%%%%.....%%%%%%%%%%%%%%%%%%%%%%%%%%%%%%%.......%%%......%%%%%%%%.........................%%%%..........................................
m .%.%%...%.....%%%%.......%%%%%%%%%%%%%%%%%%%%%%%%%%%%%%......%%%%.......%%%%%%......%...%....%.%%........%%%%%%.%.%%%..%%.....%.%.........%%%...%%..%.
m %%%%%%%%.......%%%.......%%%%%%%%%%%....%%%%%.%..%%%%%%........%........%%%%%%......%%%%%%%%%%%%%%%.....%%%%%%%%%%%%%%%%%%%%%%%%......%%%%%%%%%%%%%%%%
m %%%%%%%%%......%%%%......%%%%%%%%%%................%%%%%...............%%%%%%%%......%%%%%%%%%%%%%%.....%%%%%%%%%%%%%%%%%%%%%%%%.......%%%%%%%%%%%%%%%
m %%%%%%%%%......%%%......%%%%%%%%%%%................%%%%%...............%%%%%%%.......%%%%%%%%%%%%%%.....%%%%%%%%%%%%%%%%%%%%%%%%%.....%%%%%%%%%%%%%%%%
m ..%.%%%%.......%.%%......%.%%%%%%%%................%%%%................%%%..%........%%%%..%%.%%%%%.......%..%%..%..%%%..%.%%%%%......%%%%%...%%%%%%.%
m .....%%%%.........................%................%%%%%.............................%%%%.....%%%%...........................%%%.......%%%%...........
m .....%%%%.........................%%................%%%.............................%%%%%.....%%%%%.........................%%%%%......%%%%...........
m .....%%%..........................%%........%%.....%%%%%...%%..%%.%%%...............%%%%......%%%%..........................%%%%%......%%%............
m ....%%%%..........................%%.....%%%%%.....%%%%%%%%%%%%%%%%%%................%%%.......%%%...........................%%%.......%%%............
m .....%%%%.........................%%......%%%%......%%%%%%%%%%%%%%%%%................%%%......%%%%%..........................%%%.......%%%............
m ....%%%%%..%%%%%%.......%%%.......%%.....%%%%.......%%%%%%%%%%%%%%%%..........%%%%%%%%%%%......%%%%%%...%%..%..%.%.%%.%......%%%%.....%%%%%......%%.%.
m ....%%%%%%%%%%%%%%.......%%%%.....%%.....%%%%%.....%...%....%%%%%%%%%......%%%%%%%%%%%%%%.....%%%%%%%%%%%%%%%%%%%%%%%%.......%%%%......%%%%.....%%%%%.
m .....%%%%%%%%%%%%%%......%%%%......%......%%%%...............%%%%%%%%.....%%%%%%%%%%%%%%.......%%%%%%%%%%%%%%%%%%%%%%%.......%%%......%%%%%.....%%%%..
m .....%%%%%%%%%%%%%.......%%%%......%......%%%%...............%%%%%%%.......%%%%%%%%%%%%%%.....%%%%%%%%%%%%%%%%%%%%%%%%.......%%%%.....%%%%%.....%%%%..
m ....%%%%%..%%%%%%%......%..%%.............%%%................%%%%%%%.......%.%%%..%..%%%%.....%%%%..%%%%%%%%%%%..%%%%%......%%%%......%%..%......%%%%.
m ..............%%%%.......................%%%%...................%%%%%...................................%%%%.................%%%................%%%%..
m ...............%%%.......................%%%%....................%%%%....................................%%%%................%%%................%%%%..
m ..............%%%%%.....................%%%%%......%.%.%%%%......%%%....................................%%%%%...............%%%%%...............%%%%..
m ..............%%%%.....................%%%%%%.......%%%%%%%......%%%....................................%%%%.................%%%.................%%%%.
m ..............%%%%%....................%%%%%%%......%%%%%%%......%%%....................................%%%%................%%%%%...............%%%%%.
m ....%%%.%......%%%%%%.....%.%.....%.%..%%%%%%......%%%%%%%%.....%%%%%.%.%%......%%..%%.%.%%%%%%..%......%%%%.......%..%..%%%%%%%%%%..%%%%........%%%%.
m ....%%%%%......%%%%%%%%%%%%%.......%....%%..%......%%%%%%%.......%%%%%%%%%%%%%%%%%%%%%%%%%%%%%%%%%......%%%%......%%%%%%%%%%%%%%%%%%%%%%%%......%%%%%.
m .....%%%%.....%%%%%%%%%%%%%%.......%...............%%%%%%%%......%%%%%%%%%%%%%%%%%%%%%%%%%%%%%%%%%%.....%%%%%......%%%%%%%%%%%%%%%%%%%%%%%%.....%%%%%.
m ....%%%%%......%%%%%%%%%%%%%......%%...............%%%%%%%.......%%%%%%%%%%%%%%%%%%%%%%%%%%%%%%%%%%......%%%%.....%%%%%%%%%%%%%%%%%%%%%%%%......%%%%%.
m .....%%%%.....%.....%.%.%%%%......%................%%%%%..%.....%..%%.%%%%%%%%%%%%.%%%...%%.%%%%%%%......%%%......%.%%%%%%..%%.%...%.%...%%......%%%..
m ....%%%%.................%%%%.............................................%%%%%................%%%......%%%%....................................%%%%%.
m .....%%%%................%%%%.............................................%%%%................%%%%.......%%%%....................................%%%%.
m .....%%%%................%%%..............%...%%%..........................%%%.................%%%......%%%%....................................%%%%..
m .....%%%%...............%%%%..............%%%%%%%..........................%%%................%%%%......%%%%....................................%%%%..
m ....%%%%%................%%%%............%%%%%%%%.........................%%%%%................%%%.......%%%%...................................%%%%..
m .....%%%......%..%%......%%%%.....%%......%%%%%%........%.....%%%.%%%......%%%......%%.%%......%%%%......%%%%.%%%.%.%..%%..%%.%...%%..%..%...%.%%%%%%.
m .....%%%%.....%%%%%.....%%%%%......%.....%%%%%%%......%%%%%%%%%%%%%%%.....%%%%%.....%%%%......%%%%%......%%%%%%%%%%%%%%%%%%%%%%%%%%%%%%%%%%%%%%%%%%%..
m .....%%%......%%%%%.....%%%%%.....%%.....%%%%%%%.......%%%%%%%%%%%%%......%%%%%.....%%%%.......%%%%.....%%%%%%%%%%%%%%%%%%%%%%%%%%%%%%%%%%%%%%%%%%%%..
m .....%%%%......%%%%.....%%%%......%%.....%%%%%%%%......%%%%%%%%%%%%%......%%%%......%%%%.......%%%%......%%%%%%%%%%%%%%%%%%%%%%%%%%%%%%%%%%%%%%%%%%%%.
m .....%%%......%%%%%.....%...%............%%%%.%.......%%%%%%%...%%.%......%%%%%......%%%.......%..%......%%%%..%.%%%%%..%%.%%%%%%%.%%..%...%%..%%..%..
m .....%%%.......%%%%...................................%%%%%...............%%%%.......%%%%...............%%%%.................%%%%..........0..........
m ....%%%%%.....%%%%%....................................%%%.................%%%%......%%%%...............%%%%%...............%%%%%.....................
m ....%%%%%.....%%%%.........................................................%%%......%%%%%...............%%%%%................%%%......................
m ....%%%%.......%%%%........................................................%%%.......%%%................%%%%.................%%%......................
m .....%%%%......%%%.....................................%...................%%%.......%%%%................%%%.................%%%%.....................
m .....%%%.......%%%%......%%.%.%%..%%......%%%%......%%%.......%%%%%%%%....%%%%%......%%%%..%%%%%..%%...%%%%%......%%.%%......%%%......%%.%%..%..%..%%.
m .....%%%%.....%%%%......%%%%%%%%%%%%......%%.%.....%%..%........%%%%%%%%%%%%%%.......%%%%%%%%%%%%%%%%%%%%%%%%......%%%.......%%%.......%%%%%%%%%%%%%%.
m .....%%%%.....%%%%%.....%%.....%%%%....................................%%%%%%%.......%%%%%%%%%%%%%%%%%%%%%%%......%%%%%1.....%%%%.....%%%%%%%%%%%%%%..
m ....%%%%%.....%%%%......%%.....%%%%....................................%%%%%%%.......%%%%%%%%%%%%%%%%%%%%%%%%......%%%.......%%%%.....%%%%%%%%%%%%%%..
m .......%%......%%%%.....%%......%%%%...................................%%%%%%%........%.%..%...%%%%....%%%%%%.....%%%%.......%%%%.....%.......%.%%%%..
m ...............%%%................%%...................................%%%%%%%%.........................%%%%......%%%%%.....%%%%%................%%%..
m ...............%%%%...............%....................................%%%%%%%%.........................%%%%.......%%%.......%%%.................%%%%.
m ...............%%%%...............%%.....%.%%%%..%%....%.....%%%%......%%%%%%%..........................%%%%%......%%%.......%%%%...............%%%%..
m ...............%%%................%.......%%%%%%%%%%%%%......%%%%......%%%%%%%%..........................%%%.......%%%%.....%%%%................%%%%%.
m ...............%%%................%%......%%%%%%%%%%%%%%......%%%%......%%%%%%%..........................%%%%.....%%%%%.....%%%%%...............%%%%%.
m %%...%.%......%%%%.............%%%%%......%%%%%%%%%%%%%.......%%%%.....%%%%%%%%%.%%%%%.%.%%%...%%%%.....%%%%%%%%..%%%%.......%%%%.%..%....%.....%%%%%%
m %%%%%%%%.......%%%%.....%......%%%%......%%%%..%...%%%%......%...%......%...%%%%%%%%%%%%%%%%%%%%%%%......%%%%%%%%%%%%%%.....%%%%%%%%%%%%%%%.....%%%%%%
m %%%%%%%%.......%....................................%%%..........................%%%%%%%%%%%%%%%%%%.....%%%%%%%%%%%%%%.......%%%%%%%%%%%%%......%%%%%%
m %%%%%%%%%.....%%...................................%%%%..........................%%%%%%%%%%%%%%%%%%......%%%%%%%%%%%%%%......%%%%%%%%%%%%%%.....%%%%%%
m %%%...%.%.....%%....................................%%%..........................%%%%%%%%..%%%.%%.......%.%.....%.%%%%.......%..%.%%%.%%%%%.....%.%.%.
m ...............%...................................%%%%%.........................%%%%%%%%..........................%%%%................%%%............
m ...............%....................................%%%%.........................%%%%%%%%.........................%%%%%...............%%%%............
m ..............%%%.......%...%%.%.%.%.%.%%%%%%%......%%%%%.%....%.......%.%..%%%..%%%%%%%%..........................%%%%...............%%%%%...........
m ..............%%%%......%%%%%%%%%%%%%%%%%%%%%%......%%%%%%%%%%%%%......%%%%%%%%%%%%%%%%%..........................%%%%................%%%%%...........
m ..............%%%%%.....%%%%%%%%%%%%%%%%%%%%%.......%%%%%%%%%%%%%%......%%%%%%%%%%%%%%%%%.........................%%%%.................%%%%...........
m %.%%%%..%.....%%%%%%%%%%%%%%%%%%%%%%%%%%%%%%%.......%%%%%%%%%%%%%%.....%%%%%%%%%%%%%%%%%%%%...%%%.%%.%%%%..........%%%%......%%%.%%%..%%%%%%%%..%%....
m %%%%%%%%.......%%%%..%%..%......%%%...%%.%.%%%.....%.%..%%%.%%%%%%.........%%%%.%%....%%%%%%%%%%%%%%%%%%%%%%%.....%%%%%.....%%%%%%%%%%%%%%%%%%%%%%%%%%
m %%%%%%.......................................................%%%%%.........................%%%%%%%%%%%%%%%%%%.....%%%%%.....%%%%%%%%%%%%%%%%%%%%%%%%%%
m %%%%%%.......................................................%%%%%.........................%%%%%%%%%%%%%%%%%%.....1%%%.......%%%%%%%%%%%%%%%%%%%%%%%%%
m %%...%.......................................................%%%%%.........................%%%%%%%%%%....%.........%%%%......%.%%%....%.%....%%%%%%%%.
m ..............................................................%%%..........................%%%%%%%.................%%%..........................%%%%%.
m ..............................................................%%%..........................%%%%%%%%................%%%...........................%%%..
m ...............%.....%%........%%%%.%.%%..%.%.%%%%.%%%%%.....%%%%%%..%%.%%.%.....%.%%.......%%%%%%%................%%%%..........................%%%%.
m ..............%.......%%%%.....%%%%%%%%%%%%%%%%%%%%%%%%......%%%%%%%%%%%%%%.......%%%......%%%%%%%................%%%%...........................%%%%.
m ..............%......%%%%.......%%%%%%%%%%%%%%%%%%%%%%%%.....%%%%%%%%%%%%%%......%%%%.......%%%%%%%................%%%..........................%%%%..
m ....%%.....%%%%%......%%%%......%%%%%%%%%%%%%%%%%%%%%%%%.....%%%%%%%%%%%%%%......%%%%%......%%%%%%%%%.%............%%%%%..%..%%.%.....%%.%%......%%%..
m .....%......%%%%......%%%.......%....%%%......%...%.%.%%.....%..%%.%...%%%%%......%%%.........%%%%%%%%%%%%%%.......%%%%%%%%%%%%%%.....%%%%.......%%%%.
m ............%%%%......%%%...............................................%%%%.....%%%%%...............%%%%%%%......%%%%%%%%%%%%%%.......%%%.......%....
m ............%%%%.....%%%%..............................................%%%%.......%%%................%%%%%%%......%%%%%%%%%%%%%%.......%%%.......%....
m ...........%%%%......%%%%%..............................................%%%%.....%%%%%...............%%%%%%%.........%...%%%..%%%.....%%%%.......%....
m ...........%%%%%.....%%%%%..............................................%%%......%%%%................%%%%%%%...........................%%%............
m ............%%%.......%%%%.............................................%%%%......%%%%%...............%%%%%%%%..........................%%%%...........
m ....%..%%.%%%%%......%%%%%%%.%....%%......%..%...%%.%%%%%%...%..%%......%%%%.....%%%%%...%%%.%%......%%%%%%%..........................%%%%............
m ....%%%%%%%%%%%.......%%%%%%%%%%%%%%.....%%%%%%%%%%%%%%%%%%%%%%%%......%%%%.......%%%%%%%%%%%%%%.....%%%%%%%%..........................%%%%...........
m ....%%%%%%%%%%%......%%%%%%%%%%%%%%.......%%%%%%%%%%%%%%%%%%%%%%%%.....%%%%......%%%%%%%%%%%%%%%......%%%%%%%.........................%%%%%...........
m .%%%%%%%%%%%%%%%......%%%%%%%%%%%%%.......%%%%%%%%%%%%%%%%%%%%%%%%.....%%%%%.....%%%%%%%%%%%%%%%.....%%%%%%%%%.%....%.....%%%.%..%..%%%%%%.......%....
m ......%...%%%%%%.....%%%%%%%%..%%%%%.....%%%%%%%%.%.%%%.%.%%%.%%%......%%%%%......%%%%..%%%%%%%%.....%%.%%%%%%%%%%%%%%%%%%%%%%%%%%%%%%%%%%%.....%.....
m ...........%%%%.................%%%......%%%%%.........................%%%%......%%%%......%%%%..........................%%%%.........................
m ...........%%%%................%%%%.......%%%..........................%%%%......%%%%%.....%%%%...........................%%%%........................
m ...........%%%%%................%%%%......%%%%..........................%%%......%%%%%.....%%%%...........................%%%.........................
m ............%%%%................%%%......%%%%...........................%%%%.....%%%%.......%%%...........................%%%.........................
m ............%%%%................%%%.....1%%%%...........................%%%%.....%%%%%.....%%%%..........................%%%%.........................
m .....%......%%%%%%%..%%.%%......%%%%......%%%......%.%.......%%%%%...%%%%%%%.....%%%%%.....%%%%%%...%%%%%%.......%...%%%%%%%%%......%.%.%%%.....%.%%.%
m %%%%%%......%%%%%%%%%%%%%.......%%%%......%%%%.....%%%%.......%%%%%%%%%%%%%.......%%%%......%%%%%%%%%%%%%%......%%%%%%%%%%%%%%......%%%%%%%.....%%%%%%
m %%%%%......%%%%%%%%%%%%%%.......%%%.......%%%.......%%%%......%%%%%%%%%%%%%......%%%%.......%%%%%%%%%%%%%.......%%%%%%%%%%%%%%.....%%%%%%%%.....%%%%%%
m %%%%%%......%%%%%%%%%%%%%.......%%%%.....%%%%.......%%%%.....%%%%%%%%%%%%%%......%%%%.......%%%%%%%%%%%%%%.....%%%%%%%%%%%%%%%......%%%%%%......%%%%%%
m .%..%%.....%%%%%.%%%.%%%%......%%%.%......%%%%......%%%%.....%%%.%.....%%.%......%%%%%.....%%%.%...%%%%%%.......%.%...%.%.%%........%%%%%%%.....%%%.%.
m ............%%%.......%%%%................%%%......%%%%%..............................................%%%%.........................%%%%%%%......%%....
m ............%%%......%%%%................%%%%.......%%%..............................................%%%%%.........................%%%%%%%%.....%%....
m ............%%%%.....%%%%................%%%%%.....%%%%...............................................%%%%.........................%%%..%.......%.....
m ............%%%%.....%%%%%................%%%%......%%%%.............................................%%%%%......................................%.....
m ...........%%%%%......%%%................%%%%.......%%%%..............................................%%%.......................................%%....
m .%..%%.....%%%%......%%%%%%.%.%%%%..%..%%%%%%.......%%%%%.%...%.%%..%%..%..%.....%.%.%......%..%..%%.%%%%%%...%%....%%..%%%%..%%%...............%.....
m .%%%%......%%%%%......%%%%%%%%%%%%%%%%%%%%%%%......%%%%%%%%%%%%%%%%%%%%%%%%.......%%%%......%%%%%%%%%%%%%%%%%%%%%%%%%%%%%%%%%%%%%...............%.....
m .%%%%%......%%%%......%%%%%%%%%%%%%%%%%%%%%%%%......%%%%%%%%%%%%%%%%%%%%%%%%.....%%%%%.....%%%%%%%%%%%%%%%%%%%%%%%%%%%%%%%%%%%%%%...............%%....
m ..%%%%.....%%%%%.....%%%%%%%%%%%%%%%%%%%%%%%%......%%%%%%%%%%%%%%%%%%%%%%%%......%%%%%.....%%%%%%%%%%%%%%%%%%%%%%%%%%%%%%%%%%%%%.......%%%%...%.%.....
m ..%%%........%%.........%.%%..%........%.%%%%%.....%%%%%%.%..%......%%.%%%%......%%%%.........%%..%.%%%%..%.%%%%%%.%.%%.%%%%%%%%.......%%%%%%%%%%%....
m .%%%%....................................%%%%%......%%%%...............%%%%......%%%%....................................%%%%%%%%.....%%%%%%%%%%%%....
m .%%%%%....................................%%%.......%%%%................%%%......%%%%%...................................%%%%%%%%.....%%%%%%%%%%%%....
m .%%%%....................................%%%%......%%%%%...............%%%%......%%%%....................................%%%%%%%%......%%%%%...%%.....
m ..%%%....................................%%%%%.....%%%%.................%%%%......%%%.......................................%%%%%.....%%%%%.....%.....
m ..%%%%...........................0........%%%%.....%%%%.................%%%%......%%%........................................%%%.......%%%%.....%.....
m ..%%%%..%..%.%%%..%%%.%.%.%%..%..%.%......%%%......%%%%%.........%.....%%%%.......%%%%%%%.%...%%.%%.%..%.%......%..%%%%.....%%%%......%%%%%.....%.....
m .%%%%%%%%%%%%%%%%%%%%%%%%%%%%%%%%%%%.....%%%%......%%%%......%%%%......%%%%......%%%%%%%%%%%%%%%%%%%%%%%%......%%%%%%%%.....%%%%%......%%%%.....%.....
m ..%%%%%%%%%%%%%%%%%%%%%%%%%%%%%%%%%......%%%%%.....%%%%......%%%%%.....%%%%%......%%%%%%%%%%%%%%%%%%%%%%%.......%%%%%%%......%%%%......%%%......%%....
m ..%%%%%%%%%%%%%%%%%%%%%%%%%%%%%%%%%%.....%%%%.......%%%%.....%%%%%......%%%%.....%%%%%%%%%%%%%%%%%%%%%%%%%......%%%%%%%.....%%%%.......%%%......%.....
m ..%%...%....0%%.%%.%.%%%%%%...%%.%.%.....%%%%%.....%%.%......%%%%.......%%%%.........%.%..%%.%%.%%...%%%%.......%%%%%%.......%%%......%%%%......%.....
m ......................%%%................%%%%................%%%%%.....%%%%....................................%%%%%%%......%%%%.......%%%%.....%.....
m .....................%%%%.................%%%%................%%%.......%%%%...................................%%%%%%%%.....%%%%......%%%%......%.....
m ......................%%%%...............%%%%%................%%%%......%%%....................................%%%...%......%%%%%......%........%%....
m ......................%%%%................%%%%...............%%%%......%%%%%................................................%%%%%...............%.....
m ......................%%%%................%%%................%%%%......%%%%%................................................%%%%................%%....
m ............%%%.......%%%%%.%..%%.%...%%.%%%%%%..%..%%....%%.%%%%%......%%%%..%%%..%...%.%%...%......%.%%.%%%...............%%%%................%%%%.%
m %%%%%.......%%%.......%%%%%%%%%%%%%%%%%%%%%%%%%%%%%%%%%%%%%%%%%%%.......%%%%%%%%%%%%%%%%%%%%%%%%.....%%%%%%%%................%%%................%%%%%%
m %%%%%.......%%%......%%%%%%%%%%%%%%%%%%%%%%%%%%%%%%%%%%%%%%%%%%%%......%%%%%%%%%%%%%%%%%%%%%%%%.......%%%%%%%...............%%%%%...............%%%%%%
m %%%%%......%%%%.......%%%%%%%%%%%%%%%%%%%%%%%%%%%%%%%%%%%%%%%%%%%%......%%%%%%%%%%%%%%%%%%%%%%%%......%%%%%%.......%..%......%%%%.%%%%.%.%%.....%%%%%%
m %%%%%.......%%%%.....%.%.%..%%%%%%%%.%%%%..%...%%.%..%%%%%%.%%%%%%......%%%.%.%%%%%%%%.%%%%..%%......%%%%%%%%.....%%%%.......%%%%%%%%%%%%%%.....%%%%%%
m %%%%%.......%%%%...............%%%%%.........................%%%%................%%%%................%%%%%%%%.....%%%%%.....%%%%%%%%%%%%%%%......%%%%%
m %%%%%%......%%%%................%%%..........................%%%%.................%%%................%%%%%%%......%%%%......%%%%%%%%%%%%%%%.....%%%%%%
m %%%%%.......%%%%................%%%..........................%%%%.................%%%%...............%%%%..%%.....%%%%......%%%%%.%.%.%%%%%.....%%.%%%
m ....%%.....%%%%.................%%%..........................%%%%%...............%%%%..............................%%%%.....%%%%......%%%%%...........
