# map type: blank
# random seed: 235525264
# hill distance  16, 81  16, 16  17,102  68,102  69, 16  69, 81  17,139  68,139
#        16, 81       0      95      22     103     146      99      81     126 
#        16, 16      95       0      81     126      99     146      22     103 
#        17,102      22      81       0      83     126     103      61     106 
#        68,102     103     126      83       0      81      22     106      61 
#        69, 16     146      99     126      81       0      95     103      22 
#        69, 81      99     146     103      22      95       0     126      81 
#        17,139      81      22      61     106     103     126       0      83 
#        68,139     126     103     106      61      22      81      83       0 
players 4
rows 120
cols 144
m ..........................%%%%........%%%%..............%%%%........%%%%........................................................................
m .........................%%%%%.......%%%%%%............%%%%%%.......%%%%%.......................................................................
m ..........................%%%%.......%%%%%%............%%%%%%.......%%%%........................................................................
m ..........................%%%%%......%%%%%%............%%%%%%......%%%%%........................................................................
m .........................%%%%%.......%%%%%..............%%%%%.......%%%%%.......................................................................
m .........................%%%%%.......%%%%%..............%%%%%.......%%%%%.......................................................................
m .%%%..%%%..%%%..%........%%%%%.......%%%%%%..%..%%..%..%%%%%%.......%%%%%........%..%%%..%%%..%%%......%%..%%.........%%%%%%.........%%..%%.....
m .%%%%%%%%%%%%%%%%%%......%%%%%.......%%%%%%%%%%%%%%%%%%%%%%%%.......%%%%%......%%%%%%%%%%%%%%%%%%.......%%%%%.......%%%%%%%%%%.......%%%%%......
m .%%%%%%%%%%%%%%%%%........%%%%%.......%%%%%%%%%%%%%%%%%%%%%%.......%%%%%........%%%%%%%%%%%%%%%%%.......%%%%%.......%%%%%%%%%%.......%%%%%......
m ..%%%%%%%%%%%%%%%%%.......%%%%.......%%%%%%%%%%%%%%%%%%%%%%%%.......%%%%.......%%%%%%%%%%%%%%%%%.......%%%%%%......%%%%%%%%%%%%......%%%%%%.....
m .%%%%%%%%%%%%%%%%%%......%%%%%%......%%%%%%%%%%%%%%%%%%%%%%%%......%%%%%%......%%%%%%%%%%%%%%%%%%.......%%%%........%%%%%%%%%%........%%%%......
m .%%.%.%..%%%%....%........%%%%%.......%.%..%%.%.%%.%.%%..%.%.......%%%%%........%....%%%%..%.%.%%......%%%%%........%...%%...%........%%%%%.....
m ..........................%%%%......................................%%%%................................%%%%%........................%%%%%......
m ..........................%%%%......................................%%%%................................%%%%..........................%%%%......
m .........................%%%%%......................................%%%%%..............................%%%%%%........................%%%%%%.....
m ..........................%%%%%....................................%%%%%................................%%%%..........................%%%%......
m ................1........%%%%%%....................................%%%%%%........0......................%%%%..........................%%%%......
m ..........................%%%%%....................................%%%%%..............................3%%%%%%........................%%%%%%2....
m .%.%...........%%.........%%%%.......%.%..................%.%.......%%%%.........%%...........%.%.......%%%%%......%%%.%..%.%%%......%%%%%......
m ..%%%%%.......%%%%........%%%%.......%%%%%%............%%%%%%.......%%%%........%%%%.......%%%%%........%%%%%......%%%%%%%%%%%%......%%%%%......
m ..%%%%%......%%%%%.......%%%%%%.......%%%%..............%%%%.......%%%%%%.......%%%%%......%%%%%........%%%%%......%%%%%%%%%%%%......%%%%%......
m .%%%%%%......%%%%%.......%%%%%........%%%%%............%%%%%........%%%%%.......%%%%%......%%%%%%.......%%%%%......%%%%%%%%%%%%......%%%%%......
m ..%%%%%.......%%%%........%%%%%.......%%%%%............%%%%%.......%%%%%........%%%%.......%%%%%.......%%%%%%......%%%%%%%%%%%%......%%%%%%.....
m .%%%%%.......%%%%%........%.%.%......%%%%%..............%%%%%......%.%.%........%%%%%.......%%%%%.......%.%.........%%%%%%%%%%.........%.%......
m .%%%%%........%%%%...................%%%%%%............%%%%%%...................%%%%........%%%%%...................%%%%%%%%%%..................
m .%%%%%.......%%%%%....................%%%%..............%%%%....................%%%%%.......%%%%%...................%%%%%%%%%%..................
m .%%%%%........%%%%%..................%%%%%%............%%%%%%..................%%%%%........%%%%%..................%%%%%%%%%%%%.................
m ..%%%%........%%%%...................%%%%%%............%%%%%%...................%%%%........%%%%....................%%%%%%%%%%..................
m .%%%%%%......%%%%%%..................%%%%%..............%%%%%..................%%%%%%......%%%%%%...................%%%%%%%%%%..................
m ..%%%%%......%%%%%....................%%%%..............%%%%....................%%%%%......%%%%%...................%%%%%%%%%%%%.................
m ..%%%%........%%%%%.........%..%%%.%%%%%%%..............%%%%%%%.%%%..%.........%%%%%........%%%%.......%.%%%%......%%%%%%%%%%%%......%%%%.%.....
m ..%%%%%......%%%%%.......%%%%%%%%%%%%%%%%%..............%%%%%%%%%%%%%%%%%.......%%%%%......%%%%%........%%%%%.......%%%%%%%%%%.......%%%%%......
m .%%%%%.......%%%%%.......%%%%%%%%%%%%%%%%%%............%%%%%%%%%%%%%%%%%%.......%%%%%.......%%%%%.......%%%%%.......%%%%%%%%%%.......%%%%%......
m ..%%%%%......%%%%%%.......%%%%%%%%%%%%%%%%..............%%%%%%%%%%%%%%%%.......%%%%%%......%%%%%........%%%%........%%%%%%%%%%........%%%%......
m ..%%%%.......%%%%%........%%%%%%%%%%%%%%%%..............%%%%%%%%%%%%%%%%........%%%%%.......%%%%........%%%%........%%%%%%%%%%........%%%%......
m .%%..%........%.%.%.........%.%%...%..%.%%..............%%.%..%...%%.%.........%.%.%........%..%%.......%%..%.......%.%%..%%.%.......%..%%......
m ................................................................................................................................................
m ................................................................................................................................................
m ................................................................................................................................................
m ................................................................................................................................................
m ................................................................................................................................................
m ................................................................................................................................................
m %%%%%%%%%%%%%%%%%%%%%%%%%%%%%%%%%%%%%%%%%%%%%%%%%%%%%%%%%%%%%%%%%%%%%%%%%%%%%%%%%%%%%%%%%%%%%%%%%%%%%%%%%%%%%%%%%%%%%%%%%%%%%%%%%%%%%%%%%%%%%%%%
m %%%%%%%%%%%%%%%%%%%%%%%%%%%%%%%%%%%%%%%%%%%%%%%%%%%%%%%%%%%%%%%%%%%%%%%%%%%%%%%%%%%%%%%%%%%%%%%%%%%%%%%%%%%%%%%%%%%%%%%%%%%%%%%%%%%%%%%%%%%%%%%%
m ................................................................................................................................................
m ................................................................................................................................................
m ................................................................................................................................................
m ................................................................................................................................................
m ................................................................................................................................................
m ................................................................................................................................................
m .%%..%........%.%.%.........%.%%...%..%.%%..............%%.%..%...%%.%.........%.%.%........%..%%.......%%..%.......%.%%..%%.%.......%..%%......
m ..%%%%.......%%%%%........%%%%%%%%%%%%%%%%..............%%%%%%%%%%%%%%%%........%%%%%.......%%%%........%%%%........%%%%%%%%%%........%%%%......
m ..%%%%%......%%%%%%.......%%%%%%%%%%%%%%%%..............%%%%%%%%%%%%%%%%.......%%%%%%......%%%%%........%%%%........%%%%%%%%%%........%%%%......
m .%%%%%.......%%%%%.......%%%%%%%%%%%%%%%%%%............%%%%%%%%%%%%%%%%%%.......%%%%%.......%%%%%.......%%%%%.......%%%%%%%%%%.......%%%%%......
m ..%%%%%......%%%%%.......%%%%%%%%%%%%%%%%%..............%%%%%%%%%%%%%%%%%.......%%%%%......%%%%%........%%%%%.......%%%%%%%%%%.......%%%%%......
m ..%%%%........%%%%%.........%..%%%.%%%%%%%..............%%%%%%%.%%%..%.........%%%%%........%%%%.......%.%%%%......%%%%%%%%%%%%......%%%%.%.....
m ..%%%%%......%%%%%....................%%%%..............%%%%....................%%%%%......%%%%%...................%%%%%%%%%%%%.................
m .%%%%%%......%%%%%%..................%%%%%..............%%%%%..................%%%%%%......%%%%%%...................%%%%%%%%%%..................
m ..%%%%........%%%%...................%%%%%%............%%%%%%...................%%%%........%%%%....................%%%%%%%%%%..................
m .%%%%%........%%%%%..................%%%%%%............%%%%%%..................%%%%%........%%%%%..................%%%%%%%%%%%%.................
m .%%%%%.......%%%%%....................%%%%..............%%%%....................%%%%%.......%%%%%...................%%%%%%%%%%..................
m .%%%%%........%%%%...................%%%%%%............%%%%%%...................%%%%........%%%%%...................%%%%%%%%%%..................
m .%%%%%.......%%%%%........%.%.%......%%%%%..............%%%%%......%.%.%........%%%%%.......%%%%%.......%.%.........%%%%%%%%%%.........%.%......
m ..%%%%%.......%%%%........%%%%%.......%%%%%............%%%%%.......%%%%%........%%%%.......%%%%%.......%%%%%%......%%%%%%%%%%%%......%%%%%%.....
m .%%%%%%......%%%%%.......%%%%%........%%%%%............%%%%%........%%%%%.......%%%%%......%%%%%%.......%%%%%......%%%%%%%%%%%%......%%%%%......
m ..%%%%%......%%%%%.......%%%%%%.......%%%%..............%%%%.......%%%%%%.......%%%%%......%%%%%........%%%%%......%%%%%%%%%%%%......%%%%%......
m ..%%%%%.......%%%%........%%%%.......%%%%%%............%%%%%%.......%%%%........%%%%.......%%%%%........%%%%%......%%%%%%%%%%%%......%%%%%......
m .%.%...........%%.........%%%%.......%.%..................%.%.......%%%%.........%%...........%.%.......%%%%%......%%%.%..%.%%%......%%%%%......
m ..........................%%%%%....................................%%%%%..............................1%%%%%%........................%%%%%%0....
m ................3........%%%%%%....................................%%%%%%........2......................%%%%..........................%%%%......
m ..........................%%%%%....................................%%%%%................................%%%%..........................%%%%......
m .........................%%%%%......................................%%%%%..............................%%%%%%........................%%%%%%.....
m ..........................%%%%......................................%%%%................................%%%%..........................%%%%......
m ..........................%%%%......................................%%%%................................%%%%%........................%%%%%......
m .%%.%.%..%%%%....%........%%%%%.......%.%..%%.%.%%.%.%%..%.%.......%%%%%........%....%%%%..%.%.%%......%%%%%........%...%%...%........%%%%%.....
m .%%%%%%%%%%%%%%%%%%......%%%%%%......%%%%%%%%%%%%%%%%%%%%%%%%......%%%%%%......%%%%%%%%%%%%%%%%%%.......%%%%........%%%%%%%%%%........%%%%......
m ..%%%%%%%%%%%%%%%%%.......%%%%.......%%%%%%%%%%%%%%%%%%%%%%%%.......%%%%.......%%%%%%%%%%%%%%%%%.......%%%%%%......%%%%%%%%%%%%......%%%%%%.....
m .%%%%%%%%%%%%%%%%%........%%%%%.......%%%%%%%%%%%%%%%%%%%%%%.......%%%%%........%%%%%%%%%%%%%%%%%.......%%%%%.......%%%%%%%%%%.......%%%%%......
m .%%%%%%%%%%%%%%%%%%......%%%%%.......%%%%%%%%%%%%%%%%%%%%%%%%.......%%%%%......%%%%%%%%%%%%%%%%%%.......%%%%%.......%%%%%%%%%%.......%%%%%......
m .%%%..%%%..%%%..%........%%%%%.......%%%%%%..%..%%..%..%%%%%%.......%%%%%........%..%%%..%%%..%%%......%%..%%.........%%%%%%.........%%..%%.....
m .........................%%%%%.......%%%%%..............%%%%%.......%%%%%.......................................................................
m .........................%%%%%.......%%%%%..............%%%%%.......%%%%%.......................................................................
m ..........................%%%%%......%%%%%%............%%%%%%......%%%%%........................................................................
m ..........................%%%%.......%%%%%%............%%%%%%.......%%%%........................................................................
m .........................%%%%%.......%%%%%%............%%%%%%.......%%%%%.......................................................................
m ..........................%%%%........%%%%..............%%%%........%%%%........................................................................
m ..%.%%%.......%%....%..%.%%%%%%.......%%%%..............%%%%.......%%%%%%.%..%....%%.......%%%.%.......%.%%.%......%..%.%%.%..%......%.%%.%.....
m ..%%%%%.......%%%%%%%%%%%%%%%%%......%%%%%..............%%%%%......%%%%%%%%%%%%%%%%%.......%%%%%.......%%%%%%.......%%%%%%%%%%.......%%%%%%.....
m .%%%%%%......%%%%%%%%%%%%%%%%%%.......%%%%..............%%%%.......%%%%%%%%%%%%%%%%%%......%%%%%%......%%%%%%......%%%%%%%%%%%%......%%%%%%.....
m ..%%%%%.......%%%%%%%%%%%%%%%%........%%%%..............%%%%........%%%%%%%%%%%%%%%%.......%%%%%.......%%%%%%.......%%%%%%%%%%.......%%%%%%.....
m ..%%%%%......%%%%%%%%%%%%%%%%%%......%%%%%%............%%%%%%......%%%%%%%%%%%%%%%%%%......%%%%%........%%%%.......%%%%%%%%%%%%.......%%%%......
m ..%%%%.......%%.%%..%..%%.%%..%.......%.%%..............%%.%.......%..%%.%%..%..%%.%%.......%%%%........%.%%.......%%%%%%%%%%%%.......%%.%......
m .%%%%%%....................................................................................%%%%%%..................%%%%%%%%%%%%.................
m ..%%%%......................................................................................%%%%...................%%%%%%%%%%%%.................
m ..%%%%......................................................................................%%%%...................%%%%%%%%%%%%.................
m ..%%%%%....................................................................................%%%%%....................%%%%%%%%%%..................
m ..%%%%......................................................................................%%%%...................%%%%%%%%%%%%.................
m .%%%%%%....................................................................................%%%%%%..................%%%%%%%%%%%%.................
m %%%%%%%.%...%.%.%%.......%.%%%%%%.%.%.%%%.%............%.%%%.%.%.%%%%%%.%.......%%.%.%...%.%%%%%%%%..%%%.%%%.......%%%%%%%%%%%%.......%%%.%%%..%
m %%%%%%%%%%%%%%%%%%........%%%%%%%%%%%%%%%%%............%%%%%%%%%%%%%%%%%........%%%%%%%%%%%%%%%%%%%%%%%%%%%%%......%%%%%%%%%%%%......%%%%%%%%%%%
m %%%%%%%%%%%%%%%%%%........%%%%%%%%%%%%%%%%%............%%%%%%%%%%%%%%%%%........%%%%%%%%%%%%%%%%%%%%%%%%%%%%%......%%%%%%%%%%%%......%%%%%%%%%%%
m %%%%%%%%%%%%%%%%%%........%%%%%%%%%%%%%%%%..............%%%%%%%%%%%%%%%%........%%%%%%%%%%%%%%%%%%%%%%%%%%%%%......%%%%%%%%%%%%......%%%%%%%%%%%
m %%%%%%%%%%%%%%%%%%........%%%%%%%%%%%%%%%%..............%%%%%%%%%%%%%%%%........%%%%%%%%%%%%%%%%%%%%%%%%%%%%........%%%%%%%%%%........%%%%%%%%%%
m %%%%%%%%%%%%%%%%%%........%%%%%%%%%%%%%%%%..............%%%%%%%%%%%%%%%%........%%%%%%%%%%%%%%%%%%%%%%%%%%%%........%%%%%%%%%%........%%%%%%%%%%
m %%%%%%%%%%%%%%%%%%........%%%%%%%%%%%%%%%%..............%%%%%%%%%%%%%%%%........%%%%%%%%%%%%%%%%%%%%%%%%%%%%%......%%%%%%%%%%%%......%%%%%%%%%%%
m %%%%%%%%%%%%%%%%%%........%%%%%%%%%%%%%%%%%............%%%%%%%%%%%%%%%%%........%%%%%%%%%%%%%%%%%%%%%%%%%%%%%......%%%%%%%%%%%%......%%%%%%%%%%%
m %%%%%%%%%%%%%%%%%%........%%%%%%%%%%%%%%%%%............%%%%%%%%%%%%%%%%%........%%%%%%%%%%%%%%%%%%%%%%%%%%%%%......%%%%%%%%%%%%......%%%%%%%%%%%
m %%%%%%%.%...%.%.%%.......%.%%%%%%.%.%.%%%.%............%.%%%.%.%.%%%%%%.%.......%%.%.%...%.%%%%%%%%..%%%.%%%.......%%%%%%%%%%%%.......%%%.%%%..%
m .%%%%%%....................................................................................%%%%%%..................%%%%%%%%%%%%.................
m ..%%%%......................................................................................%%%%...................%%%%%%%%%%%%.................
m ..%%%%%....................................................................................%%%%%....................%%%%%%%%%%..................
m ..%%%%......................................................................................%%%%...................%%%%%%%%%%%%.................
m ..%%%%......................................................................................%%%%...................%%%%%%%%%%%%.................
m .%%%%%%....................................................................................%%%%%%..................%%%%%%%%%%%%.................
m ..%%%%.......%%.%%..%..%%.%%..%.......%.%%..............%%.%.......%..%%.%%..%..%%.%%.......%%%%........%.%%.......%%%%%%%%%%%%.......%%.%......
m ..%%%%%......%%%%%%%%%%%%%%%%%%......%%%%%%............%%%%%%......%%%%%%%%%%%%%%%%%%......%%%%%........%%%%.......%%%%%%%%%%%%.......%%%%......
m ..%%%%%.......%%%%%%%%%%%%%%%%........%%%%..............%%%%........%%%%%%%%%%%%%%%%.......%%%%%.......%%%%%%.......%%%%%%%%%%.......%%%%%%.....
m .%%%%%%......%%%%%%%%%%%%%%%%%%.......%%%%..............%%%%.......%%%%%%%%%%%%%%%%%%......%%%%%%......%%%%%%......%%%%%%%%%%%%......%%%%%%.....
m ..%%%%%.......%%%%%%%%%%%%%%%%%......%%%%%..............%%%%%......%%%%%%%%%%%%%%%%%.......%%%%%.......%%%%%%.......%%%%%%%%%%.......%%%%%%.....
m ..%.%%%.......%%....%..%.%%%%%%.......%%%%..............%%%%.......%%%%%%.%..%....%%.......%%%.%.......%.%%.%......%..%.%%.%..%......%.%%.%.....
