# map type: blank
# random seed: 1419253484
# hill distance  88, 41  88, 62  25, 62  46, 83  67, 20  67, 83  46, 20  25, 41
#        88, 41       0      21      54      84      62      79      79      49 
#        88, 62      21       0      49      79      79      62      84      54 
#        25, 62      54      49       0      62      84      79      79      21 
#        46, 83      84      79      62       0      54      21      49      79 
#        67, 20      62      79      84      54       0      49      21      79 
#        67, 83      79      62      79      21      49       0      54      84 
#        46, 20      79      84      79      49      21      54       0      62 
#        25, 41      49      54      21      79      79      84      62       0 
players 8
rows 96
cols 96
m ................................................................................................
m .............................%..%..%..%.%%...%%%........%%%...%%.%..%..%..%.....................
m ........................%.....%%%%%%%%%%%%%%%%%%%......%%%%%%%%%%%%%%%%%%%.....%................
m ..............................%%%%%%%%%%%%%%%%%%........%%%%%%%%%%%%%%%%%%......................
m ........%.......%......%.....%%%%..%..%%%....%%.%......%.%%....%%%..%..%%%%.....%......%.......%
m .............................%%%%......................................%%%%.....................
m .............................%%%%......................................%%%%.....................
m ..............................%%........................................%%......................
m ...%%.........%%.............%%%%......................................%%%%.............%%......
m ...%%.........%%.............%%%%......................................%%%%.............%%......
m ..............................%%........................................%%......................
m .............................%%%%......................................%%%%.....................
m .............................%%%%......................................%%%%.....................
m ........%.......%......%.....%%%%..%..%%%....%%.%......%.%%....%%%..%..%%%%.....%......%.......%
m ..............................%%%%%%%%%%%%%%%%%%........%%%%%%%%%%%%%%%%%%......................
m ........................%.....%%%%%%%%%%%%%%%%%%%......%%%%%%%%%%%%%%%%%%%.....%................
m .............................%..%..%..%.%%...%%%........%%%...%%.%..%..%..%.....................
m ................................................................................................
m .............%..........%......................................................%..........%.....
m ...%%.........%%........%......................................................%........%%......
m ...%%.........%%........................................................................%%......
m ........%.......%.......%.%....%..%.%..%.....%%%%......%%%%.....%..%.%..%....%.%.......%.......%
m ........................%%%%%%%%%%%%%%%%%....%%%%......%%%%....%%%%%%%%%%%%%%%%%................
m ........................%%%%%%%%%%%%%%%%%....%%%........%%%....%%%%%%%%%%%%%%%%%................
m .................................%%.%%%%%.....%%........%%.....%%%%%.%%.........................
m .....................................%%%%0....................1%%%%.............................
m ......................................%%%......................%%%..............................
m .....................................%%%%......................%%%%.............................
m ........%............................%%%%......................%%%%............................%
m ..........%..%%.%%%.....%...%..%%.....%%%%%%.%..%......%..%.%%%%%%.....%%..%...%.....%%%.%%..%..
m .................%%......%%%%%%%.....%%%%%%%%%%%%......%%%%%%%%%%%%.....%%%%%%%......%%.........
m ................%%%......%%%%%%%.....%%%%%%%%%%%........%%%%%%%%%%%.....%%%%%%%......%%%........
m .................%%......%%%%%%%%.....%%%.%.%%.%........%.%%.%.%%%.....%%%%%%%%......%%.........
m .................%%.....%%%%%%%%%......................................%%%%%%%%%.....%%.........
m %%.%%.%%%..%.....%%......%%%%%%%%......................................%%%%%%%%......%%.....%..%
m %%%%%%%%%%%......%%......%%%%%%%........................................%%%%%%%......%%......%%%
m %%%%%%%%%%%.....%%%.....%%%%%%%%........................................%%%%%%%%.....%%%.....%%%
m %%.%%.%%%%%%.....%%.....%..%%%..%%%%%%%.%.....%%........%%.....%.%%%%%%%..%%%..%.....%%.....%%%%
m .........%%......%%%............%%%%%%%%%....%%%%......%%%%....%%%%%%%%%............%%%......%%.
m .........%%.....%%%%............%%%%%%%%%.....%%........%%.....%%%%%%%%%............%%%%.....%%.
m ........%%%%.....%%.............%%%%%%..%.....%.%......%.%.....%..%%%%%%.............%%.....%%%%
m .........%%.....%%%%............%%%%%..............................%%%%%............%%%%.....%%.
m .........%%......%%%%.%%.%%.....%%%%................................%%%%.....%%.%%.%%%%......%%.
m ........%%%%.....%%%%%%%%%%%....%%%..................................%%%....%%%%%%%%%%%.....%%%%
m ........%%%.....%%%%%%%%%%%%.....%%..................................%%.....%%%%%%%%%%%%.....%%%
m ........%%%%.....%%%%%%%%%%%....%%%%....%.%%.%%%%......%%%%.%%.%....%%%%....%%%%%%%%%%%.....%%%%
m .........%%%........4...%%%..............%%%%%%%%......%%%%%%%%..............%%%...7........%%%.
m .........%%.............%%%%............%%%%%%%%........%%%%%%%%............%%%%.............%%.
m .........%%.............%%%.............%%%%%..%%......%%..%%%%%.............%%%.............%%.
m .........%%..............%%%.............%%%%..............%%%%.............%%%..............%%.
m ........%%%%....%%%.....%%%%.....%......%%%..................%%%......%.....%%%%.....%%%....%%%%
m ........%%%%....%%%%.....%%.....%%%%....%%%..................%%%....%%%%.....%%.....%%%%....%%%%
m .........%%%....%%%%.....%%%....%%%.....%%%%................%%%%.....%%%....%%%.....%%%%....%%%.
m ........%.%.....%%......%%.......%.%....%%.%....%%%%%%%%....%.%%....%.%.......%%......%%.....%.%
m ................................................%%%%%%%%........................................
m ................................................%%%%%%%%........................................
m ................................................%%%%%%%%........................................
m ................................................%%%%%%%%........................................
m ................................................%%%%%%%%........................................
m ................................................%%%%%%%%........................................
m ........%.%.....%%......%%.......%.%....%%.%....%%%%%%%%....%.%%....%.%.......%%......%%.....%.%
m .........%%%....%%%%.....%%%....%%%.....%%%%................%%%%.....%%%....%%%.....%%%%....%%%.
m ........%%%%....%%%%.....%%.....%%%%....%%%..................%%%....%%%%.....%%.....%%%%....%%%%
m ........%%%%....%%%.....%%%%.....%......%%%..................%%%......%.....%%%%.....%%%....%%%%
m .........%%..............%%%.............%%%%..............%%%%.............%%%..............%%.
m .........%%.............%%%.............%%%%%..%%......%%..%%%%%.............%%%.............%%.
m .........%%.............%%%%............%%%%%%%%........%%%%%%%%............%%%%.............%%.
m .........%%%........6...%%%..............%%%%%%%%......%%%%%%%%..............%%%...5........%%%.
m ........%%%%.....%%%%%%%%%%%....%%%%....%.%%.%%%%......%%%%.%%.%....%%%%....%%%%%%%%%%%.....%%%%
m ........%%%.....%%%%%%%%%%%%.....%%..................................%%.....%%%%%%%%%%%%.....%%%
m ........%%%%.....%%%%%%%%%%%....%%%..................................%%%....%%%%%%%%%%%.....%%%%
m .........%%......%%%%.%%.%%.....%%%%................................%%%%.....%%.%%.%%%%......%%.
m .........%%.....%%%%............%%%%%..............................%%%%%............%%%%.....%%.
m ........%%%%.....%%.............%%%%%%..%.....%.%......%.%.....%..%%%%%%.............%%.....%%%%
m .........%%.....%%%%............%%%%%%%%%.....%%........%%.....%%%%%%%%%............%%%%.....%%.
m .........%%......%%%............%%%%%%%%%....%%%%......%%%%....%%%%%%%%%............%%%......%%.
m %%.%%.%%%%%%.....%%.....%..%%%..%%%%%%%.%.....%%........%%.....%.%%%%%%%..%%%..%.....%%.....%%%%
m %%%%%%%%%%%.....%%%.....%%%%%%%%........................................%%%%%%%%.....%%%.....%%%
m %%%%%%%%%%%......%%......%%%%%%%........................................%%%%%%%......%%......%%%
m %%.%%.%%%..%.....%%......%%%%%%%%......................................%%%%%%%%......%%.....%..%
m .................%%.....%%%%%%%%%......................................%%%%%%%%%.....%%.........
m .................%%......%%%%%%%%.....%%%.%.%%.%........%.%%.%.%%%.....%%%%%%%%......%%.........
m ................%%%......%%%%%%%.....%%%%%%%%%%%........%%%%%%%%%%%.....%%%%%%%......%%%........
m .................%%......%%%%%%%.....%%%%%%%%%%%%......%%%%%%%%%%%%.....%%%%%%%......%%.........
m ..........%..%%.%%%.....%...%..%%.....%%%%%%.%..%......%..%.%%%%%%.....%%..%...%.....%%%.%%..%..
m ........%............................%%%%......................%%%%............................%
m .....................................%%%%......................%%%%.............................
m ......................................%%%......................%%%..............................
m .....................................%%%%2....................3%%%%.............................
m .................................%%.%%%%%.....%%........%%.....%%%%%.%%.........................
m ........................%%%%%%%%%%%%%%%%%....%%%........%%%....%%%%%%%%%%%%%%%%%................
m ........................%%%%%%%%%%%%%%%%%....%%%%......%%%%....%%%%%%%%%%%%%%%%%................
m ........%.......%.......%.%....%..%.%..%.....%%%%......%%%%.....%..%.%..%....%.%.......%.......%
m ...%%.........%%........................................................................%%......
m ...%%.........%%........%......................................................%........%%......
m .............%..........%......................................................%..........%.....
