# map type: blank
# random seed: 745392850
# hill distance  64, 86  48, 16  96, 46 112,116  72,106  88, 26  40,146  24, 76   0,136  16, 56
#        64, 86       0     114     128     114      44     124     124      86     130     114 
#        48, 16     114       0     114     130     112      86      44     112     114     128 
#        96, 46     128     114       0     114     112      44     130     114     112      86 
#       112,116     114     130     114       0      86     124     114     128      44     124 
#        72,106      44     112     112      86       0     114     128     114     114     130 
#        88, 26     124      86      44     124     114       0     114     130     128     114 
#        40,146     124      44     130     114     128     114       0     114      86     124 
#        24, 76      86     112     114     128     114     130     114       0     112      44 
#         0,136     130     114     112      44     114     128      86     112       0     114 
#        16, 56     114     128      86     124     130     114     124      44     114       0 
players 5
rows 120
cols 150
m .................%%%................%%..........%.......................%....%%%...%%%.........%%................%%.................%...3......%%.....
m ..%.%.%%%...%....%%%....%%...%.....%%%....%.%.%%%%...%%%...%%%...%%....%%....%%%%%%%%%....%..%%%%%....%.%%..%....%%......%.....%...%%%...%......%%%...
m %%%%%%%%%%%%%....%%%...%%.....%%...%%....%%%%%%%%....%%....%%%...%%%....%%....%%%%%%%....%%%%%%%%....%%%%%%%%%%%%%%.....%.....%%%%%%%%%%%%%....%%%%%%%
m %%%%%%%%%%%%%..........%%%...%%%...%.%...%%%%..%%.....%%...%......%.....%%....%%%%.%%%....%.%%.%%%....%%...%.%%%%..%...%%%...%%...%.%%.....%...%%%%%%%
m ...........%%...........%.....%%.........%%...........%%................%%....%.....%%.........%%%....%%................%.............................
m ...........%%%..........%%....%%.........%%%..........%%................%%...%%....%%%.........%%....%%%...............%%%............................
m ...........%%%..........%....%%%..........%%..........%.................%%....%%...%%%.........%%....%%%................%.............................
m .%...%%%...%%%.%%%%%....%%...%%%...%%.....%....%......%%%%.%....%%%%....%%....%%...%%%%%%..%....%%%..%%%...%%.%%%....%.%%%%..%.%.%%%.....%..%..%%%%.%%
m %%....%.....%%%%%%%%....%%%%%%%%...%%%...%%%....%.....%%%%%%%%%%%%%%....%....%%%....%%%%%%%....%%%%%%%%.....%%%%%%%%%%%%%%%%%%%%%%%%%%...%%%%%%%%%%%%%
m %.....%%...%.%%%%%%.....%%%%%%%.....%%...%%%...%%....%%%..%%%%.%..%%...%.%...%%....%.%%%.%%....%..%.%%.....%%%.%.%%%.%%.%%%%%%.%%...%....%%%%%%%%.%%%%
m %%....%.............................%.....%%.................................%%...........%%................%%...........................%%%.........%
m %%....%............................%%.....%%.................................%%...........%%................%%...........................%%%.........%
m %.....%%...........................%%%....%..................................%%...........%%................%%...........................%%%.........%
m %.....%%%..%%%...%.%.....%......%..%%%....%....%%%%%%%......%%...%.%%.%....%%%%%...%......%%%%%.%..%.%..%%%%%.....%%...%.....%%......%...%%%.........%
m %.....%%%%%%%%...%%%....%.....%%%%%%%%...%%....%%%%%%%%.....%%...%%%%%%%%%%%%%%....%%....%%%%%%%%%%%%%%%%%%%%%...%%.....%%%%%%%%...%%%%%%%%.....%....%
m ......%%%..%%....%......%%...%.%...%%.....%....%%%..%%%....%%....%%...%%%%.%%%%%....%....%%.%..%%%.%.%%%%%.%......%.....%...........%%%%%%.....%%....%
m .....%%%...%%...........%...........%.....%%...%%%....%.2...............%..........%%%.........%%%...%%..........%%................%%%.........%%%....
m .....%%%....%%.........%%%.........%%%....%%....%....%%%...............%%%.........%%%..........%%....%...........%................%%%..........%%....
m ......%.....%...........%...........%.....%%...%%.....%.................%...........%..........%%%...%%...........%.................%%..........%.....
m .%.%.%%....%%%....%....%%%..%.%%....%%....%.....%%....%%...%......%%....%....%%%.%%%%%...%.%....%%...%%%....%%%%.%%%%...%.%..%%.%.%%%%...%%%%%%%%%.%..
m %%%%%%%....%%%...%%.....%%%%%%%%...%%%...%%%...%%....%%.....%.....%%...%%.....%%%%%%%%%%%%%....%%%...%%....%%%%%%%%%%%%%%%%%%%%%%%%%%%...%%%%%%%%%%%%%
m %%..%.%%....%%...%%....%%%%.%.%.....%%...%%%...%%%....%%...%.%...%%%....%%....%.%.%%%%.%%.%....%%%....%%...%%%.%%...%.%.....%%%%%%%.%%....%%..%...%%%.
m ...........%%.....%%...%%%.........%%................%%%...............%%%.........%%%.....................%%%................%%..........%%..........
m ...........%%%....%%....%..........%%.................%.................%..........%%......................%%%...............%%%.........%%...........
m ............%....%%%...%%%.........%%................%%.................%...1......%%......................%%%................%%..........%...........
m %%...%%....%%....%%%%%%%%%....%..%%%%%....%.%%..%....%%......%.....%...%%%...%......%%%.....%.%.%%%...%....%%%....%%...%.....%%%....%.%.%%%%...%%%...%
m %%...%%%....%%....%%%%%%%....%%%%%%%%....%%%%%%%%%%%%%%.....%.....%%%%%%%%%%%%%....%%%%%%%%%%%%%%%%%%%%....%%%...%%.....%%...%%....%%%%%%%%....%%....%
m ......%.....%%....%%%%.%%%....%.%%.%%%....%%...%.%%%%..%...%%%...%%...%.%%.....%...%%%%%%%%%%%%%%%%%%%%..........%%%...%%%...%.%...%%%%..%%.....%%...%
m ............%%....%.....%%.........%%%....%%................%........................................%%...........%.....%%.........%%...........%%....
m ............%%...%%....%%%.........%%....%%%...............%%%.......................................%%%..........%%....%%.........%%%..........%%....
m ............%%....%%...%%%.........%%....%%%................%........................................%%%..........%....%%%..........%%..........%.....
m ....%%%%....%%....%%...%%%%%%..%....%%%..%%%...%%.%%%....%.%%%%..%.%.%%%.....%..%..%%%%.%%.%...%%%...%%%.%%%%%....%%...%%%...%%.....%....%......%%%%.%
m %%%%%%%%....%....%%%....%%%%%%%....%%%%%%%%.....%%%%%%%%%%%%%%%%%%%%%%%%%%...%%%%%%%%%%%%%%%....%.....%%%%%%%%....%%%%%%%%...%%%...%%%....%.....%%%%%%
m %%.%..%%...%.%...%%....%.%%%.%%....%..%.%%.....%%%.%.%%%.%%.%%%%%%.%%...%....%%%%%%%%.%%%%%.....%%...%.%%%%%%.....%%%%%%%.....%%...%%%...%%....%%%..%%
m .................%%...........%%................%%...........................%%%.........%%%....%.............................%.....%%................
m .................%%...........%%................%%...........................%%%.........%%%....%............................%%.....%%................
m .................%%...........%%................%%...........................%%%.........%%.....%%...........................%%%....%.................
m %%...%.%%.%....%%%%%...%......%%%%%.%..%.%..%%%%%.....%%...%.....%%......%...%%%.........%%.....%%%..%%%...%.%.....%......%..%%%....%....%%%%%%%......
m %%...%%%%%%%%%%%%%%....%%....%%%%%%%%%%%%%%%%%%%%%...%%.....%%%%%%%%...%%%%%%%%.....%....%%.....%%%%%%%%...%%%....%.....%%%%%%%%...%%....%%%%%%%%.....
m %....%%...%%%%.%%%%%....%....%%.%..%%%.%.%%%%%.%......%.....%...........%%%%%%.....%%....%......%%%..%%....%......%%...%.%...%%.....%....%%%..%%%....%
m ............%..........%%%.........%%%...%%..........%%................%%%.........%%%.........%%%...%%...........%...........%.....%%...%%%....%.0...
m ...........%%%.........%%%..........%%....%...........%................%%%..........%%.........%%%....%%.........%%%.........%%%....%%....%....%%%....
m ............%...........%..........%%%...%%...........%.................%%..........%...........%.....%...........%...........%.....%%...%%.....%.....
m ......%%....%....%%%.%%%%%...%.%....%%...%%%....%%%%.%%%%...%.%..%%.%.%%%%...%%%%%%%%%.%...%.%.%%....%%%....%....%%%..%.%%....%%....%.....%%....%%...%
m %.....%%...%%.....%%%%%%%%%%%%%....%%%...%%....%%%%%%%%%%%%%%%%%%%%%%%%%%%...%%%%%%%%%%%%%%%%%%%%....%%%...%%.....%%%%%%%%...%%%...%%%...%%....%%.....
m .%...%%%....%%....%.%.%%%%.%%.%....%%%....%%...%%%.%%...%.%.....%%%%%%%.%%....%%..%...%%%.%%..%.%%....%%...%%....%%%%.%.%.....%%...%%%...%%%....%%...%
m ...........%%%.........%%%.....................%%%................%%..........%%.....................%%.....%%...%%%.........%%................%%%....
m ............%..........%%......................%%%...............%%%.........%%......................%%%....%%....%..........%%.................%.....
m ............%...4......%%......................%%%................%%..........%.......................%....%%%...%%%.........%%................%%.....
m .%.....%...%%%...%......%%%.....%.%.%%%...%....%%%....%%...%.....%%%....%.%.%%%%...%%%...%%%...%%....%%....%%%%%%%%%....%..%%%%%....%.%%..%....%%.....
m %.....%%%%%%%%%%%%%....%%%%%%%%%%%%%%%%%%%%....%%%...%%.....%%...%%....%%%%%%%%....%%....%%%...%%%....%%....%%%%%%%....%%%%%%%%....%%%%%%%%%%%%%%.....
m %%...%%...%.%%.....%...%%%%%%%%%%%%%%%%%%%%..........%%%...%%%...%.%...%%%%..%%.....%%...%......%.....%%....%%%%.%%%....%.%%.%%%....%%...%.%%%%..%...%
m %........................................%%...........%.....%%.........%%...........%%................%%....%.....%%.........%%%....%%................
m %%.......................................%%%..........%%....%%.........%%%..........%%................%%...%%....%%%.........%%....%%%...............%
m %........................................%%%..........%....%%%..........%%..........%.................%%....%%...%%%.........%%....%%%................
m %%%..%.%.%%%.....%..%..%%%%.%%.%...%%%...%%%.%%%%%....%%...%%%...%%.....%....%......%%%%.%....%%%%....%%....%%...%%%%%%..%....%%%..%%%...%%.%%%....%.%
m %%%%%%%%%%%%%%...%%%%%%%%%%%%%%%....%.....%%%%%%%%....%%%%%%%%...%%%...%%%....%.....%%%%%%%%%%%%%%....%....%%%....%%%%%%%....%%%%%%%%.....%%%%%%%%%%%%
m %%%%%%.%%...%....%%%%%%%%.%%%%%.....%%...%.%%%%%%.....%%%%%%%.....%%...%%%...%%....%%%..%%%%.%..%%...%.%...%%....%.%%%.%%....%..%.%%.....%%%.%.%%%.%%.
m .................%%%.........%%%....%.............................%.....%%.................................%%...........%%................%%..........
m .................%%%.........%%%....%............................%%.....%%.................................%%...........%%................%%..........
m .................%%%.........%%.....%%...........................%%%....%..................................%%...........%%................%%..........
m .....%%......%...%%%.........%%.....%%%..%%%...%.%.....%......%..%%%....%....%%%%%%%......%%...%.%%.%....%%%%%...%......%%%%%.%..%.%..%%%%%.....%%...%
m %%%%%%%%...%%%%%%%%.....%....%%.....%%%%%%%%...%%%....%.....%%%%%%%%...%%....%%%%%%%%.....%%...%%%%%%%%%%%%%%....%%....%%%%%%%%%%%%%%%%%%%%%...%%.....
m %...........%%%%%%.....%%....%......%%%..%%....%......%%...%.%...%%.....%....%%%..%%%....%%....%%...%%%%.%%%%%....%....%%.%..%%%.%.%%%%%.%......%.....
m ...........%%%.........%%%.........%%%...%%...........%...........%.....%%...%%%....%.3...............%..........%%%.........%%%...%%..........%%.....
m ...........%%%..........%%.........%%%....%%.........%%%.........%%%....%%....%....%%%...............%%%.........%%%..........%%....%...........%.....
m ............%%..........%...........%.....%...........%...........%.....%%...%%.....%.................%...........%..........%%%...%%...........%.....
m %.%..%%.%.%%%%...%%%%%%%%%.%...%.%.%%....%%%....%....%%%..%.%%....%%....%.....%%....%%...%......%%....%....%%%.%%%%%...%.%....%%...%%%....%%%%.%%%%...
m %%%%%%%%%%%%%%...%%%%%%%%%%%%%%%%%%%%....%%%...%%.....%%%%%%%%...%%%...%%%...%%....%%.....%.....%%...%%.....%%%%%%%%%%%%%....%%%...%%....%%%%%%%%%%%%%
m ....%%%%%%%.%%....%%..%...%%%.%%..%.%%....%%...%%....%%%%.%.%.....%%...%%%...%%%....%%...%.%...%%%....%%....%.%.%%%%.%%.%....%%%....%%...%%%.%%...%.%.
m ......%%..........%%.....................%%.....%%...%%%.........%%................%%%...............%%%.........%%%.....................%%%..........
m .....%%%.........%%......................%%%....%%....%..........%%.................%.................%..........%%......................%%%..........
m ......%%..........%.......................%....%%%...%%%.........%%................%%.................%...2......%%......................%%%..........
m .....%%%....%.%.%%%%...%%%...%%%...%%....%%....%%%%%%%%%....%..%%%%%....%.%%..%....%%......%.....%...%%%...%......%%%.....%.%.%%%...%....%%%....%%...%
m %%...%%....%%%%%%%%....%%....%%%...%%%....%%....%%%%%%%....%%%%%%%%....%%%%%%%%%%%%%%.....%.....%%%%%%%%%%%%%....%%%%%%%%%%%%%%%%%%%%....%%%...%%.....
m %%...%.%...%%%%..%%.....%%...%......%.....%%....%%%%.%%%....%.%%.%%%....%%...%.%%%%..%...%%%...%%...%.%%.....%...%%%%%%%%%%%%%%%%%%%%..........%%%...%
m %%.........%%...........%%................%%....%.....%%.........%%%....%%................%........................................%%...........%.....
m %%.........%%%..........%%................%%...%%....%%%.........%%....%%%...............%%%.......................................%%%..........%%....
m %%..........%%..........%.................%%....%%...%%%.........%%....%%%................%........................................%%%..........%....%
m %%...%%.....%....%......%%%%.%....%%%%....%%....%%...%%%%%%..%....%%%..%%%...%%.%%%....%.%%%%..%.%.%%%.....%..%..%%%%.%%.%...%%%...%%%.%%%%%....%%...%
m %%...%%%...%%%....%.....%%%%%%%%%%%%%%....%....%%%....%%%%%%%....%%%%%%%%.....%%%%%%%%%%%%%%%%%%%%%%%%%%...%%%%%%%%%%%%%%%....%.....%%%%%%%%....%%%%%%
m %.....%%...%%%...%%....%%%..%%%%.%..%%...%.%...%%....%.%%%.%%....%..%.%%.....%%%.%.%%%.%%.%%%%%%.%%...%....%%%%%%%%.%%%%%.....%%...%.%%%%%%.....%%%%%%
m ......%.....%%.................................%%...........%%................%%...........................%%%.........%%%....%.......................
m .....%%.....%%.................................%%...........%%................%%...........................%%%.........%%%....%.......................
m .....%%%....%..................................%%...........%%................%%...........................%%%.........%%.....%%......................
m ..%..%%%....%....%%%%%%%......%%...%.%%.%....%%%%%...%......%%%%%.%..%.%..%%%%%.....%%...%.....%%......%...%%%.........%%.....%%%..%%%...%.%.....%....
m %%%%%%%%...%%....%%%%%%%%.....%%...%%%%%%%%%%%%%%....%%....%%%%%%%%%%%%%%%%%%%%%...%%.....%%%%%%%%...%%%%%%%%.....%....%%.....%%%%%%%%...%%%....%.....
m .%...%%.....%....%%%..%%%....%%....%%...%%%%.%%%%%....%....%%.%..%%%.%.%%%%%.%......%.....%...........%%%%%%.....%%....%......%%%..%%....%......%%...%
m ......%.....%%...%%%....%.1...............%..........%%%.........%%%...%%..........%%................%%%.........%%%.........%%%...%%...........%.....
m .....%%%....%%....%....%%%...............%%%.........%%%..........%%....%...........%................%%%..........%%.........%%%....%%.........%%%....
m ......%.....%%...%%.....%.................%...........%..........%%%...%%...........%.................%%..........%...........%.....%...........%.....
m %%....%%....%.....%%....%%...%......%%....%....%%%.%%%%%...%.%....%%...%%%....%%%%.%%%%...%.%..%%.%.%%%%...%%%%%%%%%.%...%.%.%%....%%%....%....%%%..%.
m %%...%%%...%%%...%%....%%.....%.....%%...%%.....%%%%%%%%%%%%%....%%%...%%....%%%%%%%%%%%%%%%%%%%%%%%%%%%...%%%%%%%%%%%%%%%%%%%%....%%%...%%.....%%%%%%
m %.....%%...%%%...%%%....%%...%.%...%%%....%%....%.%.%%%%.%%.%....%%%....%%...%%%.%%...%.%.....%%%%%%%.%%....%%..%...%%%.%%..%.%%....%%...%%....%%%%.%.
m .....%%................%%%...............%%%.........%%%.....................%%%................%%..........%%.....................%%.....%%...%%%....
m .....%%.................%.................%..........%%......................%%%...............%%%.........%%......................%%%....%%....%.....
m .....%%................%%.................%...0......%%......................%%%................%%..........%.......................%....%%%...%%%....
m %..%%%%%....%.%%..%....%%......%.....%...%%%...%......%%%.....%.%.%%%...%....%%%....%%...%.....%%%....%.%.%%%%...%%%...%%%...%%....%%....%%%%%%%%%....
m %%%%%%%....%%%%%%%%%%%%%%.....%.....%%%%%%%%%%%%%....%%%%%%%%%%%%%%%%%%%%....%%%...%%.....%%...%%....%%%%%%%%....%%....%%%...%%%....%%....%%%%%%%....%
m %.%%.%%%....%%...%.%%%%..%...%%%...%%...%.%%.....%...%%%%%%%%%%%%%%%%%%%%..........%%%...%%%...%.%...%%%%..%%.....%%...%......%.....%%....%%%%.%%%....
m .....%%%....%%................%........................................%%...........%.....%%.........%%...........%%................%%....%.....%%....
m .....%%....%%%...............%%%.......................................%%%..........%%....%%.........%%%..........%%................%%...%%....%%%....
m .....%%....%%%................%........................................%%%..........%....%%%..........%%..........%.................%%....%%...%%%....
m .%....%%%..%%%...%%.%%%....%.%%%%..%.%.%%%.....%..%..%%%%.%%.%...%%%...%%%.%%%%%....%%...%%%...%%.....%....%......%%%%.%....%%%%....%%....%%...%%%%%%.
m %....%%%%%%%%.....%%%%%%%%%%%%%%%%%%%%%%%%%%...%%%%%%%%%%%%%%%....%.....%%%%%%%%....%%%%%%%%...%%%...%%%....%.....%%%%%%%%%%%%%%....%....%%%....%%%%%%
m %....%..%.%%.....%%%.%.%%%.%%.%%%%%%.%%...%....%%%%%%%%.%%%%%.....%%...%.%%%%%%.....%%%%%%%.....%%...%%%...%%....%%%..%%%%.%..%%...%.%...%%....%.%%%.%
m %%................%%...........................%%%.........%%%....%.............................%.....%%.................................%%...........
m %%................%%...........................%%%.........%%%....%............................%%.....%%.................................%%...........
m %%................%%...........................%%%.........%%.....%%...........................%%%....%..................................%%...........
m %%%%%.%..%.%..%%%%%.....%%...%.....%%......%...%%%.........%%.....%%%..%%%...%.%.....%......%..%%%....%....%%%%%%%......%%...%.%%.%....%%%%%...%......
m %%%%%%%%%%%%%%%%%%%%...%%.....%%%%%%%%...%%%%%%%%.....%....%%.....%%%%%%%%...%%%....%.....%%%%%%%%...%%....%%%%%%%%.....%%...%%%%%%%%%%%%%%....%%....%
m %.%..%%%.%.%%%%%.%......%.....%...........%%%%%%.....%%....%......%%%..%%....%......%%...%.%...%%.....%....%%%..%%%....%%....%%...%%%%.%%%%%....%....%
m .....%%%...%%..........%%................%%%.........%%%.........%%%...%%...........%...........%.....%%...%%%....%.4...............%..........%%%....
m ......%%....%...........%................%%%..........%%.........%%%....%%.........%%%.........%%%....%%....%....%%%...............%%%.........%%%....
m .....%%%...%%...........%.................%%..........%...........%.....%...........%...........%.....%%...%%.....%.................%...........%.....
m .%....%%...%%%....%%%%.%%%%...%.%..%%.%.%%%%...%%%%%%%%%.%...%.%.%%....%%%....%....%%%..%.%%....%%....%.....%%....%%...%......%%....%....%%%.%%%%%...%
m %....%%%...%%....%%%%%%%%%%%%%%%%%%%%%%%%%%%...%%%%%%%%%%%%%%%%%%%%....%%%...%%.....%%%%%%%%...%%%...%%%...%%....%%.....%.....%%...%%.....%%%%%%%%%%%%
m %....%%%....%%...%%%.%%...%.%.....%%%%%%%.%%....%%..%...%%%.%%..%.%%....%%...%%....%%%%.%.%.....%%...%%%...%%%....%%...%.%...%%%....%%....%.%.%%%%.%%.
m .................%%%................%%..........%%.....................%%.....%%...%%%.........%%................%%%...............%%%.........%%%....
m .................%%%...............%%%.........%%......................%%%....%%....%..........%%.................%.................%..........%%.....
