# map type: blank
# random seed: -1357156802
# hill distance  58, 24  35, 47  24, 46  57, 13  41, 16  27, 30
#        58, 24       0      46      56      20      25      37 
#        35, 47      46       0      20      56      37      25 
#        24, 46      56      20       0      66      47      19 
#        57, 13      20      56      66       0      19      47 
#        41, 16      25      37      47      19       0      28 
#        27, 30      37      25      19      47      28       0 
players 2
rows 80
cols 80
m %%........%.%....%%%%.%%%.%......%%%%%....................................%%.%.%
m .................%%%..............%%%.................................%%%.......
m .................%%%..............%%%.................................%%%.......
m ..................%%.............%%%%%................................%%%.......
m ..................%%.............%%%%%%..%%%%%......%.......%.......%...........
m ..%%%....%%%...%%%%%%....%..%.%%%%%%%%%%%%%%%%....%%%......%%%.....%%%....%%%%.%
m %%%%%.....%%%%%%%%%%%.....%%%%%%%%%%%%%%%%%%%......%%.....%%%%.....%%%....%%%%%%
m %%%%%....%%%%%%%%%%%%.....%%%%.%%%%%%%%.%.%%%%.....%%%.....%%.....%%%.....%%%%%%
m %%%%%.....%%%%...%.......%.........%%.............%%%%.............%%%....%%%%%%
m %%%%%....%%%.......................%%.............%%%%.............%%......%%%%%
m %%%%......%%%............%........%%%%.............%%.............%%%%....%%%%%%
m %%%%.....%%%.............%........%%%%.............%%%.............%%%.....%%%%%
m %%%%......%%.............%%%%%.....%%%....%..%.....%%%..%%.........%%%.....%%%%%
m %%%%%..%.%%%%....%.%%....%%%%%....%%%%....%%%......%%%%%%%%%%%.....%%.....%%%%%%
m %%%%%%%%%%%%.....%%%%....%%%%%.....%%%....%%%%.....%%%%%%%%%%%....%%%.....%%%%%%
m ..%%%%%%%%%%%.....%%%.....%.%.....%..%....%%%%.....%...%.%..%%......%.....%%%%%.
m ...%%%%%%%%%......%%......................%%%%..................................
m ...%%%%%%%%%%....%%%%%....................%%%%..................................
m ..%%%%%%%%%%......%%%.....................%%%...................................
m ...%%%%%%%%%......%%%%.....................%%%..................................
m %.%%%%%%%%%%%.....%%%...........%.%..%....%%%%%..%%%%%.....%%...%...%.....%.%.%.
m %%%%%%%%%%%%%.....%%%......%%%%%%%%%%%.....%%%%%%%%%%......%%%%%%%%%%%....%%%%%%
m %%%%%%%%%%%%%.....%%%......%%%%%%%%%%%....%%%%%%%%%%%......%%%%%%%%%%.....%%%%%%
m ..%.%.%..%%%.......%.%.....%%%...%.%%......%.......%%%.....%%%%%...%%%.....%%%.%
m ...........................%%.................0...........%%%..............%%%..
m ...........................%%.............................%%%%.............%%...
m ...........................%%.............................%%%.............%%%...
m ..........................%%%.0............................%%.............%%%...
m ..%%..%..........%..%......%%.....%........%.%....%%%.%%.%%%%.......%%%%..%%%%..
m ...%%%%%%%%%......%%%%....%%%.....%%%......%%%%%%%%%%%%%%%%%%%.....%%%%%%%%%%...
m ..%%%%%%%%%%%.....%%%%....%%%%.....%%%.....%%%%%%%%%%%%%%%%%%%....%%%%%%%%%%%...
m ..%%%.%%%%%%.....%%%%......%%.....%..%.....%%.%.%%%.....%.%.%%....%%%%....%%%...
m ......%.%...%.....%%.%.............................................%%...........
m ...................................................................%%%..........
m ..................................................................%%%%..........
m ...............................................1...................%%%..........
m %%%%.....................%.%%%......%%%%.%%%..%%%..%......%.......%%%.....%..%.%
m .%%%%...........%.%%......%%%%.....%%%%%%%%%%%%%%%%%%......%%%.....%%%.....%%...
m .%%%......%%%%%%%%%%%....%%%%%....%%%%%%%%%%%%%%%%%%%%.....%%%....%%%......%%...
m .%%%%.....%%%%%%%%%%%....%%%%......%%%.%...%..%....%.%....%%%......%%.....%%%...
m .%%%......%%%......%.....%%%.%.....%%.....................%%%..............%%...
m ..........%%....1.................%%%......................%%%............%%....
m ..........%%......................%%%%.....................%%%............%%%...
m .........%%%......................%%%%.....................%%%............%%%...
m ..........%%%....................%%%%%......%%.%.%%.......%%%%....%..%..%%%%%...
m %.%.%....%%%.....%%.%......%..%%%%%%%.....%%%%%%%%%%%%.....%%.....%%%%%%%%%%%..%
m %%%%......%%%.....%%......%%%%%%%%%%%%....%%%%%%%%%%%%.....%%%.....%%%%%%%%%%%%%
m %%%%......%%%.....%%.....%%%%%%%%%%%%%.......%%%..%%%......%%%.....%%%%%%%%%%%%%
m %%%%%....%%%.......%%....%%%%..%%%.%%%.............%%%.............%%%..%%%%%..%
m .........................%%%.......................%%....................%%%%...
m .........................%%%%......................%%.....................%%....
m ..........................%%.......................%%.....................%%%...
m .........................%%%.............%.%%%....%%%%%.%.%.%%%.%........%%%....
m .%%%%%%%.%.%.............%%%......%%......%%%.....%%%%%%%%%%%%%%%%..%....%%%%...
m ..%%%%%%%%%%%....%%%%....%%%%.....%%.....%%%%%.....%%%%%%%%%%%%%%%%%.....%%%%...
m ..%%%%%%%%%%......%%%.....%%.....%%%.....%%%%......%%...%.%%%%%%%%%%%....%%%%...
m .%.%%%%.%%%%.....%%%......%%.....%%%%....%.%.%............%%%.%.%...%....%%.%...
m .........%%%.1....%%%....%%%%.....%%%......................%%...................
m ..........%%......%%....0%%%.....%%%%.....................%%....................
m ..........%%......%%%....%%%......%%......................%%%...................
m .........%%%......%%%.....%%.....%%%.............%%%%%....%%%...................
m .........%%%.....%%%%.....%%.....%%%%....%%......%%%%.....%%.......%%.....%..%%.
m %%%%%....%%%%....%%%.....%%%%.....%%%%%%%%%%%....%%%%%....%%%.....%%......%%%%%%
m %%%%.....%%%%....%%%......%%......%%%%%%%%%%%....%%%%%....%%%.....%%%....%%%%%%%
m %%%%.....%..%.....%%.......%%.....%%.%...%%%.....%.%%%....%%.....%%%........%%%.
m ..%%.............%%%.....................%%%....................................
m ..%%%............%%%......................%%....................................
m .%%%..............%%%....................%%%%...................................
m .%%%%............%%%......................%%....................................
m ..%%.........%%%.%%%%....%..%%...%.......%%%%%.%%%%%%%....%%%%.%%.%.%......%....
m ..%%.....%%%%%%%%%%%......%%%%%%%%%%%.....%%%%%%%%%%%%....%%%%%%%%%%%.....%%%...
m ..%%%....%%%%%%%%%%%%.....%%%%%%%%%%%....%%%%%%.%%.%%.....%%%%%%%%%%.....%%%%...
m ..%%%.....%%%.%...%%%.....%%..%%%%.%%....%%%%.............%%%%%%%%%%......%%....
m ..........%%%............................%%%%%.............%%%%%%%%%%...........
m ..........%%%.............................%%%.............%%%%%%%%%%............
m .........%%%.............................%%%%%............%%%%%%%%%%%...........
m ..........%%..............................%%%........%.....%%%%%%%%%%...........
m ...%......%%.......%%..%.%.%.....%%........%%......%%%....%%%%%%%%%%%.......%..%
m %%%%......%%%.....%%%%%%%%%%%.....%%%%.....%%.....%%%%.....%%%%%%%%%%.....%%%%%%
m %%%%%....%%%%....%%%%%%%%%%%%.....%%%%....%.%%....%.%.....%%..%.%%%%%....%%%%%%%
