rows 72
cols 72
players 4
m ..%.....%%...%%%%%%%%....%%%...%%%%...%%%....%%%%%%%%...%%.....%....%%..
m .%%%...%%.......%%%%%%....%............%....%%%%%%.......%%...%%%...%%..
m .%%%...............%%%....%%..........%%....%%%...............%%%...%%..
m ..%%...............%%%...%%%..........%%%...%%%...............%%....%%..
m .%%................%%.....%%..........%%.....%%................%%...%%..
m .%%......%....%.....%%....%....%%%%....%....%%.....%....%......%%...%%..
m ..%.....%%%%%%%.....%%...%%%...%%%%...%%%...%%.....%%%%%%%.....%....%%..
m ..%.....%..%%%%%...%%%...%%%...%%%%...%%%...%%%...%%%%%..%.....%....%%..
m ..%%.........%%.0..%%%....%.....%%.....%....%%%..1.%%.........%%....%%..
m .%%%.........%%.....%.....%....%%%%....%.....%.....%%.........%%%...%%..
m ..%%.........%%%...%%....%%....%%%%....%%....%%...%%%.........%%....%%..
m ..%%.........%%%%..%%....%%....%%%%....%%....%%..%%%%.........%%....%%..
m ..%%...%%....%%%%%%%%.....%%...%%%%...%%.....%%%%%%%%....%%...%%....%%..
m ..........................%.....%%.....%............................%%..
m ..........................%%....%%....%%............................%%..
m ..........................%%....%%....%%............................%%..
m ..........................%.....%%.....%............................%%..
m ..%%...%%....%%%%%%%%.....%%...%%%%...%%.....%%%%%%%%....%%...%%....%%..
m ..%%.........%%%%..%%....%%....%%%%....%%....%%..%%%%.........%%....%%..
m ..%%.........%%%...%%....%%....%%%%....%%....%%...%%%.........%%....%%..
m .%%%.........%%.....%.....%....%%%%....%.....%.....%%.........%%%...%%..
m ..%%.........%%.2..%%%....%.....%%.....%....%%%..3.%%.........%%....%%..
m ..%.....%..%%%%%...%%%...%%%...%%%%...%%%...%%%...%%%%%..%.....%....%%..
m ..%.....%%%%%%%.....%%...%%%...%%%%...%%%...%%.....%%%%%%%.....%....%%..
m .%%......%....%.....%%....%....%%%%....%....%%.....%....%......%%...%%..
m .%%................%%.....%%..........%%.....%%................%%...%%..
m ..%%...............%%%...%%%..........%%%...%%%...............%%....%%..
m .%%%...............%%%....%%..........%%....%%%...............%%%...%%..
m .%%%...%%.......%%%%%%....%............%....%%%%%%.......%%...%%%...%%..
m ..%.....%%...%%%%%%%%....%%%...%%%%...%%%....%%%%%%%%...%%.....%....%%..
m .%%%.....%....%%.%..%%....%.....%%.....%....%%..%.%%....%.....%%%...%%..
m ..%%..........%%................%%................%%..........%%....%%..
m .%%...........%.................%%.................%...........%%...%%..
m .%%..........%%................%%%%................%%..........%%...%%..
m ..%.....%.....%%%%.%..%.%..%....%%....%..%.%..%.%%%%.....%.....%....%%..
m .%%.....%%....%%%%%%%%%%%%%%...%%%%...%%%%%%%%%%%%%%....%%.....%%...%%..
m ..%....%%%.....%..%%%%%%%%%%...%%%%...%%%%%%%%%%..%.....%%%....%....%%..
m ..%.....%................%%%...%%%%...%%%................%.....%....%%..
m .%%%....%................%%%...%%%%...%%%................%....%%%...%%..
m .%%....%%................%%%....%%....%%%................%%....%%...%%..
m .%%....%%%%%.%.%...%%%....%%...%%%%...%%....%%%...%.%.%%%%%....%%...%%..
m ..%%....%%%%%%%%%%%%%....%%%...%%%%...%%%....%%%%%%%%%%%%%....%%....%%..
m ..%.....%%.....%.%%%%.....%%....%%....%%.....%%%%.%.....%%.....%....%%..
m ..%.....%%.........%%....%%%...%%%%...%%%....%%.........%%.....%....%%..
m .%%%....%...........%.....%%....%%....%%.....%...........%....%%%...%%..
m ..%.....%..........%%.....%.....%%.....%.....%%..........%.....%....%%..
m ..%%...%%%....%....%%%...%%%....%%....%%%...%%%....%....%%%...%%....%%..
m ..%%....%%....%%...%%.....%%...%%%%...%%.....%%...%%....%%....%%....%%..
m .%%%....%%...%%%.....%....%.....%%.....%....%.....%%%...%%....%%%...%%..
m ..%...........%..........%%%...%%%%...%%%..........%...........%....%%..
m ..%...........%..........%%.....%%.....%%..........%...........%....%%..
m ..%...........%..........%%.....%%.....%%..........%...........%....%%..
m ..%...........%..........%%%...%%%%...%%%..........%...........%....%%..
m .%%%....%%...%%%.....%....%.....%%.....%....%.....%%%...%%....%%%...%%..
m ..%%....%%....%%...%%.....%%...%%%%...%%.....%%...%%....%%....%%....%%..
m ..%%...%%%....%....%%%...%%%....%%....%%%...%%%....%....%%%...%%....%%..
m ..%.....%..........%%.....%.....%%.....%.....%%..........%.....%....%%..
m .%%%....%...........%.....%%....%%....%%.....%...........%....%%%...%%..
m ..%.....%%.........%%....%%%...%%%%...%%%....%%.........%%.....%....%%..
m ..%.....%%.....%.%%%%.....%%....%%....%%.....%%%%.%.....%%.....%....%%..
m ..%%....%%%%%%%%%%%%%....%%%...%%%%...%%%....%%%%%%%%%%%%%....%%....%%..
m .%%....%%%%%.%.%...%%%....%%...%%%%...%%....%%%...%.%.%%%%%....%%...%%..
m .%%....%%................%%%....%%....%%%................%%....%%...%%..
m .%%%....%................%%%...%%%%...%%%................%....%%%...%%..
m ..%.....%................%%%...%%%%...%%%................%.....%....%%..
m ..%....%%%.....%..%%%%%%%%%%...%%%%...%%%%%%%%%%..%.....%%%....%....%%..
m .%%.....%%....%%%%%%%%%%%%%%...%%%%...%%%%%%%%%%%%%%....%%.....%%...%%..
m ..%.....%.....%%%%.%..%.%..%....%%....%..%.%..%.%%%%.....%.....%....%%..
m .%%..........%%................%%%%................%%..........%%...%%..
m .%%...........%.................%%.................%...........%%...%%..
m ..%%..........%%................%%................%%..........%%....%%..
m .%%%.....%....%%.%..%%....%.....%%.....%....%%..%.%%....%.....%%%...%%..
