# map type: blank
# random seed: 2022630331
# hill distance  34, 38  66, 60   6, 33  55, 29  37, 56  49, 21  67, 18  45, 50  54, 71   9, 51  76, 39  72, 68
#        34, 38       0      54      45      30      53      32      53      31      53      38      49      70 
#        66, 60      54       0      51      50      39      58      49      31      31      30      31      32 
#         6, 33      45      51       0      39      74      59      32      58      70      53      32      59 
#        55, 29      30      50      39       0      51      32      31      31      49      54      31      58 
#        37, 56      53      39      74      51       0      59      70      32      32      45      58      59 
#        49, 21      32      58      59      32      59       0      53      39      45      70      51      74 
#        67, 18      53      49      32      31      70      53       0      54      38      53      30      45 
#        45, 50      31      31      58      31      32      39      54       0      30      49      50      51 
#        54, 71      53      31      70      49      32      45      38      30       0      53      54      53 
#         9, 51      38      30      53      54      45      70      53      49      53       0      31      32 
#        76, 39      49      31      32      31      58      51      30      50      54      31       0      39 
#        72, 68      70      32      59      58      59      74      45      51      53      32      39       0 
players 4
rows 78
cols 78
m ....%%............%%%...............%%....%%%..........%%%%%....%..........%%%
m ....%%.%...........%%...%.%...%.%....%%%%%%%.....%%...%%%%%....%%%%%.%%.%%.%%.
m ...%%%%%.....%%....%%...%%%%%%%%%....%%%%%%%....%%%....%%%%.....%%%%%%%%%%%%%%
m ....%.%%....%.......%...%%%..%........%%%%%%....%.%.......%%...%%%..%.%...%%%.
m .........................%%...............%%%...............................%%
m .........................%%...............%%%..............................%%%
m ........................%%.......2........%%................................%.
m ...%.%%%....%.%....%.....%%......%.%%%....%%%%.%.%....%%..%%%.%%%%....%.....%%
m ....%%%%.....%%....%%...%%%....%%%%%%%.....%%%%%%%%....%%%%%%%%%%....%%%....%%
m ....%%%%%...%%....%%.....%.....%.%..%......%%%%%...3..%%%%%%%.%........%...%..
m .............%...........%%................%%............%%%..................
m .............%%..........%%................%.............%%...................
m .............%%.........%%.................%.............%%%..................
m ...%%%.%%...%%%...%...%.%%%%.%%.....%...%%%%%.......%%.%%%%.....%....%%..%%%.%
m ....%%%%.....%.....%%%%%%%%%%%%%%...%%%%%%%%.....%%%%%%%%%%%....%.....%%%%%%%.
m ...%%%%%%...%.%....%%.%%.%.%%.%.....%%%%..%%.....%%%%%%%%........%...%.%...%.%
m ...%%%%%%...........................%%.............%%%%%%.....................
m ....%%%%.............................%%............%%%%%%.....................
m ....%%%%%...........................%%.............%..%%%.....................
m %.%%%%%%%..%%.%.....%....%...%.%%....%....%%%%%%.........%%%...........%...%.%
m %%%%%%%%%%%%%%%...%%....%%%%%%%%....%%....%%%%%..........%%%...%%%...%%%...%%%
m %%%%%%%%%%%%%%%...%%%....%%%%%%%%....%....%%%%%%.........%%%....%%...%%%....%%
m %%%%%%%%%%%%%%....%%%...%%....%%%.........%%%%%%....%....%%%%%%%%....%%%...%%%
m %%%%%%%%%%%%%%%...%%%...%%%...%%%..........%%%%%....%%....%%%%%%%%....%%...%%%
m %..%%%%%%%.%%.%...%...........%%%.........%%%%%%....%....%%.%...%....%.....%.%
m ...%%%%%.........................%%%..%.............%%........................
m ....%%%%.........................%%%%%%............%%.........................
m ...%%%%%%........................%%%%%%.............%%........................
m ...%%%%%%...%.%...%.%...%........%%%%%%%%.....%%..%%%%.....%.%%.%.%%.%%....%.%
m ....%%%%.....%%%%%%%.....%....%%%%%%%%%%%.....%%%%%%%%...%%%%%%%%%%%%%%.....%.
m ...%%.%%%...%.%%%..%%....%.....%%%%.%%.......%%%%%...%.....%%.%%%%.%...%...%%%
m ..............................%%%.............%.................%%.........%%.
m ...............................%%.............%................%%..........%%.
m ..............................%%%............%%................%%...........%.
m ...%%%%%......%...%........%.%%%%%%%..2...%%%%%......%..%.%.....%.....%%....%%
m ....%%%%....%%....%%%....%%%%%%%%%%....%%%%%%%%.....%%%%%%%....%%%...%%....%%.
m ....%%%.%...%%.....%....%%%%.%%%..%%....%.%.%%%%....%%%.%......%%.....%....%.%
m .............%................................%%........3.......%%............
m ............%%%..............................%%%...............%%.............
m ............%%...............................%%%...............%%.............
m ....%%.%.....%%%...%.%..%%%...%%.......%.%....%%%%%%........%..%%%...%.......%
m ....%%%%%...%%%%%%%%%%%%%%.....%%%%....%%%....%%%%%%%....%%%%%%%%%...%%....%%.
m ....%.%%.....%%.%%.%%.%%%%%....%%%%%...%%.....%%%%%%%....%.%...%.%...%%.......
m ......%%....%%%..........%....%%%%%..........%%%....%%...............%%%......
m ......%%....%%...........%.....%%%%%..........%.....%%................%.......
m ......%%%....%%.........%%.....%%%%%.........%%%..1.%................%%%......
m ...%%%%%....%%%..........%%....%.............%%%....%%....%...%..%...%%%%.%.%.
m ...%%%%%%....%....%%.....%....%%%.......%.....%%...%%....%%%%%%%%%...%%%%%%%%.
m ...%%%%.%....%.....%.....%%....%........%.....%%...%%%....%.%%%%%.....%%%%%%%.
m %%%...............%%%0.................%%...........%%......%%%%%.....%%...%%%
m %%%................%...................%%...........%.......%%%%%....%%%...%%%
m %%%................%%..................%%...........%%......%%.%.....%.%....%%
m %%.....%.%.%%%%...%%%......%%.%.%%.%.........%.%...%%......................%%%
m %%....%%%%%%%%.....%%....%%%%%%%%%%%%%........%%...%%......................%%%
m %%%.......%.%%..........%%%....%%...%%.......%%%.......................0....%%
m ............%%..........%%%..3.............%%.........%%%......%%%....%.....%%
m .............%%.........%%%................%%.........%%%%%....%%....%%.....%%
m .............%%.........%%%...............%%%...................%%....%.......
m ...%.%%%%...%%%.....%%%%%%%%.%%%%...%%%...%%%%%%%....................%%%......
m ...%%%%%%...%%%%%%%%%%%%%%%%%%%%%....%%...%%%%%%%%%...................%%......
m ...%%%%%%.....%..%%%%.%%...%.%%.....%.%...%%%%%%%%%..................%%%......
m ...%%%%%%.........%%%..................%%%%%%%%%...%.%.....%%.%...%%.%%%%..%..
m ...%%%%%%.........%%...................%%%%%%%%%...%%....%%%%%%%%%%%%%%%%%%%%%
m ...%%%%.%.........%%%....................%%%%%%%...%%%...%%%%.%%%%%%%%.....%%%
m ...................%....%%...................%%%...............%%%.........%%.
m ............%%.....%%....%%....%%%%%.........%%................%%%.........%%.
m ............%%.....%....%%%......%%%.........%%.............2..%%%..........%%
m .%.......%%%%%....1.......................%%%.......%%...%%....%%%..........%%
m %%%%%%....%%%%%......................%%...%%........%%%%%%%%%%%%%....%%.....%%
m %.%.%.....%%%%%......................%%...%.%.........%.%%.%.%%......%%%...%%%
m .........%%%%%....%.%.....%.%%......%%...........%%..................%%.......
m .........%%%%%%...%%%....%%%%%.......%...........%%...................%.......
m .........%%%%%%...%%.....%%%%%......%%...........%%.................1%%%......
m ...%.%%%%....%%%%%%%.....%%%%%.%....%%%...%%.....%........%....%%.....%.....%.
m ...%%%%%%....%%%%%%%%...%%%%%%%%%....%%...%%.....%.......%%%....%.....%%....%.
m ....%%%%%....%.%.%%%%...%..%...%....%%....%%%.............%....%%..........%%%
m ...%%%............%%%................%.0..%%%.........%%%%%.....%%.........%%.
m ....%%.............%................%%.....%..........%%%%%.....%...........%%
