# map type: blank
# random seed: 650734898
# hill distance  71,116 117, 89  62, 15  90,116 100, 19  16, 61  16, 28 100, 70   1, 99 117,  0  29, 74  62, 74 117, 70 117, 19   1,116  90, 99  75, 28  75, 61  29, 15  71, 99  20, 99  20,116 100, 89 100,  0
#        71,116       0     117      42      63      98     110      93     127     111      96      88      71     146     127      94      92      62      91      71      49      76      63      98      69 
#       117, 89     117       0     115      54     111      61      98      92      20      37      65      94      63      94      37      37     115      94      98      96      69      98      33      54 
#        62, 15      42     115       0      61      62      92      61      93     115      94      92      81     110      91      98      94      26      61      37      71      88      71      98      65 
#        90,116      63      54      61       0      69     115      98      96      54      37     115      94     117      98      37      33      65      94      98      92     111      94      37      20 
#       100, 19      98     111      62      69       0      88      71      63     117      92     110      93      76      49      98      96      42      71      91     127     146     127      94      63 
#        16, 61     110      61      92     115      88       0      37      71      65      98      26      61      42      71      94      98      92      81      61      93      62      91      94     115 
#        16, 28      93      98      61      98      71      37       0      88      94      61      61      92      71      42      65     115      81      92      26     110      91      62     115      94 
#       100, 70     127      92      93      96      63      71      88       0      98     111      91      62      49      76     117      69      71      42     110      98     127     146      63      94 
#         1, 99     111      20     115      54     117      65      94      98       0      37      61      98      69      96      33      37     115      98      94      94      63      92      37      54 
#       117,  0      96      37      94      37      92      98      61     111      37       0      98     115      94      63      20      54      94     115      65     117      98      69      54      33 
#        29, 74      88      65      92     115     110      26      61      91      61      98       0      37      62      93      94      98      92      61      81      71      42      71      94     115 
#        62, 74      71      94      81      94      93      61      92      62      98     115      37       0      91     110     115      61      61      26      92      42      71      88      65      98 
#       117, 70     146      63     110     117      76      42      71      49      69      94      62      91       0      63      96      98      88      71      93     127      98     127      92     111 
#       117, 19     127      94      91      98      49      71      42      76      96      63      93     110      63       0      69     117      71      88      62     146     127      98     111      92 
#         1,116      94      37      98      37      98      94      65     117      33      20      94     115      96      69       0      54      98     115      61     111      92      63      54      37 
#        90, 99      92      37      94      33      96      98     115      69      37      54      98      61      98     117      54       0      94      65     115      63      94     111      20      37 
#        75, 28      62     115      26      65      42      92      81      71     115      94      92      61      88      71      98      94       0      37      61      91     110      93      98      61 
#        75, 61      91      94      61      94      71      81      92      42      98     115      61      26      71      88     115      65      37       0      92      62      93     110      61      98 
#        29, 15      71      98      37      98      91      61      26     110      94      65      81      92      93      62      61     115      61      92       0      88      71      42     115      94 
#        71, 99      49      96      71      92     127      93     110      98      94     117      71      42     127     146     111      63      91      62      88       0      63      76      69      98 
#        20, 99      76      69      88     111     146      62      91     127      63      98      42      71      98     127      92      94     110      93      71      63       0      49      96     117 
#        20,116      63      98      71      94     127      91      62     146      92      69      71      88     127      98      63     111      93     110      42      76      49       0     117      96 
#       100, 89      98      33      98      37      94      94     115      63      37      54      94      65      92     111      54      20      98      61     115      69      96     117       0      37 
#       100,  0      69      54      65      20      63     115      94      94      54      33     115      98     111      92      37      37      61      98      94      98     117      96      37       0 
players 8
rows 126
cols 126
m %.......%%....%%.....%....%.%...%%%%.%%............%%.%%%%...%.%....%.....%%....%%.......%%..........%%...%%%%...%%..........%
m %%%%%....%%....%....%%%...%%%...%%%%%%%%%........%%%%%%%%%...%%%...%%%....%....%%....%%%%%%........3%%%....%%....%%%2........%
m %%%%....%%%....%.....%%...%%.........%%%%........%%%%.........%%...%%.....%....%%%....%%%%..........%%%....%%....%%%..........
m %%.............%%.........%%...........%%........%%...........%%.........%%.............%%......%...%%.....%%.....%%...%......
m %%............%%...........%..........%%%........%%%..........%...........%%............%%....%%%%%%%%%...%%%%...%%%%%%%%%....
m %..............%..........%%%.........%%%........%%%.........%%%..........%..............%....%%%%%.%%.....%%.....%%.%%%%%....
m ......%.%%....%%.......%%%%%....%%....%%%........%%%....%%....%%%%%.......%%....%%.%..........%%....%%....%%%%....%%....%%....
m .....%%%%%%...%%%...%%%%%%%%.....%%...%%..........%%...%%.....%%%%%%%%...%%%...%%%%%%..........%.....%%...%%%%...%%.....%.....
m ......%%%%....%%%...%.%%%%%.%...%%....%%..........%%....%%...%.%%%%%.%...%%%....%%%%..........%%.....%....%%%%....%.....%%....
m .%...%%%%%%....%%................%%....%..........%....%%................%%....%%%%%%...%.%.%.%%.....%....%%%%....%.....%%.%.%
m %%...%%%%%%...%%%................%%...%%%........%%%...%%................%%%...%%%%%%...%%%%%%%%....%%....%%%%....%%....%%%%%%
m %%....%.%%%....%................%%%....%%........%%....%%%................%....%%%.%....%%..%.%%...........%%...........%%.%..
m ..............%%%.....%...%....%%%.....%..........%.....%%%....%...%.....%%%..................%%..........%%%%..........%%....
m ...............%%...%%.....%%%%%%%.....%%........%%.....%%%%%%%.....%%...%%....................%..........%%%%..........%.....
m ..............%.%...%.%....%%.%%%%.....%..........%.....%%%%.%%....%.%...%.%...................%%.........%%%%.........%%.....
m ...%.%%%.%.%.%...................%%....................%%...................%.%.%.%%%.%...%....%%.%........%%........%.%%....%
m %%%%%%%%%%%%%...............4...%%%....................%%%...7...............%%%%%%%%%%%%%%....%%%%%%%%...%%%%...%%%%%%%%....%
m ..%...%%%%.%%%...................%%....................%%...................%%%.%%%%...%......%%%%%%%%%....%%....%%%%%%%%%....
m ..............................%%..........................%%..................................%%.....%.....%%.....%.....%%....
m ..............................%%..........................%%..................................%%.....%....%%%%....%.....%%....
m ..............................%............................%..................................%%...3.%%...%%%%...%%.2...%%....
m %.....%%....%%......%.%..%....%%..%.%.%.%%%....%%%.%.%.%..%%....%..%.%......%%....%%.....%....%%....%%.....%%.....%%....%%....
m %%....%.....%........%%%%....%%%%%%%%%%%%%%....%%%%%%%%%%%%%%....%%%%........%.....%....%%%...%%%...%%%....%%....%%%...%%%...%
m %%....%%...%.%......%%%%%.....%..%%%%%...%%....%%...%%%%%..%.....%%%%%......%.%...%%....%%....%%....%%............%%....%%....
m .....%%%.............%%%%..........%%................%%..........%%%%.............%%%..........%%...%%%..........%%%...%%.....
m .....%%%.............%%%%%.........%%................%%.........%%%%%.............%%%.........%%%....%%..........%%....%%%....
m .....%%%............%...%...........%................%...........%...%............%%%..........%....%%............%%....%.....
m %%%.%%%%...%..............%...%.....%%...%%....%%...%%.....%...%..............%...%%%%.%%%%....%%...%%%.%......%.%%%...%%....%
m %%%%%%%.....%%.............%%%%%...%%....%%....%%....%%...%%%%%.............%%.....%%%%%%%....%%%....%%%%%%%%%%%%%%....%%%....
m %...%..%....%%.0...........%%%%....%%.....%....%.....%%....%%%%...........1.%%....%..%...%%...%.....%%..%.%%%%.%..%%.....%...%
m ............%........%.....%%%%..........%%....%%..........%%%%.....%........%.............................%%.................
m ............%%...%%%%%%...%%%%%...........%....%...........%%%%%...%%%%%%...%%.............................%%.................
m ...........%%%...%%.%%.....%..............%....%..............%.....%%.%%...%%%...........................%%%%................
m %....%.%..%%%%.%.....%..............%.%%%%%....%%%%%.%..............%.....%.%%%%..%.%....%%...%...%...%...%%%%...%...%...%...%
m %....%%%%%%%%%%%%....%%............%%%%%%%%....%%%%%%%%............%%....%%%%%%%%%%%%....%%...%%%%%%%%%...%%%%...%%%%%%%%%...%
m %.....%.%%%...%%%...%%%............%%%%............%%%%............%%%...%%%...%%%.%.....%%....%%..%%.%...%%%%...%.%%..%%....%
m %....................%%%%..%%....%%%%................%%%%....%%..%%%%....................%%...%%%......................%%%...%
m %...................%%%%%%%%%...%%%%%%..............%%%%%%...%%%%%%%%%...................%....%%........................%%....
m %%...................%%...%......%%.%%..............%%.%%......%...%%...................%%%....%........................%....%
m %%.%%%%%.%..........%%..........%%%...%.%........%.%...%%%..........%%..........%.%%%%%.%%%...%%%...%%%.%%%..%%%.%%%...%%%...%
m %%%%%%%%%%%%%%.......%..........%%.....%%%%....%%%%.....%%..........%.......%%%%%%%%%%%%%%.....%.....%%%%%%%%%%%%%%.....%.....
m %%%%%%...%%.%.......%%..........%%....%%%%%....%%%%%....%%..........%%.......%.%%...%%%%%%......%......%%.%..%.%%......%......
m ....................%%%...%%.%..%%.....%%%%....%%%%.....%%..%.%%...%%%........................................................
m ....................%%%...%%%%%%%%.....%%%%....%%%%.....%%%%%%%%...%%%........................................................
m ..............................................................................................................................
m ............................................%%................................................................................
m ............................................%%................................................................................
m ..............................................................................................................................
m ....................%%%...%%%%%%%%.....%%%%....%%%%.....%%%%%%%%...%%%........................................................
m ....................%%%...%%.%..%%.....%%%%....%%%%.....%%..%.%%...%%%........................................................
m %%%%%%...%%.%.......%%..........%%....%%%%%....%%%%%....%%..........%%.......%.%%...%%%%%%......%......%%.%..%.%%......%......
m %%%%%%%%%%%%%%.......%..........%%.....%%%%....%%%%.....%%..........%.......%%%%%%%%%%%%%%.....%.....%%%%%%%%%%%%%%.....%.....
m %%.%%%%%.%..........%%..........%%%...%.%........%.%...%%%..........%%..........%.%%%%%.%%%...%%%...%%%.%%%..%%%.%%%...%%%...%
m %%...................%%...%......%%.%%..............%%.%%......%...%%...................%%%....%........................%....%
m %...................%%%%%%%%%...%%%%%%..............%%%%%%...%%%%%%%%%...................%....%%........................%%....
m %....................%%%%..%%....%%%%................%%%%....%%..%%%%....................%%...%%%......................%%%...%
m %.....%.%%%...%%%...%%%............%%%%............%%%%............%%%...%%%...%%%.%.....%%....%%..%%.%...%%%%...%.%%..%%....%
m %....%%%%%%%%%%%%....%%............%%%%%%%%....%%%%%%%%............%%....%%%%%%%%%%%%....%%...%%%%%%%%%...%%%%...%%%%%%%%%...%
m %....%.%..%%%%.%.....%..............%.%%%%%....%%%%%.%..............%.....%.%%%%..%.%....%%...%...%...%...%%%%...%...%...%...%
m ...........%%%...%%.%%.....%..............%....%..............%.....%%.%%...%%%...........................%%%%................
m ............%%...%%%%%%...%%%%%...........%....%...........%%%%%...%%%%%%...%%.............................%%.................
m ............%........%.....%%%%..........%%....%%..........%%%%.....%........%.............................%%.................
m %...%..%....%%.2...........%%%%....%%.....%....%.....%%....%%%%...........3.%%....%..%...%%...%.....%%..%.%%%%.%..%%.....%...%
m %%%%%%%.....%%.............%%%%%...%%....%%....%%....%%...%%%%%.............%%.....%%%%%%%....%%%....%%%%%%%%%%%%%%....%%%....
m %%%.%%%%...%..............%...%.....%%...%%....%%...%%.....%...%..............%...%%%%.%%%%....%%...%%%.%......%.%%%...%%....%
m .....%%%............%...%...........%................%...........%...%............%%%..........%....%%............%%....%.....
m .....%%%.............%%%%%.........%%................%%.........%%%%%.............%%%.........%%%....%%..........%%....%%%....
m .....%%%.............%%%%..........%%................%%..........%%%%.............%%%..........%%...%%%..........%%%...%%.....
m %%....%%...%.%......%%%%%.....%..%%%%%...%%....%%...%%%%%..%.....%%%%%......%.%...%%....%%....%%....%%............%%....%%....
m %%....%.....%........%%%%....%%%%%%%%%%%%%%....%%%%%%%%%%%%%%....%%%%........%.....%....%%%...%%%...%%%....%%....%%%...%%%...%
m %.....%%....%%......%.%..%....%%..%.%.%.%%%....%%%.%.%.%..%%....%..%.%......%%....%%.....%....%%....%%.....%%.....%%....%%....
m ..............................%............................%..................................%%...1.%%...%%%%...%%.0...%%....
m ..............................%%..........................%%..................................%%.....%....%%%%....%.....%%....
m ..............................%%..........................%%..................................%%.....%.....%%.....%.....%%....
m ..%...%%%%.%%%...................%%....................%%...................%%%.%%%%...%......%%%%%%%%%....%%....%%%%%%%%%....
m %%%%%%%%%%%%%...............6...%%%....................%%%...5...............%%%%%%%%%%%%%%....%%%%%%%%...%%%%...%%%%%%%%....%
m ...%.%%%.%.%.%...................%%....................%%...................%.%.%.%%%.%...%....%%.%........%%........%.%%....%
m ..............%.%...%.%....%%.%%%%.....%..........%.....%%%%.%%....%.%...%.%...................%%.........%%%%.........%%.....
m ...............%%...%%.....%%%%%%%.....%%........%%.....%%%%%%%.....%%...%%....................%..........%%%%..........%.....
m ..............%%%.....%...%....%%%.....%..........%.....%%%....%...%.....%%%..................%%..........%%%%..........%%....
m %%....%.%%%....%................%%%....%%........%%....%%%................%....%%%.%....%%..%.%%...........%%...........%%.%..
m %%...%%%%%%...%%%................%%...%%%........%%%...%%................%%%...%%%%%%...%%%%%%%%....%%....%%%%....%%....%%%%%%
m .%...%%%%%%....%%................%%....%..........%....%%................%%....%%%%%%...%.%.%.%%.....%....%%%%....%.....%%.%.%
m ......%%%%....%%%...%.%%%%%.%...%%....%%..........%%....%%...%.%%%%%.%...%%%....%%%%..........%%.....%....%%%%....%.....%%....
m .....%%%%%%...%%%...%%%%%%%%.....%%...%%..........%%...%%.....%%%%%%%%...%%%...%%%%%%..........%.....%%...%%%%...%%.....%.....
m ......%.%%....%%.......%%%%%....%%....%%%........%%%....%%....%%%%%.......%%....%%.%..........%%....%%....%%%%....%%....%%....
m %..............%..........%%%.........%%%........%%%.........%%%..........%..............%....%%%%%.%%.....%%.....%%.%%%%%....
m %%............%%...........%..........%%%........%%%..........%...........%%............%%....%%%%%%%%%...%%%%...%%%%%%%%%....
m %%.............%%.........%%...........%%........%%...........%%.........%%.............%%......%...%%.....%%.....%%...%......
m %%%%....%%%....%.....%%...%%.........%%%%........%%%%.........%%...%%.....%....%%%....%%%%..........%%%....%%....%%%..........
m %%%%%....%%....%....%%%...%%%...%%%%%%%%%........%%%%%%%%%...%%%...%%%....%....%%....%%%%%%........1%%%....%%....%%%0........%
m %.......%%....%%.....%....%.%...%%%%.%%............%%.%%%%...%.%....%.....%%....%%.......%%..........%%...%%%%...%%..........%
m .........%......................................................................%..........%%...%....%.....%%.....%....%...%%.
m ........%%%....................................................................%%%.........%%%%%%....%%...%%%%...%%....%%%%%%.
m .........%......................................................................%...........%%%%....%.....%%%%.....%....%%%%..
m ...%%%.%%%%%....%%%%%%%.%..%%...%%.%%.%............%.%%.%%...%%..%.%%%%%%%....%%%%%.%%%.....%%%%...........%%...........%%%%..
m ...%%%%%%%%%%%%%%%%%%%%%%%%%.....%%%%%%%..........%%%%%%%.....%%%%%%%%%%%%%%%%%%%%%%%%%.....%%%%%.........%%%%.........%%%%%..
m ..%%%........%%%%....%.%%.%%.....%%%..%.%........%.%..%%%.....%%.%%.%....%%%%........%%%...%%..%%.........%%%%.........%%..%%.
m ...%%..........%%................%......................%................%%..........%%.......................................
m ...%%.........%%%...............%%......................%%...............%%%.........%%.......................................
m 5..%...........%%..5.............%%....................%%.............6..%%...........%..6....................................
m %%%%%%...%.....%%...%%%%.%%.%....%%...%............%...%%....%.%%.%%%%...%%.....%...%%%%%%...%......%.%%%......%%%.%......%...
m %%%%%%%%%%.....%%%%%%%%%%%%%%....%....%%..........%%....%....%%%%%%%%%%%%%%.....%%%%%%%%%%%%%........%%%%%....%%%%%........%%%
m %%.%..%........%%..%.%.%%.%%....%%%...%%..........%%...%%%....%%.%%.%.%..%%........%..%.%%%.%.......%%%%%%....%%%%%%.......%.%
m ...........................%...........%%........%%...........%.....................................%%%%%......%%%%%..........
m ..........................%%%.........%%%........%%%.........%%%....................................%%%%%......%%%%%..........
m ...........................%..........%%..........%%..........%......................................%%..%....%..%%...........
m ...%.%%%%%.%%%.%..%%.......%%..%%%%...%%%........%%%...%%%%..%%.......%%..%.%%%.%%%%%.%...%.%%.%%.........%..%.........%%.%%.%
m %%%%%%%%%%%%%%%%%%%%%%.....%%%%%%%%....%..........%....%%%%%%%%.....%%%%%%%%%%%%%%%%%%%%%%%%%%%%%..........%%..........%%%%%%%
m %%%%%%%%%%%%%%%%%%%%%%.....%%%%%%%%....%..........%....%%%%%%%%.....%%%%%%%%%%%%%%%%%%%%%%%%%%%%%..........%%..........%%%%%%%
m ...%.%%%%%.%%%.%..%%.......%%..%%%%...%%%........%%%...%%%%..%%.......%%..%.%%%.%%%%%.%...%.%%.%%.........%..%.........%%.%%.%
m ...........................%..........%%..........%%..........%......................................%%..%....%..%%...........
m ..........................%%%.........%%%........%%%.........%%%....................................%%%%%......%%%%%..........
m ...........................%...........%%........%%...........%.....................................%%%%%......%%%%%..........
m %%.%..%........%%..%.%.%%.%%....%%%...%%..........%%...%%%....%%.%%.%.%..%%........%..%.%%%.%.......%%%%%%....%%%%%%.......%.%
m %%%%%%%%%%.....%%%%%%%%%%%%%%....%....%%..........%%....%....%%%%%%%%%%%%%%.....%%%%%%%%%%%%%........%%%%%....%%%%%........%%%
m %%%%%%...%.....%%...%%%%.%%.%....%%...%............%...%%....%.%%.%%%%...%%.....%...%%%%%%...%......%.%%%......%%%.%......%...
m 7..%...........%%..7.............%%....................%%.............4..%%...........%..4....................................
m ...%%.........%%%...............%%......................%%...............%%%.........%%.......................................
m ...%%..........%%................%......................%................%%..........%%.......................................
m ..%%%........%%%%....%.%%.%%.....%%%..%.%........%.%..%%%.....%%.%%.%....%%%%........%%%...%%..%%.........%%%%.........%%..%%.
m ...%%%%%%%%%%%%%%%%%%%%%%%%%.....%%%%%%%..........%%%%%%%.....%%%%%%%%%%%%%%%%%%%%%%%%%.....%%%%%.........%%%%.........%%%%%..
m ...%%%.%%%%%....%%%%%%%.%..%%...%%.%%.%............%.%%.%%...%%..%.%%%%%%%....%%%%%.%%%.....%%%%...........%%...........%%%%..
m .........%......................................................................%...........%%%%....%.....%%%%.....%....%%%%..
m ........%%%....................................................................%%%.........%%%%%%....%%...%%%%...%%....%%%%%%.
m .........%......................................................................%..........%%...%....%.....%%.....%....%...%%.
