rows 66
cols 66
players 4
m ...%%%%.....%..........%%%..........%%.........%....%...%%.....%%.
m ..%%%%%....%%%.........%%.2.........%..........%%%%%%....%.....%..
m ....%%%%...%%%.%%%.%%.%%%%.%.%%.....%%....%%...%..%%%...%%%...%...
m .....%%.....%%%%%%%%%%%%%%%%%%%....%%%...%%.............%%........
m ...........%.%%..%..%%...%%...%....%.%.....%............%%........
m .........................................................%%.......
m ..%.%.............................................%.%%.%%%%....%%.
m ...%%..............................................%%%%%%%....%%..
m ...%%%.%%..%%....%.....%%%.%...%..%......%.%%%......%..%%.%...%%%.
m .....%%%%%%%%%....%%%%%%%%%%%%%%%%%%%%...%%%...................%%.
m .....%%%%.%%.%.....%%%..%..%.%%.%...%%....%%...................%..
m .....%%..................................%..%.................%%%.
m ..%%%%%............................................%%%..%.....%%%.
m %%%%%%%............................................%%%%%%%.....%%%
m %%%%%%%%.....%....%.%%%%.....%.%...%.%%............%%%%%%%....%%%%
m %%%%%%%%...%%.....%%%%%%%%....%....%%%.....%%...%..%%%%%%...%%%...
m %%%%%%%%...%%%...%%%%%%..%...%%.....%%%....%....%%%%%%%%.....%%...
m %%%%%%%%%%%%....%%%%%%%............%%.%...%.%.....%%%%.%....%.....
m .%%%%%%%%%%.....%%%%%%%...........................................
m .%%%%%...%%%.....%..%%%...........................................
m .%%......%%%.................%..%.................................
m %%%.......%...................%%....%%...%.%%.%..%..%%%.....%.%%.%
m %%%......%%...................%%%...%%%%%%%%%%%%%%%%%%%%....%%%%%%
m %.%%%....%%%...%.%%..%......%%%.%......%..%...%.%%%.....%....%%..%
m ...%%.....%%....%%%%%%%...........................................
m ...%.%...%%....%%%%.%%.%..........................................
m ...............%%.................................................
m ................%%............%.....%.%....%...%%...%%..%..%%.%...
m .%%.............%%.............%%...%%%....%%%%%%%%%%%%%%%%%%%....
m %%%%.......%...%%%...%%%..%...%%....%%.....%%.%.%%%%.%%.%%%.%%%...
m .%%%%%....%.....%....%%%%%%..........%.........3.%%.........%%%...
m .%%%%....%%.....%%...%....%.........%%..........%%%..........%....
m %%%%%%...%%....%%%..................%%%..........%%.........%%....
m %%%%%%...%%....%%..........%%%%.%....%....%%....%%%...%%%...%%%...
m %%%%%%....%.....%%.........%%%%%%...%%%....%%...%%%....%%....%....
m ....%%....%%....%%%%%%%.....%%......%......%%...%......%%...%.....
m ....%....%%%....%%%%%%%....%%.............%%%..........%..........
m ...%%.....%%...%%%.%.%%%...%%%.............%...........%..........
m ..........%....%%.0........................%%.........%%%.........
m .........%%%....%%...............%%%......%%%...%%.%%.............
m ..........%.....%................%%%%%.....%....%%%%%.........%...
m ...%.%...%%.....%%....%%%.%%.....%%%..%...%.....%.%%%.........%..%
m ...%%....%%....%%%...%%%%%%%%....%%%...............%%...%.%...%%%.
m .....%....%%.........%..%..%.%....%................%....%%.....%%.
m .........%%........................................%%....%....%%.%
m ..........%...........................%....%%%%...................
m ..........%%........................%%....%%%%%...................
m ..%.%%....%....%%...%.%......%...%.%%%%....%%%%...................
m ..%%%....%%.....%%%%%%%.....%.....%%%%%%.....%....%%.%%.%%%....%%.
m ...%%%...%%....%%%.%%.%%....%.....%%%%%%.....%.....%%%%%%%.....%%.
m ..%%.%.....................%%%%....%%%%.%...%......%.%...%%....%..
m ...........................%%%%%....%%........................%%..
m ...........................%%%%....%...........................%..
m ........%.%%....%....%%........................................%%.
m ..%......%%.....%%....%................%....%.%..%..%.........%%..
m ...%%....%%%...%.%...%%...............%%%....%%%%%%%%...%%%....%%.
m ..%.%...%..%.........%%%.%.....%...%..%%%.....%%.%%%....%%.....%%.
m ...........%.........%%%%%....%.....%%%%%................%.....%..
m .....................%%.%%...%%%......%%%...............%%....%%%.
m .................%%%.........%%........................1.%%....%..
m ...%%.............%...........%.............%%%...%%%.%.%%%...%%..
m ...%..............%..........%%%.............%%....%%%%%%%....%%%.
m ..%%.........%...%%......%...%%......%......%%.....%%%%%%%....%%..
m ..%%%%%%....%....%%....%%%...%%....%%%...%%%%%%.........%%.....%..
m ..%%%%%%...%%%...%%%...%%%....%%....%....%.%%%%..........%%....%%.
m ..%%%%%%....%%.........%%..........%%%..................%%%....%%.
