# map type: blank
# random seed: 957057411
# hill distance  41, 14  53,  2   5, 50  77, 62  65, 74  17, 38  29, 26
#        41, 14       0      24      72      72      48      48      24 
#        53,  2      24       0      72      48      24      72      48 
#         5, 50      72      72       0      24      48      24      48 
#        77, 62      72      48      24       0      24      48      72 
#        65, 74      48      24      48      24       0      72      72 
#        17, 38      48      72      24      48      72       0      24 
#        29, 26      24      48      48      72      72      24       0 
players 7
rows 84
cols 84
m .................%%...............................................%%................
m .................%%..............................................%%%................
m %%...%%....%%.%%%%%....%%....%...%%%%%%..%%%...%%.%.%.%%%%%..%....%%...%.%...%......
m %%....%%....%%%%%%%.....%%%%%%%%%%%%%%%%%%%.....%%%%%%%%%%%%%.....%%...%%%....%%...%
m %%..........%%%..%%%...%.%.%....%%%.%.%..%%......%%.%.%%%.%%%....%%%....%%.....%....
m %%.........%%%....................................3.....................%%.........%
m %%.........%%%..........................................................%%..........
m %%.........%%..........................................................%%%.........%
m %%....%.%%%%%%%%%%%%...%%....%%%....%%%%%.......%...........%....%.%..%%%%..%%%%...%
m %%...%%%%%%%%%%%%%%....%%%...%%%...%%%%%%%%%...%%%....%%....%%...%%%%%%%%%%%%%%....%
m .%....%%..%%%%.%.......%%....%..........%%%%...%.....%%%...%.....%%..%.%..%%%......%
m .....%%%.............................................%%.............................
m .....%%...............................................%%............................
m .....%%..............................................%%%............................
m %.%%%%%....%%....%...%%%%%%..%%%...%%.%.%.%%%%%..%....%%...%.%...%......%%...%%....%
m %%%%%%%.....%%%%%%%%%%%%%%%%%%%.....%%%%%%%%%%%%%.....%%...%%%....%%...%%%....%%....
m %%%..%%%...%.%.%....%%%.%.%..%%......%%.%.%%%.%%%....%%%....%%.....%....%%..........
m %%....................................0.....................%%.........%%%.........%
m %%..........................................................%%..........%%.........%
m %..........................................................%%%.........%%%.........%
m %%%%%%%%...%%....%%%....%%%%%.......%...........%....%.%..%%%%..%%%%...%%%....%.%%%%
m %%%%%%%....%%%...%%%...%%%%%%%%%...%%%....%%....%%...%%%%%%%%%%%%%%....%%%...%%%%%%%
m %%.%.......%%....%..........%%%%...%.....%%%...%.....%%..%.%..%%%......%.%....%%..%%
m .........................................%%..................................%%%....
m ..........................................%%.................................%%.....
m .........................................%%%.................................%%.....
m %....%...%%%%%%..%%%...%%.%.%.%%%%%..%....%%...%.%...%......%%...%%....%%.%%%%%....%
m %%%%%%%%%%%%%%%%%%%.....%%%%%%%%%%%%%.....%%...%%%....%%...%%%....%%....%%%%%%%.....
m .%.%....%%%.%.%..%%......%%.%.%%%.%%%....%%%....%%.....%....%%..........%%%..%%%...%
m ..........................4.....................%%.........%%%.........%%%..........
m ................................................%%..........%%.........%%%..........
m ...............................................%%%.........%%%.........%%...........
m %....%%%....%%%%%.......%...........%....%.%..%%%%..%%%%...%%%....%.%%%%%%%%%%%%...%
m %%...%%%...%%%%%%%%%...%%%....%%....%%...%%%%%%%%%%%%%%....%%%...%%%%%%%%%%%%%%....%
m %....%..........%%%%...%.....%%%...%.....%%..%.%..%%%......%.%....%%..%%%%.%.......%
m .............................%%..................................%%%................
m ..............................%%.................................%%.................
m .............................%%%.................................%%.................
m %%%..%%%...%%.%.%.%%%%%..%....%%...%.%...%......%%...%%....%%.%%%%%....%%....%...%%%
m %%%%%%%.....%%%%%%%%%%%%%.....%%...%%%....%%...%%%....%%....%%%%%%%.....%%%%%%%%%%%%
m %.%..%%......%%.%.%%%.%%%....%%%....%%.....%....%%..........%%%..%%%...%.%.%....%%%.
m ..............1.....................%%.........%%%.........%%%......................
m ....................................%%..........%%.........%%%......................
m ...................................%%%.........%%%.........%%.......................
m %%%%%.......%...........%....%.%..%%%%..%%%%...%%%....%.%%%%%%%%%%%%...%%....%%%....
m %%%%%%%%...%%%....%%....%%...%%%%%%%%%%%%%%....%%%...%%%%%%%%%%%%%%....%%%...%%%...%
m ....%%%%...%.....%%%...%.....%%..%.%..%%%......%.%....%%..%%%%.%.......%%....%......
m .................%%..................................%%%............................
m ..................%%.................................%%.............................
m .................%%%.................................%%.............................
m %.%.%.%%%%%..%....%%...%.%...%......%%...%%....%%.%%%%%....%%....%...%%%%%%..%%%...%
m %%%%%%%%%%%%%.....%%...%%%....%%...%%%....%%....%%%%%%%.....%%%%%%%%%%%%%%%%%%%.....
m .%%.%.%%%.%%%....%%%....%%.....%....%%..........%%%..%%%...%.%.%....%%%.%.%..%%.....
m ..5.....................%%.........%%%.........%%%..................................
m ........................%%..........%%.........%%%..................................
m .......................%%%.........%%%.........%%...................................
m %...........%....%.%..%%%%..%%%%...%%%....%.%%%%%%%%%%%%...%%....%%%....%%%%%.......
m %%....%%....%%...%%%%%%%%%%%%%%....%%%...%%%%%%%%%%%%%%....%%%...%%%...%%%%%%%%%...%
m .....%%%...%.....%%..%.%..%%%......%.%....%%..%%%%.%.......%%....%..........%%%%...%
m .....%%..................................%%%........................................
m ......%%.................................%%.........................................
m .....%%%.................................%%.........................................
m .%....%%...%.%...%......%%...%%....%%.%%%%%....%%....%...%%%%%%..%%%...%%.%.%.%%%%%.
m %.....%%...%%%....%%...%%%....%%....%%%%%%%.....%%%%%%%%%%%%%%%%%%%.....%%%%%%%%%%%%
m %....%%%....%%.....%....%%..........%%%..%%%...%.%.%....%%%.%.%..%%......%%.%.%%%.%%
m ............%%.........%%%.........%%%....................................2.........
m ............%%..........%%.........%%%..............................................
m ...........%%%.........%%%.........%%...............................................
m %....%.%..%%%%..%%%%...%%%....%.%%%%%%%%%%%%...%%....%%%....%%%%%.......%...........
m %%...%%%%%%%%%%%%%%....%%%...%%%%%%%%%%%%%%....%%%...%%%...%%%%%%%%%...%%%....%%....
m .....%%..%.%..%%%......%.%....%%..%%%%.%.......%%....%..........%%%%...%.....%%%...%
m .............................%%%.............................................%%.....
m .............................%%...............................................%%....
m .............................%%..............................................%%%....
m .%...%......%%...%%....%%.%%%%%....%%....%...%%%%%%..%%%...%%.%.%.%%%%%..%....%%...%
m %%....%%...%%%....%%....%%%%%%%.....%%%%%%%%%%%%%%%%%%%.....%%%%%%%%%%%%%.....%%...%
m %%.....%....%%..........%%%..%%%...%.%.%....%%%.%.%..%%......%%.%.%%%.%%%....%%%....
m %%.........%%%.........%%%....................................6.....................
m %%..........%%.........%%%..........................................................
m %%.........%%%.........%%..........................................................%
m %%..%%%%...%%%....%.%%%%%%%%%%%%...%%....%%%....%%%%%.......%...........%....%.%..%%
m %%%%%%%....%%%...%%%%%%%%%%%%%%....%%%...%%%...%%%%%%%%%...%%%....%%....%%...%%%%%%%
m ..%%%......%.%....%%..%%%%.%.......%%....%..........%%%%...%.....%%%...%.....%%..%.%
m .................%%%.............................................%%.................
