# map type: blank
# random seed: 30492310
# hill distance  52, 55  18, 22  28, 48  45, 79  97, 24  21, 72  99, 82  76, 20  78, 45  55,  1  80,103 101,  3
#        52, 55       0      67      31      31      92      62      98      81      48      79      92     101 
#        18, 22      67       0      48      98      45      79      79      56      79      88      65      56 
#        28, 48      31      48       0      62      81      31      67      92      79      98     101      92 
#        45, 79      31      98      62       0     101      31      79      92      67      48      81      92 
#        97, 24      92      45      81     101       0      92      56      33      56      65      42      33 
#        21, 72      62      79      31      31      92       0      48     101      98      67      92      81 
#        99, 82      98      79      67      79      56      48       0      65      88      79      56      45 
#        76, 20      81      56      92      92      33     101      65       0      45      56      33      42 
#        78, 45      48      79      79      67      56      98      88      45       0      79      56      65 
#        55,  1      79      88      98      48      65      67      79      56      79       0      45      56 
#        80,103      92      65     101      81      42      92      56      33      56      45       0      33 
#       101,  3     101      56      92      92      33      81      45      42      65      56      33       0 
players 4
rows 104
cols 104
m ....%%%%%%%%%%....%%%%%%%%%%%%%%%%%%%%%%%%%%%....%%%%%%.....%%%....%%%%....%%%.....%%%......%%.....%%%..
m ...%%%%%%%%%%......%%%%%%%%%..%%%.......%%%%%.....%%%%%.....%%......%%......%%%....%%%.....%%%......%%..
m ...%%%.%%%%%%.............................%%%....%%%%%.....%%%%....%%%%....%.......%%.%.....%%%.....%%%.
m .......%%%%%%..............................%%%%%%%%%%%......%%.....%%%%....................%%%%....%%%..
m .......%%%%%%.............................%%%%%%%%%%%%%.....%%%....%%%.....................%%%%....%%%%.
m .......%%%%%%.............................%%%%%%%%%%%%%.....%%......%%%....................%%%.....%%%..
m .......%%%%%%%..%%%%%.....%..%%%.%........%%%%%%%%%%%%%....%%%%....%%%%.....................%%%.....%%..
m %%%%%%%%%%%%%%%%%%%%%%....%%%%%%%%%%%%.....%%%%%%%%%%%......%%.....%%%.....%...%%....%.%%%.%%%......%%%.
m %%%%%%%%%%%%%%%%%%%%%......%%%%%%%%%%%.....%%%%%%%%%%%%.....%%......%%.....%%%%%%%%%%%%%%%%%%%......%%%%
m %%%%%%%.%.%%%%.%..%%.%......%.%%%.%%%.......%%%%%%%%%%......%%%....%%%......%%%%%%%%%%%%%%%%%%......%%%%
m %%%%%%.....%%......................%%.............%%..%....%.%.......%%....%%%%%..%%%..%%%..%%......%%%%
m %%%%%%.....%%%....................%%%%......................................%%......................%%%%
m %%%%%%.....%%.....................%%%%......................................%%%.....................%%%%
m %%%%%......%%%....................%%%%............%.........................%%.....................%%%%%
m %%%%%.....%%%%......%.....%..%.....%%.....%%%..%%%%.........................%%.....................%%%%%
m %%%%%%.....%%%.....%%......%%.....%%%.....%%%%%%%%%%%%%.%%%.%%......%.%.%.%%%%......%%%.......%%%.%%%%%%
m %%%%%%....%%%......%%%.....%%%.....%%%....%%%%%%%%%%%%%%%%%%%%.....%%%%%%%%%%%.....%%%%.....%%%%%%%%%%%%
m .%%%%%....%%%%.....%%%....%%%%.....%%%.....%%%%.%%.%%.%...%%%%.....%%%%%%%%%%%.....%%%%....%%%%%%%%%%%.%
m ...........%%......%%%0............%%%...............................%.%.%...%%....%%%.....%%%%%%%......
m ...........%%.....%%%..............%%..............................................%%%.....%%%%%%%......
m ...........%%......%%.............%%%...............................................%%%....%%%%%%%......
m ...........%%......%%.............%%%%..................................2..........%%%%....%%%%%%%......
m %%%..%....%%%......%%%.%%.%.%......%%%.%.....%.......%.............................%%%%....%%%%%%%%.%%%.
m %%%%%......%%%.....%%%%%%%%%%......%%%%%%%%%%%.....%%%....%%%%%%.%.%%%.%.%..........%%%%..%%%%%%%%%%%%%%
m %%%%%%....%%%%.....%%%%%%%%%%......%%%%%%%%%%......%%......%%%%%%%%%%%%%%%%%%%.....%%%....%%%%%%%%%%%%%%
m %%%%%.............%%...%%%%%.%....%%.%....%%%......%%.......%.%%%%%%%%%%%%%%%%.....%%%.....%%%%%%%%%%%%%
m %%%%%.....................................%%%......%%.........%%...%..%.%....%%.....%%.....%%%%%%%%%%%%%
m .%%%%%.....................................%%%....%%%.........%....................%%%....%.%.%%%..%%.%%
m ..%%%.....................................%%%...1..%%%........%.....................%...................
m ..%%%......................................%%%....%%%.........%.....................%%..................
m ...%%%%..%%%..%%.%...%%%%.%%.%%.%%...%....%%%......%%%.....%.%......................%%..................
m ..%%%%%%%%%%%%%%%%%%%%%%%%%%%%%%%%%%%%.....%%%....%%%......%%%%%%..%%........%.....%%%..................
m ...%%%%%%%%%%%%%%%%%%%%%%%%%%%%%%%%%%.....%%%.....%%%.....%%%%%%%%%%%%%.....%%.....%%.....%...%...%..%..
m ...%%%%%%%%%%%%%.%%%%...%..%.%%%.%%.%......%%.....%%%%....%%%%%%%%%%%%.....%%%.....%%%.....%%%%%%%%%%...
m ..%%%%%%%%%%%......................................%%......%%%%%%%%%%%%.....%%.....%%%....%%%%%%%%%%%%..
m ..%%.%%...%%%%....................................%%%......%%%%%%%%%%%.%%%%%%%.............%..%.%.%.%%..
m ...........%%%.....................................%%.....%%%%%%%%%%%%....%%%%..........................
m ..........%%%.....................................%%%%....%%%%%%%%%%%%.....%%...........................
m ..........%%%%...%%.%%....%%.%.%.%..%.............%%%%%%%.%%%%%%%%%%%......%%%..........................
m ...........%%%%%%%%%%%....%%%%%%%%%%%%....%%%.....%%.....%%%%%%%%%%%%......%%...........................
m ...%%%%.%%%%%%%%%%%%%......%%%%%%%%%%.....%%%.....%%%.....%%%%%%%%%%%%....%%%%.....%%......%.%%.%%%.%..%
m %%%%%%%%%%%%%%%%%%%%%.....%..%...%...%.....%%.....%%.....%%%%%%%%%%%%%.....%%%.....%%%.....%%%%%%%%%%%%%
m %%%%%%%%%%%%%%%%%%%%%%....................%%%.....%........%%..%%%%%%......%%%....%%%.....%%%%%%%%%%%%%%
m %%%...%.%%..%%%..%%%%.....................%%......................%.%.....%%%......%%%....%...%%.%%.%%.%
m ...................%%%....................%%.....................%.........%%%....%%%...................
m ...................%%%.....................%.....................%........%%%..0...%%%..................
m ..................%%%%%.%%.%%..%%%.%.%....%%%....................%.........%%%....%%%...................
m ...................%%%%%%%%%%%%%%%%%%.....%%.....%%....%.%..%...%%.........%%......%%%..................
m %...%%.............%%%%%%%%%%%%%%%%%%.....%%%.....%%%%%%%%%%%%%%%%.%.......%%......%%%....%.%%....%.%%%%
m %%%%%.....%%%%....%%%%%%%%%%%%%%%%%%%%....%%%.....%%%%%%%%%%%%%%%%%%%......%%......%%%%%%%%%%......%%%%%
m %%%%%.....%%%......%%%%%%%%%%%%%%%%%%%..%%%%..........%.%.%%%.%.%%%%%%....%%%.....%%%%%%%%%%%......%%%%%
m %.%%%......%%%....%..%%%.%%%.%%%%%%%%....%%%%.............................%.......%.....%.%%%......%.%.%
m ...%%......%%.................%%%%%%%....%%%%..........3..................................%%%%..........
m ...%%......%%.................%%%%%%%....%%%...............................................%%%..........
m ...%%%.....%%.................%%%%%%%.....%%%..............................................%%...........
m .1%%%......%%.................%%%%%%%.....%%%....%%...%.%.%...............................%%%...........
m ..%%%.....%%%%....%%%%%.%.%%%%%%%%%%%....%%%%.....%%%%%%%%%%%.....%%%%...%.%%.%%.%%%%.....%%%.....%%%%..
m ..%%%......%%%....%%%%%%%%%%%%%%%%%%.....%%%%.....%%%%%%%%%%%.....%%%%%%%%%%%%%%%%%%%%....%%%.....%%%...
m ...%%.....%%%.....%%%%%%%%%%%%.%%%.......%%%......%%%%.%.%.%......%%.%%%.%%%%%%%%%%%%%.....%%%.....%%...
m ...%......%%%%.....%%%%%%%%%%.....................%%.........................%%%%..%%%.....%%.....%..%..
m ..........%%%......%%%%%%%%%%.....................%%.........................%............%%%%..........
m ...........%%.....%%%%%%%%%%.....................%%%......................................%%%%..........
m ..........%%%.....%%%%%%%%%%......................%%......................................%%%%..........
m ...........%%.....%%%%%%%%%%......%%..%%%..%%%..%%%%%....%%.......%.%....%..%%.............%%...........
m ..%.%%..%.%%%%.%.%%%%%%%%%%%......%%%%%%%%%%%%%%%%%%......%%%....%%%......%%%%%%%%%%.......%%%.%%%.%....
m ...%%%%%%%%%%%%%%%%%%%%%%%%%......%%%%%%%%%%%%%%%%%%%.....%%......%%.....%%%%%%%%%%%%.....%%%%%%%%%%%...
m ..%%%%%%%%%%%%%%%%%%%%%%.%%%......%%%.%%%.%....%%...%.....%%%.....%%......%%%%%%%%%%%.....%%%%%%%%%%%%..
m ...%%%%%..%%%%%%%.........%%.....%%%.....................%%%%....%%%%....%%%%%%%%%%%%%........%.%%%..%..
m ...........%%%%%%.........%%%.....%%%....................%%%......%%.....%%%%%%%%%%%%%..................
m ...........%%%%%%........%%%%....%%%%.....................%%%....%%%.....%%%%%%%%%%%%%..................
m ...........%%%%%%.........%%%....%%%%....................%%%%.....%%......%%%%%%%%%%%...................
m ...........%%%%%%.%%%....%%%.....%%%.....%.%%.......%....%%%%....%%%%.....%%%%%....%%%..................
m %%%%%......%%%%%%%%%%.....%%......%%%.....%%%....%%%......%%......%%.....%%%%%.....%%%%%.......%%%..%%%%
m %%%%%%....%%%%%%%%%%......%%%.....%%......%%%.....%%%....%%%%....%%%.....%%%%%%....%%%%%%%%%%%%%%%%%%%%%
m %%%%%.....%%%%%%%%.%%.....%%%....%%......%..%....%%%%....%%%.....%%.%.....%%%%%....%%%%%%%%%%%%%%%%%%%%%
m .%%%%%....%%%.............%%%.....................%%%.....%%.............%%%%%%.....%%%%%%%%%%..%.%....%
m ..%%%......%%.......2....%%%%....................%%%%....%%%%............%%%%%.....%%%%%%%%%%...........
m ..%%%......%%.............%%%....................%%%%....%%%..............%%%%%.....%%%%%%%%%%..........
m ...%%.....%%%............%%%%................2....%%.....%%%.............%%%%%%....%%%%%%%%%%%..........
m ...%%%....%%%......%...%%%%%%.....%.%......%%%...%%%.....%%%.....%%..%.%%%%%%%%....%%%%%%%%%%%..........
m ...%%......%%....%%%%%%%%%%%%....%%%.....%%%%%%%%%%%......%%%....%%%%%%%%%%%%%.....%%%%%%%%%%%....%%.%.1
m ..%%%......%%....%%%%%%%%%%%%....%%%%.....%%%%%%%%%%%.....%%%.....%%%%%%%%%%%%.....%%%%%%%%%%%....%%%%..
m ...%%%.....%%....%%..%...%.%.....%%%%.........%.....%.....%%%....%%%%%%..%..%.%....%%%..%%%%%%....%%%...
m ...%%%....%%%....................%%%.....................%%%%....%%%%%%....................%%%.....%%%..
m .................................%%%......................%%......%%%%......................%%%%%%%%%%..
m ..................................%%%....................%%%%.....%%%%.....................%%%%%%%%%%%..
m ..................................%%.....................%%%%.....%%%%%.....................%%%%%%%%%%..
m .................%...%%..%%%.....%%%%.%.%%%.%.....%%......%%%.%%.%%%%%%.....%.%....%%.%....%%%%%%%%%%%..
m %%%%%%%....%%....%%%%%%%%%%%%%%%%%%%%%%%%%%%%%%%%%%%......%%%%%%%%%%%%%.....%%%%%%%%%%%%%%%%%%%%%%%%%%%%
m %%%%%%%....%%....%%%%%%%%%%%%%%%%%%%%%%%%%%%%%%%%%%%.....%%%%%%%%%%%%%......%%%%%%%%%%%%%%%%%%%%%%%%%%%%
m .%%...%...................%%%%%%%%%%%....%.%%....%.%.....%%%%%%.%%.%%%......%%.....%.%%%.%.%%%%.....%%%.
m ..........................%%%%%%%%%%.....................%%%%%.....%%%%.....................%%..........
m ..........................%%%%%%%%%%%.....................%%%%.....%%%%....................%%%..........
m ..........................%%%%%%%%%%......................%%%%......%%......................%%%.........
m ...........%%%....%%%.....%%%.....%%%....................%%%%%%....%%%%.....................%%%.........
m ..%..%%....%%.....%%%......%%%....%%%%%%..%%%....%.%..%..%%%%%%....%%%.....%.....%.........%%%%.....%.%.
m %%%%%%%....%%......%%%....%%%%....%%%%%%%%%%%.....%%%%%%%%%%%%.....%%%.....%%%%%%%%%%%.....%%%%....%%%%%
m %%%%%%%....%%......%%...0.%.%%....%%%%%%%%%%%.....%%%%%%%%%%%%%....%%%......%%%%%%%%%%%.....%%%....%%%%%
m %...%......%%%....%%%.............%%%%%%%%%%%....%%%%%%%%.%..%%.....%%%.....%%%...%%%......%.%.....%%%%%
m ...........%%%.....%%.............%%%%%%%%%%%....%%%%%%.............%%%.....%%....3................%%%%.
m ...........%%......%%%............%%%%%%%%%%.....%%%%%..............%%%....%%%%....................%%%..
m ...3.......%%......%%%.............%%%%%%%%%%.....%%%%%............%%%%....%%%%....................%%%%.
m ...........%%%....%%%%%.%....%.%..%%%%%%%%%%.....%%%%%%.............%%.....%%%.....................%%%..
m ...%%.%%%%%%%%.....%%%%%%%%%%%%%%%%%%%%%%%%%%....%%%%%.....%.%%.....%%%....%%%%....%..%......%%....%%%..
