# map type: blank
# random seed: -1746923141
# hill distance  42, 94  34, 83  52, 35  13, 68  56, 80  11, 23  45, 72  30, 51  93, 90  81, 49
#        42, 94       0      19      93      55      28      56      39      75      65      84 
#        34, 83      19       0     104      36      39      59      50      86      68      83 
#        52, 35      93     104       0      90      65      75      68      74     118      43 
#        13, 68      55      36      90       0      75      65      86      78      74      47 
#        56, 80      28      39      65      75       0      84      19      55      93      56 
#        11, 23      56      59      75      65      84       0      83      47      43      52 
#        45, 72      39      50      68      86      19      83       0      36     104      59 
#        30, 51      75      86      74      78      55      47      36       0      90      65 
#        93, 90      65      68     118      74      93      43     104      90       0      75 
#        81, 49      84      83      43      47      56      52      59      65      75       0 
players 2
rows 96
cols 96
m %%%%%%......%%%%%%..................%%%%%%%%%%%......%..................%%%%%........%%%%.......
m .%%%%........%%%%%..................%%%%%%%%%%%......%...................%%%%.......%%%%%.......
m .%%%%.......%%%%%...................%%%%%%%%%%.......%...................%%%%%......%%%%%%......
m %%%%%........%%%%.......%.%.%%.%%%%%%%%%%%%%%%.......%.......%%.........%%%%%........%%%%.......
m %%%%%%.......%%%%.......%%%%%%%%%%%%%%%%%%%%%%%.............%%%%%%......%%%%%%.......%%%%%......
m %%%%%%.......%%%%%......%%%%%%%%%%%%%%%%%%%%%%%..............%%%%........%%%%........%%%%%......
m .%%%%........%%%%%......%%%%%%%%%%%%%%%%%%%%%%%......%.......%%%%.......%%%%%%......%%%%%%......
m %%%%%........%%%%%......%%%%%%%%%%%%%%%%%%%%%%%......%.......%%%%........%%%%%......%%%%%.......
m %%%.%..........%.%......%%.%..%%%%%%..%%..%%%%%......%.......%%%%%.......%%%%%..................
m ............................................................%%%%%........%%%%...................
m .............................................................%%%%%......%%%%%%..................
m .......................1....................................%%%%%%......%%%%%%..................
m ............................................................%%%%%.......%%%%%...................
m ............................................................%%%%%...0...%%%%%...................
m .............................................................%%%%.......%%%%%%..................
m ..%.%%......%.%.%.......%............%%%%%..%%%......%..%.%.%%%%%.......%%%%%%...%%.%%..%%%.%.%.
m %%%%%........%%%%%.......%%%%%%%%%....................%%%%%%%%%%%%.......%%%%%%%%%%%%%%%%%%%%%%%
m %%%%%........%%%%%......%%%%%%%%%%....................%%%%%%%%%%%.......%%%%%%%%%%%%%%%%%%%%%%%%
m %%%%%%......%%%%%%.......%%%%%%%%%%..................%%%%%%%%%%%%.......%%%%%%%%%%%%%%%%%%%%%%%%
m %%%%%%......%%%%%%......%%%%%%%%%%%...................%%%%%%%%%%%........%%%%%%%%%%%%%%%%%%%%%%%
m %%%%%%......%%%%%%......%%%%%%%%%%%..................%%%%%%%%%%%%.......%.%..%%%.%....%.%%%%%...
m %%%%%%.......%%%%%......%%%%%%%%%%%...................%%%%%%%%%%%...............................
m .%%%%%.......%%%%%......%%%%%%%%%%........%....%.%%%.%%%%%%%%%%%%%..............................
m %%%%%%......%%%%%........%%%%%%%%%.......%%%%%%%%%%%%%%%%%%%%%%%%...............................
m .%%%%.......%%%%%.......%%%%%%%%%%%......%%%%%%%%%%%%%%%%%%%%%%%%%..............................
m %%%%%.......%%%%%%......%%%%%%%%%%........%%%%%%%%%%%%%%%%%%%%%%%...............................
m .%%%%%......%%%%%%......%%%%%%%%%%........%%%%%%%%%%%%%%%%%%%%%%%...............................
m .%%%%%.......%%%%%.%%%%..%........%.......%...%.%%....%.....%.%..%.%.%.%..%.........%%%.%%......
m .%%%%.......%%%%%%%%%%............................................%%%%%%%%%%%%.......%%%%.......
m %%%%%.......%%%%%%%%%%%..........................................%%%%%%%%%%%%........%%%%.......
m .%%%%%......%%%%%%%%%%%............................1..............%%%%%%%%%%%........%%%%.......
m .%%%%%.......%%%%%%%%%...........................................%%%%%%%%%%%%%.......%%%%%......
m %%%.%%.........%%%%%%%............................................%%%%%%%%%%%%.......%..%.......
m ..................%%%%...........................................%%%%%%%%%%%%...................
m ..................%%%%%..........%.%%%%..%%.%...%%%%%%.%%.%.......%%%%%%%%%%%......0............
m ..................%%%%%......%%%%%%%%%%%%%%%%%%%%%%%%%%%%%........%%%%%%%%%%%...................
m ..................%%%%.......%%%%%%%%%%%%%%%%%%%%%%%%%%%%%%......%%%%%%%%%%%%...................
m ..................%%%%........%%%%%%%%%%%%%%%%%%%%%%%%%%%%........%%%%%%%%%%%...................
m ..................%%%%%.......%%%%%%%%%%%%%%%%%%%%%%%%%%%%........%%%%%%%%%%%%..................
m %.%%%%.%.%..%.%%%%%%%%%.......%%.%%%.%..%.%.%%%.%%..%%%%%%%.......%..%%.....%%.%%..%%...........
m %%%%%%%%%%.......%%%%%%...............................%%%%%...................%%%%%%%%%%%.......
m %%%%%%%%%%.......%%%%%................................%%%%%..................%%%%%%%%%%%%.......
m .%%%%%%%%%%.......%%%%%...............................%%%%...................%%%%%%%%%%%%%....0.
m .%%%%%%%%%%.......%%%%...............................%%%%%%...................%%%%%%%%%%%.......
m %%%%%%%%%%.......%%%%%...............................%%%%%....................%%%%%%%%%%........
m %%%%%%%%%%........%%%%................................%%%%..............1....%%%%%%%............
m .%%%%%%%%%........%%%%%......%%%%%..%..%%...%%.......%%%%%.......%...........%%%%%%.............
m %%%%%%%%%%%......%%%%%%.......%%%%%%%%%%%%%%%%.......%%%%%.......%%%%%%.......%%%%%.............
m .%%%%%%%%%%.......%%%%........%%%%%%%%%%%%%%%%........%%%%%......%%%%%........%%%%%.............
m %%%%%%%%%%.......%%%%%%......%%%%%%%%%%%%%%%%%........%%%%........%%%%........%%%%%.............
m .%%%%%%%%%%.......%%%%%.......%%%%%%%%%%%%%%%%.......%%%%%%......%%%%%%.......%%%%..............
m .....%.%%%%......%%%%%%......%%%%%%%%...%.%%%........%%%%%%......%...%..........%........%......
m .................%%%%%........%%%%%0.................%%%%%%.....................................
m .................%%%%%%.......%%%%....................%%%%%.....................................
m .................%%%%%%......%%%%%...................%%%%%%.....................................
m .................%%%%%.......%%%%%....................%%%%......................................
m .................%%%%%........%%%%%..................%%%%%......................1...............
m .................%%%%%%.......%%%%%...................%%%%......................................
m %%%%%%%%..%.......%%%%........%%%%%.%.%..%%%.%%.......%%%%%%.%.%...%..%......%%%..%%.%.%........
m %%%%%%%%%%%.......%%%%%.......%%%%%%%%%%%%%%%%%.......%%%%%%%%%%%%%%%%%.......%%%%%%%%%%%.......
m %%%%%%%%%%........%%%%........%%%%%%%%%%%%%%%%%......%%%%%%%%%%%%%%%%%%......%%%%%%%%%%%%.......
m %%%%%%%%%%........%%%%........%%%%%%%%%%%%%%%%........%%%%%%%%%%%%%%%%.......%%%%%%%%%%%%.......
m %%%%%%%%%%%.......%%%%%......%%%%%%%%%%%%%%%%%%......%%%%%%%%%%%%%%%%%%......%%%%%%%%%%%%.......
m %%%%%%%%%%%......%%%%%.......%%..%..%%%...%%.........%..%%%%%%..%%..%%%......%%%%%%%%%%%%%......
m %%%%%%%%%%%......%%%%%%.......................................................%%%%%%%%%%%.......
m %%%%%%%%%%%......%%%%%%......................................................%%%%%%%%%%%%%......
m .%%%%%%%%%%......%%%%%%.......................................................%%%%%%%%%%%%......
m .%%%%%%%%%%......%%%%%.......................................................%%%%%%%%%%%%%......
m %%..%%%%%%%......%%%%%%.........................................................%%...%%.%%......
m ..................%%%%..........................................................................
m ............%%%%%%%%%%%....%.%%%%..%%%%.%............%..%%%..%%%%.%%%........%..................
m ............%%%%%%%%%%%%%%%%%%%%%%%%%%%%%%%%%%........%%%%%%%%%%%%%%%%..........................
m ............%%%%%%%%%%%%%%%%%%%%%%%%%%%%%%%%%%.......%%%%%%%%%%%%%%%%%.......%..................
m ............%%%%%%%%%%%%%%%%%%%%%%%%%%%%%%%%%%%.......%%%%%%%%%%%%%%%%%......%..................
m ............%%%%%%%%%%%%%%%%%%%%%%%%%%%%%%%%%%.......%%%%%%%%%%%%%%%%%%......%..................
m .....%%%%%%.%%%%%%%%%%%..%...%%%%%...%%%...%%%%.......%%%%%%%..%%%%%%%%......%%%..%..%.%.%%%%%%%
m %%%%%%%%%%%%%%%%%%%%%%%...........................................%%%%%%%%%%%%%%%%%%%%%%%%%%%%%%
m %%%%%%%%%%%%%%%%%%%%%%%..........................................%%%%%%%%%%%%%%%%%%%%%%%%%%%%%%%
m %%%%%%%%%%%%%%%%%%%%%%%..........................................%%%%%%%%%%%%%%%%%%%%%%%%%%%%%%%
m %%%%%%%%%%%%%%%%%%%%%%%..........................................%%%%%%%%%%%%%%%%%%%%%%%%%%%%%%%
m .%..%.%%%.%.%%%%%%%%%%%..........................................%.%%...%%..%%%.%...%%.%%%.%%..%
m .............%%%%................................0..............................................
m .............%%%%.......%%%%%..%%.%......%%%%%%......%.%.%%%%.%%%...............................
m .............%%%%%......%%%%%%%%%%%.......%%%%%.......%%%%%%%%%%%%..............................
m .............%%%%.......%%%%%%%%%%.......%%%%%........%%%%%%%%%%%...............................
m ............%%%%%.......%%%%%%%%%%........%%%%%.......%%%%%%%%%%%...............................
m .............%%%%.......%%%%%%%%%%.......%%%%%........%%%%%%%%%%%...............................
m ....%%......%%%%%%.......%%%%%%%%%%......%%%%%........%%%%%%%%%%%........%%.........%..%.%..%%..
m %%%%%%......%%%%%%.......%%%%%%%%%%.......%%%%%.......%%%%%%%%%%%........%%%%%......%%%%%%%%%%%%
m %%%%%.......%%%%%%......%%%%%%%%%%%......%%%%%%.......%%%%%%%%%%%........%%%%%......%%%%%%%%%%%%
m %%%%%.......%%%%%%......%%%%%%%%%%%......%%%%%%.......%%%%%%%%%%%........%%%%.......%%%%%%%%%%%%
m %%%%%%.......%%%%%.......%%%%%%%%%%......%%%%%%.......%%%%%%%%%%%.......%%%%%%......%%%%%%%%%%%%
m %%%%%........%%%%.......%%...%%%%%%......%%%%%%.........%%%%..%..%.......%%%%%.......%%%%%%...%%
m .%%%%.......%%%%%........................%%%%%%.........................%%%%%%.......%%%%%1.....
m %%%%%%......%%%%%...................%%%%%%%%%%..........................%%%%%.......%%%%%%......
m .%%%%%......%%%%%%..................%%%%%%%%%%.......%..................%%%%%%.......%%%%.......
