# map type: blank
# random seed: -1309945439
# hill distance  78, 27  61,103 109,110  41, 42  48, 90  58, 80  71, 93  10, 73
#        78, 27       0     101      94     122     127     127     109      92 
#        61,103     101       0     109     127      26      34      20     127 
#       109,110      94     109       0      92     127     127     101     122 
#        41, 42     122     127      92       0     109     101     127      94 
#        48, 90     127      26     127     109       0      20      34     101 
#        58, 80     127      34     127     101      20       0      26     109 
#        71, 93     109      20     101     127      34      26       0     127 
#        10, 73      92     127     122      94     101     109     127       0 
players 4
rows 114
cols 114
m %%...........%....................%%%%%...........................%%..............................................
m .%%.........%%...................%%%%%%............................%..............................................
m %%%%%%%.....%%%%%%.%...%%.%%..%.%%%%%%%%%%%%%%%%%%%%%%%%%%....%%%%%%%%%%%%%%%%%%%%%%%%%%%%%%%%%%%%%%.%.%.%%%.%.%%%
m %%%%%%%%....%%%%%%%%%%%%%%%%%%%%%%%%%%.%..%%.%%...%.%%%%%%.....%%%%%%%%%%.%.%%%.%.%.%%%%%%%%%%%%%%%%%%%%%%%%%%%%%%
m ..%............................%%%%%%...................%%.........%%.............................................
m ..%%...........................%%%%%....................%...........%%............................................
m .%%............................%%%%....................%%%.........%%%............................................
m .%%%.%.%%..%...%.%%.%.....%%.%....%%...%...%%....%%....%%....%%%...%%.......%.%%%.%...%.%%%%%%%%.%......%....%.%..
m ..%%%%%%%%%%%%%%%%%%%.....%%%%%...%.....%%%%%%...%%%....%.....%%...%%.....%%%%%%%%%%%%%%%%%%%%%%%%%%...%%.....%...
m ...%%.%.%..%%%%%.%.%.....%%%%%....%.....%%%%%....%%%...%%%....%%...%.%....%%%....%%..%%%.....%.%.%%%...%%....%%...
m .............%%%.........%%%%%%...%%....%%%%%.....%..........%%%.........1%...........%..........%%..........%%...
m ..............%...........%%%%%...%%...%%%%%%%....%%..........%%.........%%%..........%..........%%..........%%%..
m ..............%..........%.%%.....%....%%%%%%%....%%.........%%...........%...........%...........%..........%%%..
m %%%%%%%%......%%...%....%.........%%....%..%%%..%%%%...%.....%%%.%..%%%%.%%....%......%......%....%%%.%%%%...%%%..
m %%%%%%%%%.....%%....%%%%..........%%..........%%%%%.....%%%%%%%%%%%%%%%%%%%%....%%...%%%....%.....%%%%%%%.....%%%%
m %%..%%.%.....%%%...%%%%%..........%...........%%%%%%......%..%%%%.%..%.%%%%%....%......%....%%...%.%%%.%%%...%%%.%
m ...................%%%%%..........%..........%%%%%%..........%%%..........%%...%%%..........%%..........%%....%...
m ....................%%%%.....%%...%....%%%...%%%%%%..........%%...........%%...%%%..........%%..........%....%%%..
m ...................%.%%.%...%%....%%...%%%%%%%%%%%%..........%%%.........%%.....%%.........%%%..........%%....%...
m %......%.%%.%%..%............%%...%.....%%.%%%.%...%%.%......%%%.%.%%%....%%...%%%%.%%...%%%%%...%%%...%%.....%%.%
m %%%.....%%%%%%%%%%..........%%%...%%...............%%%%%%....%%%%%%%%%...%%%...%%%%%%%%%%%%%%%%%%%%....%%%...%%%%%
m .%%....%.%%%%%%%%%%..........%....%%................%%%%%....%..%%%.%.....%%....%%%%%%%%%..%%...%%%%....%.......%%
m ..%%.........%%%%%....%%%..%%%%...%%...............%%%%%%%................%.....%%....%%..........%.....%%........
m ..%..........%%%%%....%%%%%%%%....%%..%%.%...%......%%%%%%................%%....%%...%%%..........%%....%.........
m ..%%..........%%%%%...%....%%%....%%%%%%%%....%.....%%%%%%...............%%%....%%....%%..........%%....%.........
m ..%%...%.%%%....%%%.........%%....%%%.%..%....%.......%%%%......%%%.%.....%.....%%....%%....%%....%.....%%.%...%..
m ..%%...%%%%%%...%%..........%%%...............%%..........%%%%%%%%%%%%....%%...%%%....%.....%%...%%%...%%%%%%%%%..
m .%%%......%%%...%%%..........%................%...........%%%%%%...%.....%%%....%....%%....%%%.....%....%%...%%...
m .%%%.......%%...%%%..........%................%...........%%%%%.................%...........%.................%...
m .%%........%.....%.....%....%%%........%..%.%%%%%%%%%%....%%%%%%................%%..........%%................%...
m .%%........%%...%.%...%%%....%%...%....%%%%%%%%%%%%%%.....%%%%%................%%..........%%%................%...
m ..%%%..................%%...%%....%%...%%%%%.%%%%.%%%.....%%.%.%%.%%%....%.%....%%.....%%..%%%%%.%%.....%%...%%...
m .%%%%%................%%%....%%...%%..........%%....%%...%%....%%%%%%%...%%.....%....%%%%%%%%%%%%%%%%%%%%%...%%%..
m .%%%%%%...............%%%...%%....%%.........%%....%%%...%%.....%%%%%....%%....%%%...%%%%.%%..%%%%%%%%%%%.........
m .%%%%%%..%%%%%.%.......%%...%%%.%.%%..........%%....%%...%%....%%%%%%%....%%...%%.....%................%%.........
m .%%%%%%%%%%%%%%%%%.....%%....%%%%%%%%.%%%%....%....%%.....%%...%%%%%%.....%....%%.....%%................%.........
m .%%%%%.%%%%.....%%....%%%.....%%..%%%%%%%....%%....%%%...%%....%%%%%%%....%.....%....%%.................%.........
m .................%%...%%%.........%%.%%..%...%%%...%%.....%.....%.%.%%...%%%...%%%.%%%%.....%.%.%%%....%%....%.%..
m ................%%%...%%..........%%.........%%...........................%....%%%%%%%%%...%%%%%%%%%....%%...%%%..
m ................%%.....%..........%%.........%%%.........................%%%...%..%%%%.....%%..%...%....%.....%%..
m %....%.....%%....%%.%.%%%%%...%...%%..........%%........................%%%%...........................%%.....%%%%
m .....%%%%%%%.....%%%%%%%%%%%%%....%.......3%.%%%..%.%...%..%...%%%...%.%%%%%............................%%...%%%%%
m %....%%...%%.....%..%.%.%%%%%.%...%%....%%%%%%%%%%%%%%%%%%%%....%%%%%%%%%%%.............................%....%%..%
m ...........%......................%.....%%.%..%%%%.%%%.%%.%%...%..%..%.%%%.%%....%...%.%...%...%.%.%....%%..%.....
m ...........%%.....................%%...%%%.................................%%%%%%%....%%...%%%%%%%%%....%%%%......
m ...........%......................%%....%...................................%%%%%.....%%....%.............%%......
m .....%%...%%%..%.%.%.%%.%.........%%...%%...................................%%%%%%...%%%...................%%.%..%
m %%%%%%%...%%%%%%%%%%%%%%%...%%%...%....%%....%..%%.%%.....%...%..%%%.%%%....%%%%%%....%....................%%%%%%%
m %..%%%.....%.....%%...%%%...%%....%%...%%.....%%%%%%%%%%%%%%%%%%%%%%%%%.....%%%%%%...%%...3....................%..
m ....%%.................%%.........%.....%%....%.%%%%%%%%%%%..%.%.%...%%....%%.%%%%...%%......%...%%%%.%...........
m ....%%................%%..........%%...%%%.........%%%................%%.............%%.....%....%%%%%............
m ....%%................%%%.........%.....%...........%%...............%%%..............%%...%.....%%.%%%...........
m ....%%....%%.%%.%.%...%%%...%%....%%....%..........%%%...............%%%............%................%%....%%...%%
m %...%%%....%%%%%%%%....%%%%%%%....%%....%%....%....%%%.%...%....%%..%%%%...%..%.%%%.................%%%....%.....%
m %...%%%....%....%%%...%...%%%%%...%%...%%%%%%%%.....%%%%%%%%....%%%%%%%.....%%%%%%%%................%%%....%%....%
m %...%%..........%%...........%....%%....%%....%%....%%%%%%.....%%%.%..%....%%%%....%...%.....%.............%.....%
m ....%%%..........%..........%%%...%%...%%...........%%.........%%%...........................%.............%%...%%
m %...%%%..........%...........%%...%%...%%..........%%...........%............................%.............%.....%
m .....%%%%.%%%....%%%%%%.%...%%%...%%...%%..........%%...........%%..............1............%%%%.....%....%.....%
m %....%%%%%%%%...%%%%%%%%.....%%...%%...%%.........%%%%.....%..%%%%....%%...%%......%.......%%........%....%%....%%
m ....%%%%..%.....%%%%.........%%...%%...%%.....%%%%%%%%...%%%%%%%%....%%%....%%....%........%%.......%......%%...%%
m ....%%...........%%..........%%...%%...%%%...%.%%%%%%....%%%.%%%%.....%.....%....%.....%%%%............0..........
m .....%...........%%..........%%...%%...%%...........%..........%%%...%%.....%.............%.......................
m ....%%%.........%%...........%%...%%...%%%..........%..........%%%....%%...%%.............%.......................
m ..%.%%%.....%%%%%%....%%....%%....%%....%...........%%..........%%...%%.....%.............%.....%...%....%%%%....%
m %%%%%%....%%%%%%%%.....%%%%%%%%...%%...%%%%%...%...%%%....%....%%%...%%....%%....%%%................%%%%%%%%.....%
m %%..%%....%...%.%%%....%....%%....%%....%%%%%%%....%%%%%%%%....%%%...%%.....%....%%%.................%%%.%..%...%%
m %...............%%%..........%....%%....%%...%%%...%.%.%%.%%....%%....%%...%%....%%................%............%%
m %...............%%...........%.....%.........%%%................%%...............%%%.%%.....%...%%..............%%
m ................%%%.........%%%...%%..........%%................%%................%%%%%....%.....%%.............%%
m %...%.%.%..%%%%%%%%%%%.%....%%.....%.........%%.................%%...............%.%%%%...%......%%...%%%%.%%....%
m %%%%%%%%%%%%%%%%%%%%%%%%.....%%...%%....%%...%%%...%%.....%.....%%%..%..%....................2...%%...%%%%%%.....%
m %.%%%..%...%.....%%.%%..%....%%....%...%%%...%%%%%%%%%%%%%%%...%%%%%%%%%%%%%%....................%....%%%%%%....%%
m .............................%%...%%.........%.%%.%.%.%..%%%...%%.....%..%.%%...................%%%...%%%%%%......
m .............................%....%%......................%.................%%.............%....%%.....%%%%%......
m ............................%%%...%%.....................%%.................%%%%....%%%%%%%%%...%%....%%%%%%%.....
m %..%..%...%%.%%.%%%.%%%%..%.%%.....%......................%................%..%%....%.%.%...%...%.%...%....%%.%%%.
m %%%%%%....%%%%%%%%%%%%%%%%%%%%....%%...%.%%%%%.%.%..%.....%%...%%....%%..%%....%.............................%%%%%
m %...%%%...%..%...%.%..%%%.%2.......%....%%%%%%%%%%%%%.....%%%%%%%.....%%%%%...%%............................%%%%%.
m ......................%%..........%%...%...%%%%%.%.%%....%%.....%....%%%%%.....%%...........................%%%%..
m ......................%%%.........%%..........%.....%%..................%%.....%....%...%..%%.....%%%%..%...%%%...
m .......................%%.........%%..........%%...%%%..................%%%...%%....%%%%%%%%%...%%%%%%%%%....%....
m %%.%.%.....%.....%%...%%%...%..%%.%%.........%%%...%%...................%.%....%%....%%%.%.%.....%%%%.%%%...%%%...
m %%%%%%%....%%...%%%....%%....%%%%%%%..%%.....%%%....%%.....%%%%.%%%%%..........%.................%%....%.....%....
m .%%%%%%...%%.....%%....%....%%%%.%%%%%%%%....%%.....%%%%%%%%%%%%%%%%%..........%................%%.....%%....%....
m %%%%%%%....%%...%%....%%..........%%.%.%%%...%%.......%.%%%%%..%%%%%%..........%%................%.....%%...%%....
m .%%%%%.....%%...%%%....%%.........%%....%%...%%%...............%%%%%%..........%%%%%%%%%%%..%%.%%%%...%%%....%%...
m %%%%%%%....%%...%%....%%..........%%...%%....%%%................%%%%%...%%%...%%%%%%%%%%%%%%%%%%%%%....%.....%%...
m .%%%.%%.%.%%.....%%%.%%%%.%%%%%...%%....%%...%%..................%%%.....%%...%%.....%%.%%%%%..%%.....%%....%.%...
m .......%%%%%.....%%%%%%%%%%%%%%....%...%%....%%%...%.%...%%........%%....%................%%%..........%%.........
m ......%%%%%%....%%%%%%%%%%.%..%........%%%....%.....%.....%........%%....%................%%..........%%..........
m .......%%%%%...........%................%..........%%%...%%.......%%%....%.................%...........%..........
m ..%...%%%%%%...........%................%..........%%%...%%%......%%%....%%...%%....%.....%%%....%%....%....%%%...
m %%%%%%%%%%%%..........%%...............%%%..........%%...%%%%%%...%%....%%%%%%%%%...%%%...%%.....%....%%%...%%....
m .%.%%%......%%%%.......%....%..%.%%%....%%.........%%%....%%%.%...%%....%...%.%%.....%....%%....%%....%%.....%....
m ............%%%%%%.....%....%%%%%%%%....%%%....%...%%%%%..........%%...........%....%%..........%%....%%....%%%...
m ............%%%%%%......%...%.%%..%%....%%%%%%%%....%%%%%..........%...........%....%%..........%%%...%%....%%....
m ............%%%%%%%...............%%...%%%%..%%%....%%%%%.........%%..........%%.....%..........%%....%%.....%....
m .%.%%%..%....%%%%%................%%....%..........%%%%%%%%%%.%....%%.%%.......%....%%%%...%%..%%%%%%%%%....%%....
m %%%%%%%%%....%%%%%%...............%%...%%%..........%%%%%%%%%%.....%%%%%%%%...%%%....%%%%%%%%%%%%%%%%%%%%...%%%...
m %%%.%.%%%......%.%%...%.%%%.%%.....%...%%............%..%%.%%.%......%%.%%.....%%...%%%...%%%%%...%%.%%%%...%%....
m ......%%%..........%%%%%%%%%%%%...%%....%%...%.%%.%......................%....%%..........%%%.........%%.....%%...
m .......%%..........%%%%%%...%%%....%...%%.....%%%%......................%%%....%..........%%..........%%%...%%....
m ......%%%..........%%%%%%..........%..........%%%%%......................%....%%..........%%..........%%%...%%....
m %..%.%%%%..%......%%%%%%...........%..........%%%%%...%%%.....%.%%..%%%.%%%...%%%.%%%.%...%%....%......%....%%%%%.
m %%%%%%%%%%%%%%.....%%%%%..........%%..........%%%%....%%.....%%%%%%%%%%%%%.....%%%%%%%.....%....%%%...%%....%%%%%%
m %%..%.%%%.....%...%%%%..%%%..%....%%.........%....%...%%......%%%%%%%%..%%%...%%%%.%%%....%......%......%....%%.%%
m .......%%.........%%....%%%%%%%....%.....%%.%..........%................%%%..........%...........%...........%....
m ......%%..........%%....%%%%%%%...%%...%%%%%...........%................%%%..........%%..........%..........%%%...
m ......%%%..........%.....%%%%%....%%...%%%%%%.........%%%................%%..........%%..........%...........%0...
m %.%...%%....%%%...%%%....%%%%%.....%....%%%%%.....%.%.%%%%%..%.%.%%......%%....%%...%%%.%.%.....%%%..%%....%%%....
m .%%...%%.....%....%%%...%%%%%%.....%...%%%%%.....%%%%%%%%%%%%%%%%%%%.....%.....%%...%%%%%%%%%%%%%%%%%%%%%%%%%%....
m .%%...%%%....%%....%%....%%...%...%%....%.%%.....%.%%.%...%..%%.%.%%%...%.%....%......%.%%%%%%%%.%...%.%%%.%......
m %%%.........%%%....................%%%%............................%%.............................................
