# map type: blank
# random seed: -533140950
# hill distance  87,109 106,102  76, 59  12, 91 119, 29  87, 22   5, 59 138,109   5, 72  69, 91 138, 22 106, 29  76, 72 119,102  69, 40  12, 40
#        87,109       0      36      77     103      96      95     112      79     109      36     108      93      58      65     103     138 
#       106,102      36       0      83      77      84      93      86      65      83      58      96      81      80      29     109     112 
#        76, 59      77      83       0      96      83      58      81     112      84      65     109      80      29      86      36      93 
#        12, 91     103      77      96       0     109     138      65      36      36      95     103     112      93      58     108      79 
#       119, 29      96      84      83     109       0      65      80      93      83     112      36      29      86      81      77      58 
#        87, 22      95      93      58     138      65       0     109     108     112     103      79      36      77      96      36     103 
#         5, 59     112      86      81      65      80     109       0      77      29      96      58      83      84      83      93      36 
#       138,109      79      65     112      36      93     108      77       0      58     103      95      96     109      36     138     103 
#         5, 72     109      83      84      36      83     112      29      58       0      93      77      86      81      80      96      65 
#        69, 91      36      58      65      95     112     103      96     103      93       0     138     109      36      77      79     108 
#       138, 22     108      96     109     103      36      79      58      95      77     138       0      65     112      93     103      36 
#       106, 29      93      81      80     112      29      36      83      96      86     109      65       0      83      84      58      77 
#        76, 72      58      80      29      93      86      77      84     109      81      36     112      83       0      83      65      96 
#       119,102      65      29      86      58      81      96      83      36      80      77      93      84      83       0     112     109 
#        69, 40     103     109      36     108      77      36      93     138      96      79     103      58      65     112       0      95 
#        12, 40     138     112      93      79      58     103      36     103      65     108      36      77      96     109      95       0 
players 8
rows 144
cols 144
m .................................%%%%%%.....%%%%.....%%%.....%%%....%%%.....%%%.....%%%%.....%%%%%%.............................................
m .................................%%...%%......%.....%%%.....%%%%....%%%%.....%%%.....%......%%...%%.............................................
m .....................................................%%.....%%%%....%%%%.....%%.................................................................
m ....%%%%.............................................%%.....%%%%....%%%%.....%%.............................................%%%%................
m ....%%%..............................................%%.....%%%......%%%.....%%..............................................%%%................
m .....%%.............................................%%%....5%%%%....%%%%6....%%%.............................................%%.................
m .....%%.......%.%%.%%.%.....%.......%.%%.......%....%%%%.....%%%....%%%.....%%%%....%.......%%.%.......%.....%.%%.%%.%.......%%......%.%....%.%.
m ....%%%......%%%%%%%%%%..............%%.....%%%%....%%%%....%%%%....%%%%....%%%%....%%%%.....%%..............%%%%%%%%%%......%%%.....%%......%%.
m .....%%%.....%%%%%%%%%%..............%%......%%.....%%%%....%%%%....%%%%....%%%%.....%%......%%..............%%%%%%%%%%.....%%%.....%%%......%%%
m ....%%%%....%%.%%%%.%%%..............%%%.....%%%......%......%%......%%......%......%%%.....%%%..............%%%.%%%%.%%....%%%%....%%%%....%%%%
m ....................%%%%%...........%%%.....%%%.............%%%%....%%%%.............%%%.....%%%...........%%%%%.....................%%%....%%%.
m ....................%%%%%...........%%%......%%%............%%%%....%%%%............%%%......%%%...........%%%%%....................%%%......%%%
m ....................%%%%%%%%%.......%%%%2....%%..............%%......%%..............%%....3%%%%.......%%%%%%%%%....................%%%%....%%%%
m .....................%%%%%%%.........%%%.....%%%............%%%......%%%............%%%.....%%%.........%%%%%%%.....................%%%%....%%%%
m %.%%%..%%..%%..%....%.%%%%%%%.......%%%.....%%%%......%......%%%....%%%......%......%%%%.....%%%.......%%%%%%%.%....%..%%..%%..%%%.%%%%%....%%%%
m %%%%%%%%%%%%%%%...........%%%........%%......%%%%%%%%%%......%%......%%......%%%%%%%%%%......%%........%%%...........%%%%%%%%%%%%%%%%%%......%%%
m %%%%%%%%%%%%%%%%.........%%%........%%%%....%%%%%%%%%%%......%%%....%%%......%%%%%%%%%%%....%%%%........%%%.........%%%%%%%%%%%%%%%%%%%%....%%%%
m %%..%%....%.%%%..........%%%%........%%%.....%%%%%%...%........%....%........%...%%%%%%.....%%%........%%%%..........%%%.%....%%..%%%%%......%%%
m .............%%%%........%%%%.......%%%%.....%%%....................................%%%.....%%%%.......%%%%........%%%%.............%%%......%%%
m .............%%%%.%.%....%%%.........%%......%%......................................%%......%%.........%%%....%.%.%%%%..............%%%....%%%.
m .............%%%%%%%......%%%.......%%%.....%%%%....................................%%%%.....%%%.......%%%......%%%%%%%..............%%%....%%%.
m .............%%%%%%%.....%%%........%%%%.....%%......................................%%.....%%%%........%%%.....%%%%%%%..............%%%....%%%.
m ....%...%%..%....%%%%....%..........%%%%....%%%.....%.%%....%%.%%%%%%.%%....%%.%.....%%%....%%%%..........%....%%%%....%..%%...%....%%%......%%%
m ....%%%%%%%%......%%%...............%%%%.....%%%.....%%......%%%%%%%%%%......%%.....%%%.....%%%%...............%%%......%%%%%%%%.....%%%....%%%.
m .....%%%%%%%.....%%%................%%%......%%......%%.....%%%%%%%%%%%%.....%%......%%......%%%................%%%.....%%%%%%%......%%%....%%%.
m .....%%%%%%%%.....%%.................%%.....%..%....%..%....................%..%....%..%.....%%.................%%.....%%%%%%%%.....%..%....%..%
m .....%%%%%%%%.....%%%...............%%%%....................................................%%%%...............%%%.....%%%%%%%%.................
m ....%%%%%%%%......%%%....%%....%....%%%......................................................%%%....%....%%....%%%......%%%%%%%%................
m ....%%%%%%%%......%%.....%%%%%%%.....%%......................................................%%.....%%%%%%%.....%%......%%%%%%%%................
m .....%%%%%%%.....%%%.....%%%%%%%.....%%%....................................................%%%.....%%%%%%%.....%%%.....%%%%%%%.................
m ..%%%.%%...%%....%%%%....%.%..%%....%%%%%%%..%%%%.%.%%%%.%%..%%......%%..%%.%%%%.%.%%%%..%%%%%%%....%%..%.%....%%%%....%%...%%.%%%...%%......%%.
m %%%%%.............%%%...............%%%%%%%%%%%%%%%%%%%%%%%%%%%%....%%%%%%%%%%%%%%%%%%%%%%%%%%%%...............%%%.............%%%%%%%%%....%%%%
m %%%%%.............%%%................%%%%%%%%%%%%%%%%%%%%%%%%%%......%%%%%%%%%%%%%%%%%%%%%%%%%%................%%%.............%%%%%%%%%....%%%%
m %%%%.............%%%...................%...%%%%%.%%.%%.......%%%....%%%.......%%.%%.%%%%%...%...................%%%.............%%%%.%%%....%%%.
m %%%%.............%%%%..........................................................................................%%%%.............%%%%............
m ..%%.....%..%...%%%%%%%%.%%..............................................................................%%.%%%%%%%%...%..%.....%%..............
m .%%%%.....%%%%%%%%%%%%%%%%%%%..........................................................................%%%%%%%%%%%%%%%%%%%.....%%%%.............
m .%%%%.....%%%%%%%%%%%%%%%%%%............................................................................%%%%%%%%%%%%%%%%%%.....%%%%.............
m .%%%.....%%%.%%%..%.%%%.%%..%.......%.%.....%%%%..........%%%.%%....%%.%%%..........%%%%.....%.%.......%..%%.%%%.%..%%%.%%%.....%%%....%....%...
m .....................................%%%%%%%%%%%....%%%%%%%%%%%......%%%%%%%%%%%....%%%%%%%%%%%.........................................%%%%....
m .....................................%%%%%%%%%%.....%%%%%%%%%%%%....%%%%%%%%%%%%.....%%%%%%%%%%.........................................%%%%....
m .....................................%%%%%%%%%%.....%%%%%%%%%%%%....%%%%%%%%%%%%.....%%%%%%%%%%.........................................%%%%....
m .....................................%%%%%%%%%%%....%%%%%%%%%%%......%%%%%%%%%%%....%%%%%%%%%%%.........................................%%%%....
m .%%%.....%%%.%%%..%.%%%.%%..%.......%.%.....%%%%..........%%%.%%....%%.%%%..........%%%%.....%.%.......%..%%.%%%.%..%%%.%%%.....%%%....%....%...
m .%%%%.....%%%%%%%%%%%%%%%%%%............................................................................%%%%%%%%%%%%%%%%%%.....%%%%.............
m .%%%%.....%%%%%%%%%%%%%%%%%%%..........................................................................%%%%%%%%%%%%%%%%%%%.....%%%%.............
m ..%%.....%..%...%%%%%%%%.%%..............................................................................%%.%%%%%%%%...%..%.....%%..............
m %%%%.............%%%%..........................................................................................%%%%.............%%%%............
m %%%%.............%%%...................%...%%%%%.%%.%%.......%%%....%%%.......%%.%%.%%%%%...%...................%%%.............%%%%.%%%....%%%.
m %%%%%.............%%%................%%%%%%%%%%%%%%%%%%%%%%%%%%......%%%%%%%%%%%%%%%%%%%%%%%%%%................%%%.............%%%%%%%%%....%%%%
m %%%%%.............%%%...............%%%%%%%%%%%%%%%%%%%%%%%%%%%%....%%%%%%%%%%%%%%%%%%%%%%%%%%%%...............%%%.............%%%%%%%%%....%%%%
m ..%%%.%%...%%....%%%%....%.%..%%....%%%%%%%..%%%%.%.%%%%.%%..%%......%%..%%.%%%%.%.%%%%..%%%%%%%....%%..%.%....%%%%....%%...%%.%%%...%%......%%.
m .....%%%%%%%.....%%%.....%%%%%%%.....%%%....................................................%%%.....%%%%%%%.....%%%.....%%%%%%%.................
m ....%%%%%%%%......%%.....%%%%%%%.....%%......................................................%%.....%%%%%%%.....%%......%%%%%%%%................
m ....%%%%%%%%......%%%....%%....%....%%%......................................................%%%....%....%%....%%%......%%%%%%%%................
m .....%%%%%%%%.....%%%...............%%%%....................................................%%%%...............%%%.....%%%%%%%%.................
m .....%%%%%%%%.....%%.................%%.....%..%....%..%....................%..%....%..%.....%%.................%%.....%%%%%%%%.....%..%....%..%
m .....%%%%%%%.....%%%................%%%......%%......%%.....%%%%%%%%%%%%.....%%......%%......%%%................%%%.....%%%%%%%......%%%....%%%.
m ....%%%%%%%%......%%%...............%%%%.....%%%.....%%......%%%%%%%%%%......%%.....%%%.....%%%%...............%%%......%%%%%%%%.....%%%....%%%.
m ....%...%%..%....%%%%....%..........%%%%....%%%.....%.%%....%%.%%%%%%.%%....%%.%.....%%%....%%%%..........%....%%%%....%..%%...%....%%%......%%%
m .............%%%%%%%.....%%%........%%%%.....%%......................................%%.....%%%%........%%%.....%%%%%%%..............%%%....%%%.
m .............%%%%%%%......%%%.......%%%.....%%%%....................................%%%%.....%%%.......%%%......%%%%%%%..............%%%....%%%.
m .............%%%%.%.%....%%%.........%%......%%......................................%%......%%.........%%%....%.%.%%%%..............%%%....%%%.
m .............%%%%........%%%%.......%%%%.....%%%....................................%%%.....%%%%.......%%%%........%%%%.............%%%......%%%
m %%..%%....%.%%%..........%%%%........%%%.....%%%%%%...%........%....%........%...%%%%%%.....%%%........%%%%..........%%%.%....%%..%%%%%......%%%
m %%%%%%%%%%%%%%%%.........%%%........%%%%....%%%%%%%%%%%......%%%....%%%......%%%%%%%%%%%....%%%%........%%%.........%%%%%%%%%%%%%%%%%%%%....%%%%
m %%%%%%%%%%%%%%%...........%%%........%%......%%%%%%%%%%......%%......%%......%%%%%%%%%%......%%........%%%...........%%%%%%%%%%%%%%%%%%......%%%
m %.%%%..%%..%%..%....%.%%%%%%%.......%%%.....%%%%......%......%%%....%%%......%......%%%%.....%%%.......%%%%%%%.%....%..%%..%%..%%%.%%%%%....%%%%
m .....................%%%%%%%.........%%%.....%%%............%%%......%%%............%%%.....%%%.........%%%%%%%.....................%%%%....%%%%
m ....................%%%%%%%%%.......%%%%0....%%..............%%......%%..............%%....1%%%%.......%%%%%%%%%....................%%%%....%%%%
m ....................%%%%%...........%%%......%%%............%%%%....%%%%............%%%......%%%...........%%%%%....................%%%......%%%
m ....................%%%%%...........%%%.....%%%.............%%%%....%%%%.............%%%.....%%%...........%%%%%.....................%%%....%%%.
m ....%%%%....%%.%%%%.%%%..............%%%.....%%%......%......%%......%%......%......%%%.....%%%..............%%%.%%%%.%%....%%%%....%%%%....%%%%
m .....%%%.....%%%%%%%%%%..............%%......%%.....%%%%....%%%%....%%%%....%%%%.....%%......%%..............%%%%%%%%%%.....%%%.....%%%......%%%
m ....%%%......%%%%%%%%%%..............%%.....%%%%....%%%%....%%%%....%%%%....%%%%....%%%%.....%%..............%%%%%%%%%%......%%%.....%%......%%.
m .....%%.......%.%%.%%.%.....%.......%.%%.......%....%%%%.....%%%....%%%.....%%%%....%.......%%.%.......%.....%.%%.%%.%.......%%......%.%....%.%.
m .....%%.............................................%%%....7%%%%....%%%%4....%%%.............................................%%.................
m ....%%%..............................................%%.....%%%......%%%.....%%..............................................%%%................
m ....%%%%.............................................%%.....%%%%....%%%%.....%%.............................................%%%%................
m .....................................................%%.....%%%%....%%%%.....%%.................................................................
m .................................%%...%%......%.....%%%.....%%%%....%%%%.....%%%.....%......%%...%%.............................................
m .................................%%%%%%.....%%%%.....%%%.....%%%....%%%.....%%%.....%%%%.....%%%%%%.............................................
m ..................................%%%%%.....%%%%....%%%%.....%%%....%%%.....%%%%....%%%%.....%%%%%..............................................
m ...%%..%%.%%%%%.%.%.%.%%%...%.....%%%........%%%....%%%%......%%....%%......%%%%....%%%........%%%.....%...%%%.%.%.%.%%%%%.%%..%%......%....%...
m ..%%%%%%%%%%%%%%%%%%%%%%%%%%......%%.........%%.....%%%......................%%%.....%%.........%%......%%%%%%%%%%%%%%%%%%%%%%%%%%......%%%%....
m ..%%%%%%%%%%%%%%%%%%%%%%%%%%%....%%%.........%%......%%......................%%......%%.........%%%....%%%%%%%%%%%%%%%%%%%%%%%%%%%.....%%%%%%...
m .%%%%%..%..%%%..%%%..%%..%..%....%..........%%%......%%%....................%%%......%%%..........%....%..%..%%..%%%..%%%..%..%%%%%.....%%%%....
m ..%%%.................4......................%%.....%%%%....................%%%%.....%%......................7.................%%%......%%%%....
m ..%%%....................................%..%%%.....%%%%.%%.%%%......%%%.%%.%%%%.....%%%..%....................................%%%......%%%%....
m ..%%%.....................................%%%%%.....%%%%%%%%%%%......%%%%%%%%%%%.....%%%%%.....................................%%%......%%%%....
m .%%%......................................%%%%%......%%%%%%%%%%......%%%%%%%%%%......%%%%%......................................%%%.....%%%%....
m .%%%.....%..%.%...%.%...%..%......%%...%.%%%%.......%%.%.%%.%%.%....%.%%.%%.%.%%.......%%%%.%...%%......%..%...%.%...%.%..%.....%%%....%%%%%%...
m .%%%%.....%%%%%%%%%%%%%%%%%%......%%%%%%%%%%............................................%%%%%%%%%%......%%%%%%%%%%%%%%%%%%.....%%%%....%%%%%%...
m .%%%%.....%%%%%%%%%%%%%%%%%%.....%%%%%%%%%%%............................................%%%%%%%%%%%.....%%%%%%%%%%%%%%%%%%.....%%%%....%%%%%%...
m .%%%%....%.%..%.%%%%%%.%.%.%%.....%%%..........................................................%%%.....%%.%.%.%%%%%%.%..%.%....%%%%....%%..%%...
m ..%%%............%%%............................................................................................%%%............%%%..............
m .%%%.............%%%.............................%.%%..%%.%%.%%%....%%%.%%.%%..%%.%.............................%%%.............%%%.............
m .%%%%............%%%..............................%%%%%%%%%%%%%......%%%%%%%%%%%%%..............................%%%............%%%%.............
m ..%%..............%%.............................%%%%%%%%%%%%%%......%%%%%%%%%%%%%%.............................%%..............%%..............
m .%%%%....%..%.....%%......%%%%...%.%%%..%%%.%....%%%%%%%.%%...%......%...%%.%%%%%%%....%.%%%..%%%.%...%%%%......%%.....%..%....%%%%.....%%%%....
m .%%%%.....%%......%%......%%%%%%%%%%%%%%%%%%%.....%%%%%......................%%%%%.....%%%%%%%%%%%%%%%%%%%......%%......%%.....%%%%.....%%%%....
m ..%%%.....%%%....%%%%....%%%%%%%%%%%%%%%%%%%......%%%%%......................%%%%%......%%%%%%%%%%%%%%%%%%%....%%%%....%%%.....%%%......%%%%....
m ..%%%....%..%.............%%%.....%%%..%%%%%%....%%%%..........................%%%%....%%%%%%..%%%.....%%%.............%..%....%%%......%%%%....
m ..%%......................................%%.....%%%............................%%%.....%%......................................%%......%%%%....
m ..%%%....................................%%%%.....%%%..........................%%%.....%%%%....................................%%%......%%%%....
m ..%%%....................................%%%%....%%%%..........................%%%%....%%%%....................................%%%.....%%%%%%...
m ..%%.........................2............%%.....%%%.............%%.............%%%.....%%............3.........................%%.....%%%%%%...
m ..%%......%.%........%.%%.%%.%%%%%.......%%%%.....%%........%....%%....%........%%.....%%%%.......%%%%%.%%.%%.%........%.%......%%.....%%%%%%...
m .%%%%.....%%%.....%%%%%%%%%%%%%%%%%%.....%%%%....%%%.............%%.............%%%....%%%%.....%%%%%%%%%%%%%%%%%%.....%%%.....%%%%.....%%%%....
m .%%%%.....%%......%%%%%%%%%%%%%%%%%%%....%%%.....%%%%............%%............%%%%.....%%%....%%%%%%%%%%%%%%%%%%%......%%.....%%%%....%%%%%%...
m .%.%......%%%....%%.%..%%.%%%%.%%%%%%.......%....%...............%%...............%....%.......%%%%%%.%%%%.%%..%.%%....%%%......%.%....%.%%.%...
m ..........%%%...................................................%%%%...................................................%%%......................
m ..........%%%..............................................%%%%%%%%%%%%%%..............................................%%%......................
m ..........%%%..............................................%%%%%%%%%%%%%%..............................................%%%......................
m ..........%%%...................................................%%%%...................................................%%%......................
m .%.%......%%%....%%.%..%%.%%%%.%%%%%%.......%....%...............%%...............%....%.......%%%%%%.%%%%.%%..%.%%....%%%......%.%....%.%%.%...
m .%%%%.....%%......%%%%%%%%%%%%%%%%%%%....%%%.....%%%%............%%............%%%%.....%%%....%%%%%%%%%%%%%%%%%%%......%%.....%%%%....%%%%%%...
m .%%%%.....%%%.....%%%%%%%%%%%%%%%%%%.....%%%%....%%%.............%%.............%%%....%%%%.....%%%%%%%%%%%%%%%%%%.....%%%.....%%%%.....%%%%....
m ..%%......%.%........%.%%.%%.%%%%%.......%%%%.....%%........%....%%....%........%%.....%%%%.......%%%%%.%%.%%.%........%.%......%%.....%%%%%%...
m ..%%.........................0............%%.....%%%.............%%.............%%%.....%%............1.........................%%.....%%%%%%...
m ..%%%....................................%%%%....%%%%..........................%%%%....%%%%....................................%%%.....%%%%%%...
m ..%%%....................................%%%%.....%%%..........................%%%.....%%%%....................................%%%......%%%%....
m ..%%......................................%%.....%%%............................%%%.....%%......................................%%......%%%%....
m ..%%%....%..%.............%%%.....%%%..%%%%%%....%%%%..........................%%%%....%%%%%%..%%%.....%%%.............%..%....%%%......%%%%....
m ..%%%.....%%%....%%%%....%%%%%%%%%%%%%%%%%%%......%%%%%......................%%%%%......%%%%%%%%%%%%%%%%%%%....%%%%....%%%.....%%%......%%%%....
m .%%%%.....%%......%%......%%%%%%%%%%%%%%%%%%%.....%%%%%......................%%%%%.....%%%%%%%%%%%%%%%%%%%......%%......%%.....%%%%.....%%%%....
m .%%%%....%..%.....%%......%%%%...%.%%%..%%%.%....%%%%%%%.%%...%......%...%%.%%%%%%%....%.%%%..%%%.%...%%%%......%%.....%..%....%%%%.....%%%%....
m ..%%..............%%.............................%%%%%%%%%%%%%%......%%%%%%%%%%%%%%.............................%%..............%%..............
m .%%%%............%%%..............................%%%%%%%%%%%%%......%%%%%%%%%%%%%..............................%%%............%%%%.............
m .%%%.............%%%.............................%.%%..%%.%%.%%%....%%%.%%.%%..%%.%.............................%%%.............%%%.............
m ..%%%............%%%............................................................................................%%%............%%%..............
m .%%%%....%.%..%.%%%%%%.%.%.%%.....%%%..........................................................%%%.....%%.%.%.%%%%%%.%..%.%....%%%%....%%..%%...
m .%%%%.....%%%%%%%%%%%%%%%%%%.....%%%%%%%%%%%............................................%%%%%%%%%%%.....%%%%%%%%%%%%%%%%%%.....%%%%....%%%%%%...
m .%%%%.....%%%%%%%%%%%%%%%%%%......%%%%%%%%%%............................................%%%%%%%%%%......%%%%%%%%%%%%%%%%%%.....%%%%....%%%%%%...
m .%%%.....%..%.%...%.%...%..%......%%...%.%%%%.......%%.%.%%.%%.%....%.%%.%%.%.%%.......%%%%.%...%%......%..%...%.%...%.%..%.....%%%....%%%%%%...
m .%%%......................................%%%%%......%%%%%%%%%%......%%%%%%%%%%......%%%%%......................................%%%.....%%%%....
m ..%%%.....................................%%%%%.....%%%%%%%%%%%......%%%%%%%%%%%.....%%%%%.....................................%%%......%%%%....
m ..%%%....................................%..%%%.....%%%%.%%.%%%......%%%.%%.%%%%.....%%%..%....................................%%%......%%%%....
m ..%%%.................6......................%%.....%%%%....................%%%%.....%%......................5.................%%%......%%%%....
m .%%%%%..%..%%%..%%%..%%..%..%....%..........%%%......%%%....................%%%......%%%..........%....%..%..%%..%%%..%%%..%..%%%%%.....%%%%....
m ..%%%%%%%%%%%%%%%%%%%%%%%%%%%....%%%.........%%......%%......................%%......%%.........%%%....%%%%%%%%%%%%%%%%%%%%%%%%%%%.....%%%%%%...
m ..%%%%%%%%%%%%%%%%%%%%%%%%%%......%%.........%%.....%%%......................%%%.....%%.........%%......%%%%%%%%%%%%%%%%%%%%%%%%%%......%%%%....
m ...%%..%%.%%%%%.%.%.%.%%%...%.....%%%........%%%....%%%%......%%....%%......%%%%....%%%........%%%.....%...%%%.%.%.%.%%%%%.%%..%%......%....%...
m ..................................%%%%%.....%%%%....%%%%.....%%%....%%%.....%%%%....%%%%.....%%%%%..............................................
