# map type: blank
# random seed: -1731419098
# hill distance   1,100  26, 53  81, 32 118, 89  58,  9  74,121  37, 64  97, 16
#         1,100       0      94     118      42     120     114      92     112 
#        26, 53      94       0     114      92     112     118      42     120 
#        81, 32     118     114       0     120     150     150     112      32 
#       118, 89      42      92     120       0     118     112      94     114 
#        58,  9     120     112     150     118       0      32     114     150 
#        74,121     114     118     150     112      32       0     120     150 
#        37, 64      92      42     112      94     114     120       0     118 
#        97, 16     112     120      32     114     150     150     118       0 
players 4
rows 128
cols 128
m ..........%%%.............%%%....%%%%............%%%.............%%%......%%%............%%%%%%%%....%%%%%%%%%%%.....%%%........
m .........%%%%.............%%%....%%%.............%%%..............%%%.....%%%.............%%.%%%....2...%%%..%%%%.....%%........
m ..%%.%...%%%......%.......%%%....%%%%....%%%.%...%%%%....%%%..%%.%%%......%%......%%%.........%%%............%%%......%%........
m .%%%%%%%%%%%.....%%%.....%%%%.....%%%.....%%%%%%%%%%%....%%%%%%%%%%%%....%%%.....%%%..........%%%.............%%.....%%%........
m ..%%%%%%%%%%.....%%%.....%%%%....%%%%....%%%%%%%%%%%......%%%%%%%%%%.....%%%%.....%%..........%%..............%%......%%%.......
m .....%%%...%.....%%%......%%%.....%%%....%%%%.%..%%%%....%%%%.%.%.%......%.......%%%%.........%%.............%%%%....%%%........
m .................%%%%.....%%%....%%%.............%%%%............................%%%%%..%.....%%%%%%%.%%%....%%%......%%........
m ..................%%.....%%%%....%%%.............%%%%.............................%%%%%%%.....%%%%%%%%%%.....%%%......%%%.......
m ..................%%.....%%%%.....%%%.............%%..............................%%%%%%%.....%%%%%%%%%%......%%......%%........
m ..................%%......%%%....%%%..............%%%............................%..%%.%.........%%%%..%.....%%%.....%%%%.......
m ...%%....%........%%%...%%%%%.....%%%....%%.%%.%%%%%%%%%.%%%%.....%%%....%%.%%.%.............................%%%.....%%%........
m ..%%.....%%%......%%%%%%%%%%%.....%%.....%%%%%%%%%%%%%%%%%%%%%%%%%%%.....%%%%%%%%............................%%%......%%........
m .%%%%....%%%......%%%%%%%%%%%....%%%%.....%%%%%%%%%%%%%%%%%%%%%%%%%%......%%%%%%..............................%%......%%%.......
m ..%%%.....%%%.....%%%%%%%%%%%.....%%%....%%%%..%..%%%.%..%.%%%.%%..%.....%%%%%%%%............................%%%......%%........
m %%%%%%%%.....%%%.....%%%..........%%......%%%............................%%%%%%%%.....%..%%.%%%.%..%.%%%..%..%%%%....%%%.....%%%
m %%%%%%%%......%%%....%%%%........%%%......%%..............................%%%%%%......%%%%%%%%%%%%%%%%%%%%%%%%%%.....%%%%....%%%
m %%%%%%%%......%%%.....%%..........%%......%%%............................%%%%%%%%.....%%%%%%%%%%%%%%%%%%%%%%%%%%%.....%%.....%%%
m %%...%%%........%....%%...........%%%.....%%%.............................%.%%.%%....%%%.....%%%%.%%%%%%%%%.%%.%%....%%%.....%%%
m ......%%.........................%%%%.....%%%.....%..%%%%.........%.%%..%............................%%%..............%%%....%%%
m %.....%%..........................%%......%%......%%%%%%%%%%.....%%%%%%%..............................%%.............%%%.....%%%
m %.....%%.........................%%%......%%%.....%%%%%%%%%%.....%%%%%%%.............................%%%%.............%%%....%%%
m .....%%%%.........................%%......%%%....%%%.%%%%%%%.....%..%%%%%............................%%%%.............%%%....%%%
m ......%%%.....%...%%%.............%%%....%%%%.............%%.........%%%%.......%......%.%.%.%%%%....%%%%..%.%%%%....%%%.....%%%
m %.....%%%.....%%%%%%%%%%.........%%%......%%..............%%..........%%.....%%%%.....%%%%%%%%%%......%%%%%%%%%%%....%%%%....%%%
m %.....%%%.....%%%%%%%%%%%.........%%%.....%%.............%%%..........%%%.....%%%....%%%%%%%%%%%%....%%%%%%%%%%%.....%%%.....%%%
m .......%......%%%...%.%%..........%%......%%%............%%%.........%%%......%%......%%%.%%..%%%....%%%%...%.%%%....%%%%....%%%
m .............%%%%.................%%.....%%%%..%%%...3....%%%.%%.............%%%.....%%%..............%%%.............%%%....%%%
m .............%%%..................%%%.....%%%%%%%%%%%....%%%%%%%%............%%%......%%%.............%%%............%%%%....%%%
m %............%%%%................%%%......%%%%%%%%%%%....%%%%%%%%.............%%.....%%%%............%%%.............%%%%....%%%
m .............%%%%.................%%......%%%...%%%.%.....%%%%%%.............%%%......%%..............%%%.............%%.....%%%
m %.....%%.%..%%%%......%%%........%%%%.....%%%............%%%%%%%%............%%%%....%%%.....%%.%....%%%%.......%.%%.%%%%....%%%
m .....%%%%%%%%%%%%.....%%%.........%%%....%%%..............%%%%%%%%%%%%%%.....%%%%....%%%%....%%%......%%%.....%%%%%%%%%%.....%%%
m ......%%%%%%%%%%%....%%%%........%%%%....%%%.............%%%%%%%%%%%%%%%......%%%....%%%%.....%%%.....%%%....%%%%%%%%%%%.....%%%
m ......%%%%.%%%.%......%%%........%%%.....%%%.............%%.%.%%.%%..%%%.....%%%%....%.%%....%.%%.....%%%.....%%%.%%%%.%.....%%%
m ......%%%.............%%%.........%%%.%..%%%%....%%%..%%%............%%%%.....%%..............................%%%............%%%
m ......%%.............%%%..........%%%%%%%%%%%.....%%%%%%%............%%%%.....%%%............................%%%%............%%%
m .....%%%%............%%%.........%%%%%%%%%%%......%%%%%%%............%%%%....%%%%............................%%%.............%%%
m %....%%%%............%%%%.........%%%%%.%.........%%%%%%........0....%%%%.....%%%............................%%%%............%%%
m %....%%%............%%%%.........%%%..............%%%%%%.....%%%......%%.....%%%%%.%%%.%%..%.%........%......%%%%.....%...%%.%%%
m %.....%%%.....%%%%%%%%%%.........%%%%.............%%%%%%%.....%%.....%%%.....%%%%%%%%%%%%%%%%%%%%....%%%%....%%%%....%%%%%%%%%%%
m ......%%......%%%%%%%%%%%.........%%..............%%%%%%%....%%%.....%%%%....%%%%%%%%%%%%%%%%%%%%.....%%%.....%%......%%%%%%%%%%
m %....%%%%....%%.%.%..%%%..........%%.............%......%....%%%%....%........%%%..%%%%%%%%.%%%%%.....%%......%%.......%%.%.%.%%
m .....................%%%%.........%%..........%%.............%%%%.............%%%.....%%.....................%%%%...............
m .....................%%%..........%%%.....%%%%%%%.............%%%............%%%%.....%%......................%%................
m .....................%%%%.........%%......%%%%%%%.............%%..............%%.....%%%......................%%................
m ......................%%...........%%....%%%%%%%..............%%..............%%%.....%%%.....................%%%...............
m %......%%.%%%%%.%....%%%.................%%%%%%%.......%%...%%%%%%..%%%.%%%.%%%%%....%%%.......%..%%%%%..%...%%%.............%%%
m ......%%%%%%%%%%......%%.................%%%%%%%......%%%%%%%%%%%%%%%%%%%%%%%%%%.....%%%%.....%%%%%%%%%%%%%%%%%%......%%.....%%%
m %.....%%%%%%%%%%%.....%%%................%%%%%%%......%%%%%%%%%%%%%%%%%%%%%%%%%%%....%%%%.....%%%%%%%%%%%%%%%%%%......%%.....%%%
m %.....%%%%%..%%%......%%.................%%%%%........%%%%%%....%...%........%.%%....%%.%....%%%%%%.%%%..%..%...%....%%%%....%%%
m %.............%%%................%%%%................%%%......................................%%.....................%%%.....%%%
m .............%%%%.................%%%.................%%.....................................%%%%....................%%%.....%%%
m %............%%%..................%%.................%%%%....................................%%%%.....................%%%....%%%
m %............%%%..................%%.................%%%......................................%%%.....................%%.....%%%
m %.....%..%%%%%%%.....%%%...%%....%%%%..%%....%.%...%.%%%%.%%%..%..%.%...%%...%%.%.%..%%%%.%%.%%%%.....%.........%%%..%%%%....%%%
m .....%%%%%%%%%%%%....%%%%%%%%....%%%%%%%%....%%%%%%%%%%%%%%%%%%%%%%%%%%%%%%%%%%%%%%%%%%%%%%%%%%%.....%%%......%%%%%%%%%%%....%%%
m ......%%%%%%%%%%%.....%%%%%%%....%%%%%%%%.....%%%%%%%%%%%%%%%%%%%%%%%%%%%%%%%%%%%%%%%%%%%%%%%%%%%.....%%%.....%%%%%%%%%%%....%%%
m %.....%%%%%.%%%%%....%..%%%......%%%%...%..........%%.%..%%.%.%....%..%.%..%..%..%.%%.%.%%%%.%........%%%.......%..%.%%%........
m ......%%%0....%%%.....................................................................................%%........................
m .....%%%%....%%%.....................................................................................%%%%.......................
m .....%%%%.....%%.....................................................................................%%%........................
m .....%%%.....%%%%.....................................................................................%%%.......................
m .....%%%%....%%%......%%..........%%%........................................%%%%%%%%%%%%%%%%%%%%%%%%%%%.....%%%%%%%%%%%.....%%%
m %.....%%%....%%%.....%%%%%%%......%%%........................................%%%%%%%%%%%%%%%%%%%%%%%%%%%%....%%%%%%%%%%%.....%%%
m ......%%%.....%%......%%%%%%.....%%%.........................................%%%%%%%%%%%%%%%%%%%%%%%%%%%%....%%%%%%%%%%%.....%%%
m ......%%%.....%%%.....%%.%%%.....%%%.........................................%%%%.%%..%%...%.%......%%%.%....%.%%%.%%%..%.....%.
m ..............%%%.........%%.....%%%......%...%.%.%..%..%%%%%.....%........%.%%%%...............................................
m ..............%%.........%%%%.....%%%....%%%%%%%%%%%%%%%%%%%%....%%%......%%%%%%................................................
m ..............%%%........%%%%.....%%%....%%%%%%%%%%%%%%%%%%%%....%%%.....%%%%%%%................................................
m .............%%%%..........%.....%.%%.......%.%%%%%%%%%%..%.......%%.....%.%%%%%................................................
m .....%%%......%%..................................%%%............%%%%........%%%%...%.........%....%%%..%.............%...%%%%..
m %....%%%......%%%.................................%%..............%%%........%%%%%%%%%%%.....%%%%%%%%%%%%.....%%%....%%%%%%%%%%%
m %....%%%.....%%%%................................%%%..............%%%........%%%%%%%%%%%%....%%%%%%%%%%%%....%%%%.....%%%%%%%%%%
m %.......%....%%%%.................................%%..............%%................%%%%......%%%%.%%.%.%....%%%%.....%%%%%%.%%%
m .............%%%%%%%.%%.%%...%..%%%%...%%.%.%....%%%......%%.%%.%%%%.....%%%.................%%%%.............%%%....%%%%2......
m .............%%%%%%%%%%%%%%%%%%%%%%%%%%%%%%%......%%.....%%%%%%%%%%%......%%%.................%%.............%%%%....%%%%.......
m ..............%%%%%%%%%%%%%%%%%%%%%%%%%%%%%%%....%%%......%%%%%%%%%%%.....%%%.................%%%............%%%.....%%%........
m .............%.%%%%..%.....%%%.%.%%%%%%%.%%%%....%.......%%%%%%%%...........%................%%%%............%%%.....%%%%.......
m ....%..%%%%.%....................%%%%.....%%%............%%%%................%...........%%%%%%%%.......%....%%%%.%%%%%%%.%.%%%.
m %%%%%%%%%%%%......................%%%.....%%%............%%%.................%%%.....%%%%%%%%%%%......%%%....%%%%%%%%%%%%%%%%%%%
m %%%%%%%%%%%%%....................%%%%....%%%%.............%%.................%%%......%%%%%%%%%%%.....%%......%%%%%%%%%%%%%%%%%%
m %%.%%.%%%%%%%...................3%%%%....%%%.............%%%%.................%%%.....%%%%.%%.%%......%%%....%.%.%%...%%%%..%...
m .........%%%%....%.......%%%%.%%%%%%.....%%%%....%.%.%%.%%%%......%%%%................%%..............%%........................
m .........%%%%.....%%%....%%%%%%%%%%%.....%%%%....%%%%%%%%%%%%....%%%%%%%%%%%%........%%%..............%%%.......................
m .........%%%......%%%....%%%%%%%%%%%%....%%%.....%%%%%%%%%%%%.....%%%%%%%%%%%........%%%..............%%........................
m ..........%%......%%%.......%%%%...%.............%..%%%....%.........%...%%%%........%%%%............%%%........................
m .........%%%%.............................................................%%%%%.%.....%%.......%..%%%%%%%%%%.%.......%%.%.....%.
m %........%%%..............................................................%%%%%%%.....%%%....%%%%%%%%%%%%%%%%%%%%....%%%.....%%%
m %.........%%..............................................................%%%%%%......%%%....%%%%%%%%%%%%%%%%%%%%....%%%.....%%%
m .........%%%.............................................................%%%%.%........%.....%%%%%..%..%.%.%...%......%%%.....%%
m %.%%.....%%%.....%%%.......%.....%..%%%.%%%.%....%.%%%......%.%...%%..%%.%%%%.........................................%%%.....%%
m %%%%......%%.....%%%......%%%.....%%%%%%%%%%%....%%%%%%%%%%%%%%%%%%%%%%%%%%%%.........................................%%%.....%%
m %%%%%.....%%%....%%%.....%%%%.....%%%%%%%%%%%....%%%%%%%%%%%%%%%%%%%%%%%%%%%%........................................%%%......%%
m ..%%......%%%....%%%%.....%%%.....%%%%%%%%%%%.....%%%%%%%%%%%%%%%%%%%%%%%%%%%........................................%%%........
m .........%%%%.....%%%............................%%%............................................................................
m ..........%%.....%%%%.............................%%%...........................................................................
m ..........%%%....%%%%............................%%%%...........................................................................
m .........%%%....1%%%..............................%%............................................................................
m %%..%....%%%%%.%%%%%.....%........%%%.%..%.......%%%........%.%%%%.%.%%.%..%..%..%.%..%....%.%.%%..%.%%..........%...%%%%......%
m %%%%.....%%%%%%%%%%%......%%%....%%%%%%%%%%%.....%%%.....%%%%%%%%%%%%%%%%%%%%%%%%%%%%%%%%%%%%%%%%%%%%%%%%%%%.....%%%%%%%%....%%%
m %%%%%....%%%%%%%%%%%%.....%%%....%%%%%%%%%%%......%%%.....%%%%%%%%%%%%%%%%%%%%%%%%%%%%%%%%%%%%%%%%%%%%%%%%%%%....%%%%%%%%....%%%
m ..%%%.....%%%%%%%..%.....%%%%....%%%%..%%%.........%.....%%%%.%%.%%%%..%.%.%%...%%...%.%..%..%%%.%%%%.%...%.%....%%..%%%%....%%.
m ..........%%%............%%%%.....%%.....................%%%......................................%%%.................%%........
m ..........%%%............%%%%....%%%.....................%%%%....................................%%%%.................%%........
m .........%%%%.............%%%.....%%%....................%%%%.....................................%%.................%%%........
m .........%%%.............%%%%.....%%%.....................%%......................................%%%................%%%%.......
m ..%%......%%%..%%%%%.....%%%%....%%%%....%...%..%..%%%.%%%%%%....%.%%....%%.%........%...%....%%%%%%........%%%%%...............
m .%%%.....%%%%%%%%%%%.....%%%%.....%%......%%%%%%%%%%%%%%%%%%.....%%%%....%%%%%%%%%%%%%%%%%%%%%%%%%%%......%%%%%%%...............
m ..%%......%%%%%%%%%%......%%%.....%%......%%%%%%%%%%%%%%%%%%.....%%%%.....%%%%%%%%%%%%%%%%%%%%%%%%%%......%%%%%%%...............
m ..%%%....%.%%%%%.%%......%%%%.............%%%...%..%%%%%..%.......%%%....%%%%%.%%%.%%%..%%%%%%...%%.......%%%%%%%...............
m ..%%.....................................%%%.....................%%%.....%%%..............%%..............%%%%%%%....%%.........
m .%%%%.....................................%%......................%%%.....%%..............%%.............%%%%%%%......%%........
m ..%%%.....................................%%......................%%.....%%%%............%%%.............%%%%%%%.....%%%........
m .%%%%....................................%%%%.....................%%.....%%%.............%%%%.............%%..........%%........
m ..%%%..%.%.%%....%%%%....%%%.%.%.%%.......%%......%%.....%%%%%.%%%%%%%%..%%%........%....%%%%....%......%.............%%........
m .%%%%%%%%%%%......%%......%%%%%%%%%%......%%.....%%%.....%%%%%%%%%%%%%%%%%%%%....%%%%.....%%%....%%%%%%%..............%%........
m ..%%%%%%%%%%.....%%%.....%%%%%%%%%%%%....%%%%....%%%%....%%%%%%%%%%%%%%%%%%%%.....%%%.....%%.....%%%%%%%.............%%%%.......
m ..%%%%............%%%....%%%%.%%...%.....%%%%......%........%.%..%%.%%%.%%%%%.....%%......%%%.....%%%%%%..............%%%.......
m .%%%%............%%%%....%%%%............%%%%............................%%%.....%%%%....1........%%%%%%.........%.%%%%%........
m ..%%%............%%%%.....%%%.............%%%............................%%%%....%%%%............%%%%%%%......%%%%%%%%%%%.......
m ..%%%.............%%......%%%............%%%%............................%%%.....%%%%............%%%%%%%.....%%%%%%%%%%%........
m .%%%.............%%%......%%%............%%%..............................%%.....%%%%............%%%..%%%....%%%%..%.%%%........
m .%%%......%.%%%.%%%%......%%%.....%.%%%%.%%%.....%%%.....%%.%....%%.%....%%%%.....%%%..%%.%%.%.%%.............%%%.....%%%.......
m .%%%%....%%%%%%%%%%%......%%%.....%%%%%%%%%%%....%%%.....%%%.....%%%%....%%%......%%%%%%%%%%%%%%%.............%%%....%%%%.......
m .%%%.....%%%%%%%%%%%%.....%%%.....%%%%%%%%%%.....%%%......%%%....%%%%....%%%%.....%%%%%%%%%%%%%%..............%%%....%%%........
m .%%%......%%%%..%.%%.....%%%%....%%%%.%%.%.......%%%%....%.%%.....%%%....%%%%............%%%%%%%%............%%%.....%%%%.......
m .........%%%%.............%%%.....%%.............%%%..............%%......%%%.............%%%%%%.....%.%%%...%%%......%%........
m .........%%%%............%%%%....%%%%.............%%%............%%%%.....%%.............%%%%%%%%....%%%%%%%%%%%......%%%.......
