# map type: blank
# random seed: 640560704
# hill distance  59, 55  19, 50  11,  7  35, 79  67,  2  83, 31  43, 26  91, 74
#        59, 55       0      71      96      48      67      48      71      61 
#        19, 50      71       0      67      71      96      61      48      48 
#        11,  7      96      67       0      48      71      48      61      71 
#        35, 79      48      71      48       0      61      96      67      71 
#        67,  2      67      96      71      61       0      71      48      48 
#        83, 31      48      61      48      96      71       0      71      67 
#        43, 26      71      48      61      67      48      71       0      96 
#        91, 74      61      48      71      71      48      67      96       0 
players 4
rows 96
cols 96
m %%%%%%%.....%%%%%%%%%%.....%%%......%%%%%%%%%%%.....%%%.....%%%%%%%%%%%....%%%%.....%%%....%%%%%
m %%%%%%.....%%%%%%%%%%%.....%%%.....%%%%%%%%%%%%....%%%%.....%%%%%%%%%%%....%%%.....%%%%.....%%%%
m ..%%%%%.......%...%%%%..............%%%.%.%%..%....%%......%%..%.%%%%%%....%%%.....%%%%......%.%
m ...%%%%............%%%%.............%%%............................%%%%....%%%%....%%%..........
m ...%%%..............%%%.............%%.............................%%%......%%.....%%%%.........
m ....%%%............%%%%............%%%.............................%%%%.....%%%....%%%%.........
m ...%%%..............%%%............%%%.............................%%%%....%%%.....%%%..........
m ....%%......%......%%%.....%..%%..%%%%......%%.%%%..%%.....%%.%....%%%%.....%%%....%%%......%...
m ....%%%.....%%%....%%%%....%%%%%%%%%%%%....%%%%%%%%%%%%.....%%%....%%%.....%%%.....%%%.....%%%..
m ...%%%.....%%%%.....%%.....%%%%%%%%%%%%.....%%%%%%%%%%%....%%%%....%%%......%%......%%%....%%%..
m ...%%%.....%%%%.......%....%%%%.%%.%%%.....%%%.%%%%%.%......%%%.....%%%....%%......%%%%....%%%..
m ...%%%.1...................%%%%.....%%......................................................%%..
m ....%%%....................%%%%.....%%%....................................................%%%%.
m ...%%%.....................%%%%....%%%%.....................................................%%%.
m ....%%%.....................%%%.....%%......................................................%%..
m ....%%%....%%..............%%%%....%%%%%%%%%%........%.%%%%%%%%%%%%%%%%%%%%%%%%%%%%%.......%%%..
m ....%%%.....%%%.....%%.....%%%%.....%%%%%%%%%%.....%%%%%%%%%%%%%%%%%%%%%%%%%%%%%%%%%%%%%%%%%%%%.
m ....%%.....%%%.....%%%%.....%%%.....%%%%%%%%%%%....%%%%%%%%%%%%%%%%%%%%%%%%%%%%%%%%%%%%%%%%%%%..
m ....%........%%.....%%......%%%.....%%.%.%%%%......%%%%%%...%.%..%...%.%%%%%.%..%..%%%%%%%%%..%.
m ...................%%%%.....%%%...................2%%%.............................%%%%.........
m ....................%%%.....%%%....................%%%%.............................%%%.........
m ...................%%%%....%%%%....................%%%.............................%%%%.........
m ...................%%%%....%%%%....................%%%%............................%%%%.........
m ...%.%......%%....%%%%......%%%....%......%%..%.....%%%............%....%%%..%.....%%%%%%%%%%.%.
m ...%%%......%%%%%%%%%%%.....%%%.....%%%%%%%%%%%....%%%%.....%%%....%%%%%%%%%%%%.....%%%%%%%%%%..
m ...%%%.....%%%%%%%%%%%%....%%%%.....%%%%%%%%%%%....%%%.....%%%%.....%%%%%%%%%%.....%%%%%%%%%%%..
m ............%%%.%.%%..%....%%......%%..%.%%%%%%....%%%.....%%%%......%.%..%%%%%.......%...%%%%..
m ............%%%............................%%%%....%%%%....%%%.............%%%%............%%%%.
m ............%%.............................%%%......%%.....%%%%............%%%..............%%%.
m ...........%%%.............................%%%%.....%%%....%%%%.............%%%............%%%%.
m ...........%%%.............................%%%%....%%%.....%%%.............%%%..............%%%.
m ...%..%%..%%%%......%%.%%%..%%.....%%.%....%%%%.....%%%....%%%......%.......%%......%......%%%..
m ...%%%%%%%%%%%%....%%%%%%%%%%%%.....%%%....%%%.....%%%.....%%%.....%%%......%%%.....%%%....%%%%.
m ...%%%%%%%%%%%%.....%%%%%%%%%%%....%%%%....%%%......%%......%%%....%%%.....%%%.....%%%%.....%%..
m ...%%%%.%%.%%%.....%%%.%%%%%.%......%%%.....%%%....%%......%%%%....%%%.....%%%.....%%%%.......%.
m ...%%%%.....%%......................................................%%.....%%%.0................
m ...%%%%.....%%%....................................................%%%%.....%%%.................
m ...%%%%....%%%%.....................................................%%%....%%%..................
m ....%%%.....%%......................................................%%......%%%.................
m ...%%%%....%%%%%%%%%%........%.%%%%%%%%%%%%%%%%%%%%%%%%%%%%%.......%%%......%%%....%%...........
m ...%%%%.....%%%%%%%%%%.....%%%%%%%%%%%%%%%%%%%%%%%%%%%%%%%%%%%%%%%%%%%%.....%%%.....%%%.....%%..
m ....%%%.....%%%%%%%%%%%....%%%%%%%%%%%%%%%%%%%%%%%%%%%%%%%%%%%%%%%%%%%......%%.....%%%.....%%%%.
m ....%%%.....%%.%.%%%%......%%%%%%...%.%..%...%.%%%%%.%..%..%%%%%%%%%..%.....%........%%.....%%..
m ....%%%...................1%%%.............................%%%%............................%%%%.
m ....%%%....................%%%%.............................%%%.............................%%%.
m ...%%%%....................%%%.............................%%%%............................%%%%.
m ...%%%%....................%%%%............................%%%%............................%%%%.
m ....%%%....%......%%..%.....%%%............%....%%%..%.....%%%%%%%%%%.%....%.%......%%....%%%%..
m ....%%%.....%%%%%%%%%%%....%%%%.....%%%....%%%%%%%%%%%%.....%%%%%%%%%%.....%%%......%%%%%%%%%%%.
m ...%%%%.....%%%%%%%%%%%....%%%.....%%%%.....%%%%%%%%%%.....%%%%%%%%%%%.....%%%.....%%%%%%%%%%%%.
m ...%%......%%..%.%%%%%%....%%%.....%%%%......%.%..%%%%%.......%...%%%%..............%%%.%.%%..%.
m ...................%%%%....%%%%....%%%.............%%%%............%%%%.............%%%.........
m ...................%%%......%%.....%%%%............%%%..............%%%.............%%..........
m ...................%%%%.....%%%....%%%%.............%%%............%%%%............%%%..........
m ...................%%%%....%%%.....%%%.............%%%..............%%%............%%%..........
m %%..%%.....%%.%....%%%%.....%%%....%%%......%.......%%......%......%%%.....%..%%..%%%%......%%.%
m %%%%%%%.....%%%....%%%.....%%%.....%%%.....%%%......%%%.....%%%....%%%%....%%%%%%%%%%%%....%%%%%
m %%%%%%%....%%%%....%%%......%%......%%%....%%%.....%%%.....%%%%.....%%.....%%%%%%%%%%%%.....%%%%
m %%%%.%......%%%.....%%%....%%......%%%%....%%%.....%%%.....%%%%.......%....%%%%.%%.%%%.....%%%.%
m ............................................%%.....%%%.3...................%%%%.....%%..........
m ...........................................%%%%.....%%%....................%%%%.....%%%.........
m ............................................%%%....%%%.....................%%%%....%%%%.........
m ............................................%%......%%%.....................%%%.....%%..........
m .....%.%%%%%%%%%%%%%%%%%%%%%%%%%%%%%.......%%%......%%%....%%..............%%%%....%%%%%%%%%%...
m ...%%%%%%%%%%%%%%%%%%%%%%%%%%%%%%%%%%%%%%%%%%%%.....%%%.....%%%.....%%.....%%%%.....%%%%%%%%%%..
m ...%%%%%%%%%%%%%%%%%%%%%%%%%%%%%%%%%%%%%%%%%%%......%%.....%%%.....%%%%.....%%%.....%%%%%%%%%%%.
m ...%%%%%%...%.%..%...%.%%%%%.%..%..%%%%%%%%%..%.....%........%%.....%%......%%%.....%%.%.%%%%...
m ..0%%%.............................%%%%............................%%%%.....%%%.................
m ...%%%%.............................%%%.............................%%%.....%%%.................
m ...%%%.............................%%%%............................%%%%....%%%%.................
m ...%%%%............................%%%%............................%%%%....%%%%.................
m ....%%%............%....%%%..%.....%%%%%%%%%%.%....%.%......%%....%%%%......%%%....%......%%..%.
m ...%%%%.....%%%....%%%%%%%%%%%%.....%%%%%%%%%%.....%%%......%%%%%%%%%%%.....%%%.....%%%%%%%%%%%.
m ...%%%.....%%%%.....%%%%%%%%%%.....%%%%%%%%%%%.....%%%.....%%%%%%%%%%%%....%%%%.....%%%%%%%%%%%.
m ...%%%.....%%%%......%.%..%%%%%.......%...%%%%..............%%%.%.%%..%....%%......%%..%.%%%%%%.
m ...%%%%....%%%.............%%%%............%%%%.............%%%............................%%%%.
m ....%%.....%%%%............%%%..............%%%.............%%.............................%%%..
m ....%%%....%%%%.............%%%............%%%%............%%%.............................%%%%.
m ...%%%.....%%%.............%%%..............%%%............%%%.............................%%%%.
m ....%%%....%%%......%.......%%......%......%%%.....%..%%..%%%%......%%.%%%..%%.....%%.%....%%%%.
m ...%%%.....%%%.....%%%......%%%.....%%%....%%%%....%%%%%%%%%%%%....%%%%%%%%%%%%.....%%%....%%%..
m ....%%......%%%....%%%.....%%%.....%%%%.....%%.....%%%%%%%%%%%%.....%%%%%%%%%%%....%%%%....%%%..
m ...%%......%%%%....%%%.....%%%.....%%%%.......%....%%%%.%%.%%%.....%%%.%%%%%.%......%%%.....%%%.
m ....................%%.....%%%.2...................%%%%.....%%..................................
m ...................%%%%.....%%%....................%%%%.....%%%.................................
m ....................%%%....%%%.....................%%%%....%%%%.................................
m ....................%%......%%%.....................%%%.....%%..................................
m %%%%%%%%%%%%.......%%%......%%%....%%..............%%%%....%%%%%%%%%%........%.%%%%%%%%%%%%%%%%%
m %%%%%%%%%%%%%%%%%%%%%%%.....%%%.....%%%.....%%.....%%%%.....%%%%%%%%%%.....%%%%%%%%%%%%%%%%%%%%%
m %%%%%%%%%%%%%%%%%%%%%%......%%.....%%%.....%%%%.....%%%.....%%%%%%%%%%%....%%%%%%%%%%%%%%%%%%%%%
m %%%%.%..%..%%%%%%%%%..%.....%........%%.....%%......%%%.....%%.%.%%%%......%%%%%%...%.%..%...%.%
m ...........%%%%............................%%%%.....%%%...................3%%%..................
m ............%%%.............................%%%.....%%%....................%%%%.................
m ...........%%%%............................%%%%....%%%%....................%%%..................
m ...........%%%%............................%%%%....%%%%....................%%%%.................
m %%%..%.....%%%%%%%%%%.%....%.%......%%....%%%%......%%%....%......%%..%.....%%%............%....
