# map type: blank
# random seed: -332009335
# hill distance  18, 23  56,121 100, 52 114,119 104, 25   4,100  32, 82  28, 67  80,130   8, 73  76,115  66, 71  52,  4 128, 34 124, 19
#        18, 23       0      84      95      96      84      95     111      76      99      84     110      96      53      49      56 
#        56,121      84       0     133      84     132     107      83     104      63     132      32      84      45     129     124 
#       100, 52      95     133       0      95      45     124      98     101     100     107     125      53     124      46      71 
#       114,119      96      84      95       0      84      53      99     110      49      84      56      96      95     111      76 
#       104, 25      84     132      45      84       0     133     129     124      83     132     104      84     107      63      32 
#         4,100      95     107     124      53     133       0      46      71      98      45     101      95     124     100     125 
#        32, 82     111      83      98      99     129      46       0      35     112      63      77      49     100     112     131 
#        28, 67      76     104     101     110     124      71      35       0     131      32      96      56     125      77      96 
#        80,130      99      63     100      49      83      98     112     131       0     129      35     111      46     112      77 
#         8, 73      84     132     107      84     132      45      63      32     129       0     124      84     133      83     104 
#        76,115     110      32     125      56     104     101      77      96      35     124       0      76      71     131      96 
#        66, 71      96      84      53      96      84      95      49      56     111      84      76       0      95      99     110 
#        52,  4      53      45     124      95     107     124     100     125      46     133      71      95       0      98     101 
#       128, 34      49     129      46     111      63     100     112      77     112      83     131      99      98       0      35 
#       124, 19      56     124      71      76      32     125     131      96      77     104      96     110     101      35       0 
players 3
rows 144
cols 144
m %%%%.......%%%%%%%%%%%%%%%%.......%%%%%%%%%%%%%%%%%.......%%%%%%%%%%%%%%%%%........%%%%........%%%%........%%%%.......%%%%%.......%%%%%%......%%
m %%%........%%%%%%%%%%%%%%%%%.......%%%%%%%%%%%%%%%%........%%%%%%%%%%%%%%%%%......%%%%%%.......%%%%.......%%%%%%......%%%%%.......%%%%%%.......%
m %%%%......%%%%%%%%%%%%%%%%%.......%%%%%%%%%%%%%%%%%.......%%%%%%%%%%%%%%%%%%.......%%%%%.......%%%%%......%%%%%%.......%%%%........%%%%%.......%
m %%.%......%%.%.%%%%%..%%%%%........%..%%.%%%%%.%.%.%.......%%%%%..%.%..%%..........%%%%.......%%%%%%.......%%%%%.......%...%......%%%%%%......%.
m ..........................................................%%%%%...................%%%%%.......%%%%%%0.....%%%%%...................%%%%%%........
m ..........................................................%%%%%%...................%%%%%.......%%%%%......%%%%%....................%%%%.........
m ..........................................................%%%%%%..................%%%%%%.......%%%%.......%%%%%%..................%%%%%%........
m ..........................................................%%%%%%..................%%%%%........%%%%........%%%%%..................%%%%%%........
m ..........................................................%%%%%%.........1........%%%%%........%%%%%......%%%%%....................%%%%.........
m ..........................................................%%%%%%...................%%%%.......%%%%%.......%%%%%%...................%%%%.........
m %.%.%%%%%%%%%%%.......%%%%%%%%%%%%...%.%%%%.%.%%%%%%......%%%%%%....%...%%%.......%%%%%.......%%%%%........%%%%%%..%.%%%%.%%.......%%%%.......%.
m %%%%%%%%%%%%%%%........%%%%%%%%%%%%%%%%%%%%%%%%%%%%%......%%%%%%%%%%%%%%%%%........%%%%%......%%%%%........%%%%%%%%%%%%%%%%%.......%%%%%......%%
m %%%%%%%%%%%%%%%........%%%%%%%%%%%%%%%%%%%%%%%%%%%%.......%%%%%%%%%%%%%%%%%%.......%%%%........%%%%.......%%%%%%%%%%%%%%%%%%.......%%%%........%
m %%%%%%%%%%%%%%%%.......%%%%%%%%%%%%%%%%%%%%%%%%%%%%.......%%%%%%%%%%%%%%%%%%.......%%%%%......%%%%%%......%%%%%%%%%%%%%%%%%%.......%%%%%.......%
m %%%%%%%%%%%%%%%%......%%%%%%%%%%%%%%%%%%%%%%%%%%%%%.......%%%%%%%%%%%%%%%%%%.......%%%%%......%%%%%........%%%%%%%%%%%%%%%%%.......%%%%........%
m %%%%.%%.%.%.%.........%%%.%.%%%%%%%%%%%%%%%..%%.%%.%......%%.%%.%....%%.%.%........%%%%%......%.%.%........%.%%%.%%..%...%%.........%%.........%
m %%%...............................%%%%%%...........................................%%%%%......................................................%%
m %%%...............................%%%%%%...........................................%%%%%......................................................%%
m %%%%...................2..........%%%%%%...........................................%%%%.......................................................%%
m %%%...............................%%%%%%..........................................%%%%%.......................................................%%
m %%%%...............................%%%%%...........................................%%%%.......................................................%%
m %%%%..............................%%%%%%...........................................%%%%%......................................................%%
m %%%%........%..%%.%..%%%.%.........%%%%%%%%%%%....%.......%%.%........%%%%%..%%.%.%%%%%.......%.%%....%%%%..%%%.%%%.%.%%.%.%.%%%%.%%%..%%%%%%%%%
m %%%........%%%%%%%%%%%%%%%%%......%%%%%%%%%%%%%%%%%%......%%%%%%......%%%%%%%%%%%%%%%%%........%%%%%%%%%%%%%%%%%%%%%%%%%%%%%%%%%%%%%%%%%%%%%%%%%
m %%%%.......%%%%%%%%%%%%%%%%........%%%%%%%%%%%%%%%%.......%%%%%........%%%%%%%%%%%%%%%%%.......%%%%%%%%%%%%%%%%%%%%%%%%%%%%%%%%%%%%%%%%%%%%%%%%%
m %%%%.......%%%%%%%%%%%%%%%%%......%%%%%%%%%%%%%%%%%%......%%%%%%......%%%%%%%%%%%%%%%%%%......%%%%%%%%%%%%%%%%%%%%%%%%%%%%%%%%%%%%%%%%%%%%%%%%%%
m %%%........%%%%%%%%%%%%%%%%.......%%%%%%%%%%%%%%%%%%......%%%%%.......%%%%%%%%%%%%%%%%%%.......%%%%%%%%%%%%%%%%%%%%%%%%%%%%%%%%%%%%%%%%%%%%%%%%%
m %%%.......%%%.%%.%%...%%%%%%......%..%.%.%.%..%%%%%.......%%..........%%%%%%%.%%.%.%..%........%%%%%%.%%%%%.%%.%......%%%...%.%.%%%%%%%%.%..%.%%
m %%%%...................%%%%%...................%%%%%...............0...%%%%%..................%%%%%%...........................................%
m %%%...................%%%%%....................%%%%%..................%%%%%...................%%%%%............................................%
m %%%%...................%%%%%...................%%%%%...................%%%%%..................%%%%%%..........................................%%
m %%%%..................%%%%%...................%%%%%%...................%%%%...................%%%%%...........................................%%
m %%%...................%%%%%%..................%%%%%%..................%%%%%%......0............%%%%...........................................%%
m %%%....................%%%%...................%%%%%%...................%%%%...................%%%%%%...........................................%
m %%%.........%.........%%%%%.......%%.%........%%%%%%%%%%%%..%%........%%%%%.........%.%%......%%%%%.......%.%..%......%%.%%.......%...%%......%%
m %%%.......%%%%%........%%%%%......%%%%%.......%%%%%%%%%%%%%%%%%........%%%%%.......%%%%.......%%%%%........%%%%.......%%%%%%......%%%%%........%
m %%%.......%%%%%.......%%%%%%.......%%%%%.......%%%%%%%%%%%%%%%%........%%%%........%%%%........%%%%........%%%%%.......%%%%%.......%%%%%......%%
m %%%........%%%%%.......%%%%%.......%%%%........%%%%%%%%%%%%%%%%........%%%%.......%%%%%%.......%%%%........%%%%%......%%%%%%......%%%%%%.......%
m %%%%......%%%%%........%%%%........%%%%.......%%%%%%%%%%%%%%%%%.......%%%%%........%%%%........%%%%%......%%%%%........%%%%%.......%%%%.......%%
m %..........%%%%%.......%%%%.......%%%%%%......%..%.%..%..%%%%%%%......%%%.%%.......%%%%%......%%.%%%.......%%%%........%%%%%........%%.%......%%
m ..........%%%%%%......%%%%%.......%%%%%....................%%%%%..................%%%%%...................%%%%%%................................
m ...........%%%%%.......%%%%........%%%%%...................%%%%%...................%%%%%..................%%%%%%................................
m ...........%%%%%.......%%%%%......%%%%%....................%%%%%..................%%%%%%...................%%%%.................................
m ...........%%%%%......%%%%%%.......%%%%...................%%%%%%...................%%%%...................%%%%%.................................
m ...........%%%%........%%%%%......%%%%%....................%%%%%...................%%%%....................%%%%%................................
m ...........%%%%.......%%%%%.......%%%%%....................%%%%%...................%%%%%..................%%%%%.................................
m %.%%.......%%%%%.......%%%%%......%%%%%........%%%%.......%%%%%%%%%%%%%.%..%.......%%%%%%%.....%%..........%%%%%%%%%%%%.%.%.......%..%.%......%%
m %%%%......%%%%%.......%%%%%%.......%%%%%.......%%%%%.......%%%%%%%%%%%%%%%%%......%%%%%%%%%%%%%%%%%%......%%%%%%%%%%%%%%%%%%......%%%%%%......%%
m %%%........%%%%.......%%%%%.......%%%%%%......%%%%%%.......%%%%%%%%%%%%%%%%.......%%%%%%%%%%%%%%%%%.......%%%%%%%%%%%%%%%%%........%%%%........%
m %%%.......%%%%%%......%%%%%.......%%%%%%.......%%%%........%%%%%%%%%%%%%%%%%.......%%%%%%%%%%%%%%%%........%%%%%%%%%%%%%%%%%......%%%%%%.......%
m %%%%......%%%%%%.......%%%%........%%%%%.......%%%%%......%%%%%%%%%%%%%%%%%.......%%%%%%%%%%%%%%%%%.......%%%%%%%%%%%%%%%%%%.......%%%%%.......%
m %%%%.......%%%%%.......%...%......%%%%%%......%.%%.%......%%.%.%%%%%..%%%%%........%..%%.%%%%%.%.%.%.......%%%%%..%.%..%%..........%%%%.......%%
m %%%%2.....%%%%%...................%%%%%%..................................................................%%%%%...................%%%%%.......%%
m %%%%......%%%%%....................%%%%...................................................................%%%%%%...................%%%%%.......%
m %%%.......%%%%%%..................%%%%%%..................................................................%%%%%%..................%%%%%%.......%
m %%%........%%%%%..................%%%%%%..................................................................%%%%%%..................%%%%%........%
m %%%%......%%%%%....................%%%%...................................................................%%%%%%.........0........%%%%%........%
m %%%.......%%%%%%...................%%%%...................................................................%%%%%%...................%%%%.......%%
m %%%........%%%%%%..%.%%%%.%%.......%%%%.......%.%.%.%%%%%%%%%%%.......%%%%%%%%%%%%...%.%%%%.%.%%%%%%......%%%%%%....%...%%%.......%%%%%.......%%
m %%%........%%%%%%%%%%%%%%%%%.......%%%%%......%%%%%%%%%%%%%%%%%........%%%%%%%%%%%%%%%%%%%%%%%%%%%%%......%%%%%%%%%%%%%%%%%........%%%%%......%%
m %%%.......%%%%%%%%%%%%%%%%%%.......%%%%........%%%%%%%%%%%%%%%%........%%%%%%%%%%%%%%%%%%%%%%%%%%%%.......%%%%%%%%%%%%%%%%%%.......%%%%........%
m %%%%......%%%%%%%%%%%%%%%%%%.......%%%%%.......%%%%%%%%%%%%%%%%%.......%%%%%%%%%%%%%%%%%%%%%%%%%%%%.......%%%%%%%%%%%%%%%%%%.......%%%%%......%%
m %%%........%%%%%%%%%%%%%%%%%.......%%%%........%%%%%%%%%%%%%%%%%......%%%%%%%%%%%%%%%%%%%%%%%%%%%%%.......%%%%%%%%%%%%%%%%%%.......%%%%%......%%
m %.%........%.%%%.%%..%...%%.........%%.........%%%%%.%%.%.%.%.........%%%.%.%%%%%%%%%%%%%%%..%%.%%.%......%%.%%.%....%%.%.%........%%%%%......%.
m ..............................................%%%%%...............................%%%%%%...........................................%%%%%........
m ..............................................%%%%%...............................%%%%%%...........................................%%%%%........
m ..............................................%%%%%%...................1..........%%%%%%...........................................%%%%.........
m ..............................................%%%%%...............................%%%%%%..........................................%%%%%.........
m ..............................................%%%%%%...............................%%%%%...........................................%%%%.........
m ..............................................%%%%%%..............................%%%%%%...........................................%%%%%........
m %%....%%%%..%%%.%%%.%.%%.%.%.%%%%.%%%..%%%%%%%%%%%%%........%..%%.%..%%%.%.........%%%%%%%%%%%....%.......%%.%........%%%%%..%%.%.%%%%%.......%.
m %%%%%%%%%%%%%%%%%%%%%%%%%%%%%%%%%%%%%%%%%%%%%%%%%%%........%%%%%%%%%%%%%%%%%......%%%%%%%%%%%%%%%%%%......%%%%%%......%%%%%%%%%%%%%%%%%........%
m %%%%%%%%%%%%%%%%%%%%%%%%%%%%%%%%%%%%%%%%%%%%%%%%%%%%.......%%%%%%%%%%%%%%%%........%%%%%%%%%%%%%%%%.......%%%%%........%%%%%%%%%%%%%%%%%.......%
m %%%%%%%%%%%%%%%%%%%%%%%%%%%%%%%%%%%%%%%%%%%%%%%%%%%%.......%%%%%%%%%%%%%%%%%......%%%%%%%%%%%%%%%%%%......%%%%%%......%%%%%%%%%%%%%%%%%%......%%
m %%%%%%%%%%%%%%%%%%%%%%%%%%%%%%%%%%%%%%%%%%%%%%%%%%%........%%%%%%%%%%%%%%%%.......%%%%%%%%%%%%%%%%%%......%%%%%.......%%%%%%%%%%%%%%%%%%.......%
m %%%%%.%%%%%.%%.%......%%%...%.%.%%%%%%%%.%..%.%%%%%.......%%%.%%.%%...%%%%%%......%..%.%.%.%..%%%%%.......%%..........%%%%%%%.%%.%.%..%........%
m %%%%...........................................%%%%%...................%%%%%...................%%%%%...............2...%%%%%..................%%
m %%%............................................%%%%...................%%%%%....................%%%%%..................%%%%%...................%%
m %%%%..........................................%%%%%%...................%%%%%...................%%%%%...................%%%%%..................%%
m %%%...........................................%%%%%%..................%%%%%...................%%%%%%...................%%%%...................%%
m %%%...........................................%%%%%...................%%%%%%..................%%%%%%..................%%%%%%......2............%
m %%%%...........................................%%%%....................%%%%...................%%%%%%...................%%%%...................%%
m %%%.......%.%..%......%%.%%.......%...%%......%%%%%.........%.........%%%%%.......%%.%........%%%%%%%%%%%%..%%........%%%%%.........%.%%......%%
m %%%........%%%%.......%%%%%%......%%%%%........%%%%.......%%%%%........%%%%%......%%%%%.......%%%%%%%%%%%%%%%%%........%%%%%.......%%%%.......%%
m %%%........%%%%%.......%%%%%.......%%%%%......%%%%%.......%%%%%.......%%%%%%.......%%%%%.......%%%%%%%%%%%%%%%%........%%%%........%%%%........%
m %%%........%%%%%......%%%%%%......%%%%%%.......%%%%........%%%%%.......%%%%%.......%%%%........%%%%%%%%%%%%%%%%........%%%%.......%%%%%%.......%
m %%%%......%%%%%........%%%%%.......%%%%.......%%%%%%......%%%%%........%%%%........%%%%.......%%%%%%%%%%%%%%%%%.......%%%%%........%%%%........%
m .%%%.......%%%%........%%%%%........%%.%......%%%..........%%%%%.......%%%%.......%%%%%%......%..%.%..%..%%%%%%%......%%%.%%.......%%%%%......%%
m ..........%%%%%%..........................................%%%%%%......%%%%%.......%%%%%....................%%%%%..................%%%%%.........
m ..........%%%%%%...........................................%%%%%.......%%%%........%%%%%...................%%%%%...................%%%%%........
m ...........%%%%............................................%%%%%.......%%%%%......%%%%%....................%%%%%..................%%%%%%........
m ..........%%%%%............................................%%%%%......%%%%%%.......%%%%...................%%%%%%...................%%%%.........
m ...........%%%%%...........................................%%%%........%%%%%......%%%%%....................%%%%%...................%%%%.........
m ..........%%%%%............................................%%%%.......%%%%%.......%%%%%....................%%%%%...................%%%%%........
m %..........%%%%%%%%%%%%.%.%.......%..%.%......%%%.%%.......%%%%%.......%%%%%......%%%%%........%%%%.......%%%%%%%%%%%%%.%..%.......%%%%%%%.....%
m %%%%......%%%%%%%%%%%%%%%%%%......%%%%%%......%%%%%%......%%%%%.......%%%%%%.......%%%%%.......%%%%%.......%%%%%%%%%%%%%%%%%......%%%%%%%%%%%%%%
m %%%.......%%%%%%%%%%%%%%%%%........%%%%........%%%%........%%%%.......%%%%%.......%%%%%%......%%%%%%.......%%%%%%%%%%%%%%%%.......%%%%%%%%%%%%%%
m %%%........%%%%%%%%%%%%%%%%%......%%%%%%.......%%%%.......%%%%%%......%%%%%.......%%%%%%.......%%%%........%%%%%%%%%%%%%%%%%.......%%%%%%%%%%%%%
m %%%.......%%%%%%%%%%%%%%%%%%.......%%%%%.......%%%%%......%%%%%%.......%%%%........%%%%%.......%%%%%......%%%%%%%%%%%%%%%%%.......%%%%%%%%%%%%%%
m .%.%.......%%%%%..%.%..%%..........%%%%.......%%%%%%.......%%%%%.......%...%......%%%%%%......%.%%.%......%%.%.%%%%%..%%%%%........%..%%.%%%%%.%
m ..........%%%%%...................%%%%%.......%%%%%%1.....%%%%%...................%%%%%%........................................................
m ..........%%%%%%...................%%%%%.......%%%%%......%%%%%....................%%%%.........................................................
m ..........%%%%%%..................%%%%%%.......%%%%.......%%%%%%..................%%%%%%........................................................
m ..........%%%%%%..................%%%%%........%%%%........%%%%%..................%%%%%%........................................................
m ..........%%%%%%.........2........%%%%%........%%%%%......%%%%%....................%%%%.........................................................
m ..........%%%%%%...................%%%%.......%%%%%.......%%%%%%...................%%%%.........................................................
m %%%%......%%%%%%....%...%%%.......%%%%%.......%%%%%........%%%%%%..%.%%%%.%%.......%%%%.......%.%.%.%%%%%%%%%%%.......%%%%%%%%%%%%...%.%%%%.%.%%
m %%%%......%%%%%%%%%%%%%%%%%........%%%%%......%%%%%........%%%%%%%%%%%%%%%%%.......%%%%%......%%%%%%%%%%%%%%%%%........%%%%%%%%%%%%%%%%%%%%%%%%%
m %%%.......%%%%%%%%%%%%%%%%%%.......%%%%........%%%%.......%%%%%%%%%%%%%%%%%%.......%%%%........%%%%%%%%%%%%%%%%........%%%%%%%%%%%%%%%%%%%%%%%%%
m %%%.......%%%%%%%%%%%%%%%%%%.......%%%%%......%%%%%%......%%%%%%%%%%%%%%%%%%.......%%%%%.......%%%%%%%%%%%%%%%%%.......%%%%%%%%%%%%%%%%%%%%%%%%%
m %%%.......%%%%%%%%%%%%%%%%%%.......%%%%%......%%%%%........%%%%%%%%%%%%%%%%%.......%%%%........%%%%%%%%%%%%%%%%%......%%%%%%%%%%%%%%%%%%%%%%%%%%
m %%.%......%%.%%.%....%%.%.%........%%%%%......%.%.%........%.%%%.%%..%...%%.........%%.........%%%%%.%%.%.%.%.........%%%.%.%%%%%%%%%%%%%%%..%%.
m ...................................%%%%%......................................................%%%%%...............................%%%%%%........
m ...................................%%%%%......................................................%%%%%...............................%%%%%%........
m ...................................%%%%.......................................................%%%%%%...................0..........%%%%%%........
m ..................................%%%%%.......................................................%%%%%...............................%%%%%%........
m ...................................%%%%.......................................................%%%%%%...............................%%%%%........
m ...................................%%%%%......................................................%%%%%%..............................%%%%%%........
m ..%.......%%.%........%%%%%..%%.%.%%%%%.......%.%%....%%%%..%%%.%%%.%.%%.%.%.%%%%.%%%..%%%%%%%%%%%%%........%..%%.%..%%%.%.........%%%%%%%%%%%..
m %%%%......%%%%%%......%%%%%%%%%%%%%%%%%........%%%%%%%%%%%%%%%%%%%%%%%%%%%%%%%%%%%%%%%%%%%%%%%%%%%%........%%%%%%%%%%%%%%%%%......%%%%%%%%%%%%%%
m %%%.......%%%%%........%%%%%%%%%%%%%%%%%.......%%%%%%%%%%%%%%%%%%%%%%%%%%%%%%%%%%%%%%%%%%%%%%%%%%%%%.......%%%%%%%%%%%%%%%%........%%%%%%%%%%%%%
m %%%%......%%%%%%......%%%%%%%%%%%%%%%%%%......%%%%%%%%%%%%%%%%%%%%%%%%%%%%%%%%%%%%%%%%%%%%%%%%%%%%%%.......%%%%%%%%%%%%%%%%%......%%%%%%%%%%%%%%
m %%%%......%%%%%.......%%%%%%%%%%%%%%%%%%.......%%%%%%%%%%%%%%%%%%%%%%%%%%%%%%%%%%%%%%%%%%%%%%%%%%%%........%%%%%%%%%%%%%%%%.......%%%%%%%%%%%%%%
m %%%.......%%..........%%%%%%%.%%.%.%..%........%%%%%%.%%%%%.%%.%......%%%...%.%.%%%%%%%%.%..%.%%%%%.......%%%.%%.%%...%%%%%%......%..%.%.%.%..%%
m %%%%...............1...%%%%%..................%%%%%%...........................................%%%%%...................%%%%%...................%
m %%%%..................%%%%%...................%%%%%............................................%%%%...................%%%%%....................%
m %%%%...................%%%%%..................%%%%%%..........................................%%%%%%...................%%%%%...................%
m %%%%...................%%%%...................%%%%%...........................................%%%%%%..................%%%%%...................%%
m %%%%..................%%%%%%......1............%%%%...........................................%%%%%...................%%%%%%..................%%
m %%%%...................%%%%...................%%%%%%...........................................%%%%....................%%%%...................%%
m %%%%%%%%%%..%%........%%%%%.........%.%%......%%%%%.......%.%..%......%%.%%.......%...%%......%%%%%.........%.........%%%%%.......%%.%........%%
m %%%%%%%%%%%%%%%........%%%%%.......%%%%.......%%%%%........%%%%.......%%%%%%......%%%%%........%%%%.......%%%%%........%%%%%......%%%%%.......%%
m %%%%%%%%%%%%%%%........%%%%........%%%%........%%%%........%%%%%.......%%%%%.......%%%%%......%%%%%.......%%%%%.......%%%%%%.......%%%%%.......%
m %%%%%%%%%%%%%%%........%%%%.......%%%%%%.......%%%%........%%%%%......%%%%%%......%%%%%%.......%%%%........%%%%%.......%%%%%.......%%%%........%
m %%%%%%%%%%%%%%%.......%%%%%........%%%%........%%%%%......%%%%%........%%%%%.......%%%%.......%%%%%%......%%%%%........%%%%........%%%%.......%%
m .%.%..%..%%%%%%%......%%%.%%.......%%%%%......%%.%%%.......%%%%........%%%%%........%%.%......%%%..........%%%%%.......%%%%.......%%%%%%......%.
m ...........%%%%%..................%%%%%...................%%%%%%..........................................%%%%%%......%%%%%.......%%%%%.........
m ...........%%%%%...................%%%%%..................%%%%%%...........................................%%%%%.......%%%%........%%%%%........
m ...........%%%%%..................%%%%%%...................%%%%............................................%%%%%.......%%%%%......%%%%%.........
m ..........%%%%%%...................%%%%...................%%%%%............................................%%%%%......%%%%%%.......%%%%.........
m ...........%%%%%...................%%%%....................%%%%%...........................................%%%%........%%%%%......%%%%%.........
m ...........%%%%%...................%%%%%..................%%%%%............................................%%%%.......%%%%%.......%%%%%.........
m %%%.......%%%%%%%%%%%%%.%..%.......%%%%%%%.....%%..........%%%%%%%%%%%%.%.%.......%..%.%......%%%.%%.......%%%%%.......%%%%%......%%%%%........%
m %%%%.......%%%%%%%%%%%%%%%%%......%%%%%%%%%%%%%%%%%%......%%%%%%%%%%%%%%%%%%......%%%%%%......%%%%%%......%%%%%.......%%%%%%.......%%%%%.......%
