# map type: blank
# random seed: 794285378
# hill distance  56, 80  24, 48  72,  3 101, 32
#        56, 80       0      64      79     123 
#        24, 48      64       0     123      79 
#        72,  3      79     123       0     110 
#       101, 32     123      79     110       0 
players 2
rows 120
cols 120
m %%%%%%%.......%%%%%%%%%%%%%%.....%%%%.......%%%%%%%%%%%%%......%%%%%.....%%%%%%%%%%%%%%%%%%%%%%%......%%%%%......%%%%%%%
m %%%%%%%......%%%%%%%%%%%%%%......%%%%%......%%%%%%%%%%%%%%.....%%%%%......%%%..%.%%%%%%.%%%%.%%.......%%%%%......%%%%%%%
m %%%%%%%.......%%%%%%%%%%%%%%.....%%%%.......%%%%%%%%%%%%%.......%%%%.....%%%.....%%%%%...............%%%%%%%......%%%%%%
m ...%%%.......%%%%%%%.%%%%%%%.....%%%%......%%%%%...%%.%%.%.......%%.......%%.....%%%%%...............%%....%.....%%%%%.%
m .............%%%%%......%%%.......%%%......%%%%..........................%%%......%%%............................%%%%%..
m .............%%%%%.....%%%%.......%%%.......%%%%.........................%%%.....%%%%.............................%%%%..
m ..............%%%.......%%%%.....%%%%......%%%%%.........................%%%......%%%%............................%%%...
m ..............%%%%.....%%%%.......%%%......%%%%...........................%%......%%%......%%%%%%%...............%%%%%..
m ..............%%%......%%%%......%%%%......%%%%%..........................%%.....%%%%%.....%%%%%%%................%%%%..
m ...%..%%%%..%%%%%......%%%%%.....%%%%.......%%%%%......%.%.%%...%%.%.%...%%%.....%%%%.......%%%%%%......%..%.....%%%%%..
m ...%%%%%%%%%%%%%%%......%%%%.....%%%%.......%%%%%%%%%%%%%%%%%%%%%%%%%%%%%%%%.....%%%%%.....%%%%%%%.....%%%%%......%%%%..
m ...%%%%%%%%%%%%%%......%%%%%.....%%%%%.....%%%%%%%%%%%%%%%%%%%%%%%%%%%%%%%%%.....%%.%%.....%%%%%%%.....%%%%%......%%%...
m ....%%%%%%%%%%%%%......%%%%%......%%%%......%%%%%%%%%%%%%%%%%%%%%%%%%%%%%%%%...............%%%%%%%......%%%......%%%%%..
m ....%.%%%%....%%%......%%%%%......%%%......%..%..%%%%%.%.%%....%%.%.......%%...............%%%%.%%.....%%%%......%%%%...
m ........................%%%%.....%%%%..................................................................%%%%......%%%%...
m .......................%%%%%......%%%%.................................................................%%%%%.....%%%%%..
m .......................%%%%......%%%%..................................................................%%%%%......%%%...
m .......................%%%%%......%%%..............................................%.%%%................%%%.......%%%...
m ........................%%%......%%%%.............................................%%%%%%...............%%%%%......%%%%..
m .%...%.%%......%.%.....%%%%.......%%%%......%..%%%..%%%.%........%.......%........%%%%%%.....%%.%.%..%%%%%%.......%%%%.%
m %%%%%%%%%%%%%%%%%%.....%%%%%.....%%%%.......%%%%%%%%%%%%%%.....%%%%%.....%%%......%%%%%......%%%%%%%%%%%%%%%......%%%%%%
m %%%%%%%%%%%%%%%%%......%%%%%......%%%%.....%%%%%%%%%%%%%%......%%%%%......%%......%%%%%%......%%%%%%%%%%%%%%.....%%%%%%%
m %%%%%%%%%%%%%%%%%%.....%%%%%......%%%......%%%%%%%%%%%%%%%.....%%%%.......%%.....%%%%%%......%%%%%%%%%%%%%%%......%%%%%%
m %%.%%%%%%.%%%%%%%%......%%%.........%%......%%%%..%...%........%%%%......%%%.....%%..........%%%%..%.%%%%%%%.....%...%%.
m ...%%%%.................%%%.................%%%%0..............%%%%.......%%............................%%%%............
m ....%%%%...............%%%%................%%%%%...............%%%%.......%%...........................%%%%.............
m ...%%%%%...............%%%%%...............%%%%%................%%%%......%%............................%%%%............
m ....%%%................%%%%%................%%%%................%%%......%%%%%..........................%%%.............
m ....%%%................%%%%................%%%%%...............%%%%%......%%%%.........................%%%%%............
m ....%%%%.....%...%.%%%.%%%%%.....%%..%%%%.%%%%%.......%.%......%%%%......%%%%%%%%%%%%......%%%%%%%%%%%%%%%%%%%%%%..%%...
m ....%%%%.....%%%%%%%%%%%%%%%......%%%%%%%%%%%%%%......%%%%......%%%......%%%%%%%%%%%%......%%%%%%%%%%%%%%%%%%%%%%%%%%%..
m ...%%%%......%%%%%%%%%%%%%%.......%%%%%%%%%%%%%%......%%%%......%%%......%%%.%...%..%%......%%%%..%%%.%.%.%%..%%%%%%%%..
m ...%%%%......%%%%%%%%%%%%%%%......%%%%%%%%%%%%%%......%%%.......%%..........................%%%................%%%%%%...
m ......%.......%%.%...%%...%......%%%.%%...%%%..%.....%%%%%.......%..........................%%%.................%%%%%%..
m ......................................................%%%...................................%%%.................%%%%%%..
m ......................................................%%%%..................................%%%%...............%%%%%%%..
m .....................................................%%%%...................................%%%.................%%%%%%..
m .....................................................%%%%%..................%.%....%%.......%%%%......%%%%......%%%%%%..
m ......................................................%%%................%%%%%%%%%%%%......%%%%......%%%%%.....%%%%%%%..
m %%%%............%.%.%..%%%%......%%..%.......%.%%%..%%%%%..............%%%%%%%%%%%%%%%......%%%%.....%%%%%.....%%%%%%%%%
m %%%%%%%.......%%%%%%%%%%%%%......%%%%%.....%%%%%%%%%%%%%%%.....%%.......%%%%%%%%%%%%%......%%%%%......%%%%......%%%%%%%%
m %%%%%%%......%%%%%%%%%%%%%%%......%%%.......%%%%%%%%%%%%%%.....%%..........%%..%%%%%%......%%%%........%%%......%%...%..
m .%%%%%%......%%%%%%%%%%%%%%%......%%%.......%%%%%%%%%%%%....................................%%%.........................
m .%%%%%%%.....%%....%.%%%..%......%%%%.........%.%.%..%......................................%%%.........................
m ..%%%%%%.........................%%%%%......................................................%%%%........................
m ..%%%%%%..........................%%%.......................................................%%%%........................
m ..%%%%%%..........................%%%......................................................%%%%.........................
m .%%%%%%%.........................%%%%..........................%%..%.%.%.%%.......%.%......%%%%%.....%.%..........%%%%%.
m %%%%%%%%.........................%%%%%.........................%%%%%%%%%%%%%......%%%%......%%%.......%%%%.....%%%%%%%%%
m %%%%%%%%%%%%%..%.%%%.%.%%%%%......%%%%.%%.%..%..%%.%%.%%......%%%%%%%%%%%%%.......%%%......%%%%%.....%%%%......%%%%%%%%%
m %%%%%%%%%%%%%%%%%%%%%%%%%%%.......%%%%%%%%%%%%%%%%%%%%%%......%%%%%%%%%%%%%%.....%%%%%......%%%......%%%%%.....%%%%%%%%%
m ...%..%%%..%%%%%%%%%%%%%%%%%......%%%%%%%%%%%%%%%%%%%%%......%%%%%.%%..%..........%%%%.....%%%%.......%%%........%%%....
m ...........%%%%%..................%%................%%%%......%%%%................%%%%.....%%%%......%%%%%..............
m ............%%%...................%..................%%%......%%%.................%%%......%%%%......%%%%...............
m ............%%%%................%%%..................%%......%%%%................%%%%......%%%%.......%%%...............
m ...........%%%%................%%%%%.................%%%......%%%%................%%%%.....%%%%.......%%%...............
m ............%%%................%%%%%.................%%%.....%%%%%..............1.%%%%......%%%%......%%%...............
m .....%.....%%%%.......%........%%%%%.....%.%..%%.....%%.......%%%%.....%%%%.%%%%%%%%%%......%%%%%.%%.%%%%%.%%%%%...%....
m .%%%%.......%%%......%%%%%......%%%.......%%%%%%.....%%......%%%%.......%%%%%%%%%%%%%......%%%%%%%%%%%%%%%%%%%%%%%%%....
m .%%%%%.....%%%%.......%%%.......%%%.......%%%%%......%%%......%%%%......%%%%%%%%%%%%%.......%%%%%%%%%%%%%%%%%%%%%%%%....
m ..%%%......%%%%%......%%%%......%%%......%%%%%%......%%.......%%%......%%%%%%%%%%%%%%%......%%%%%%%%%%%%%%%%%%%%%%%%....
m .%%%%......%.%.%.....%%%%%.....%%.%%.....%%%%%%%.....%%.........%......%%%%%%.%%..%%.......%.%..%%%.%%...%.%%%.%%.%%....
m .%%%%%...............%%%%%...............%%%%%%......%%%...............%%%%%............................................
m .%%%%.................%%%................%%%%..%.....%%.................%%%.............................................
m ..%%%%...............%%%%............................%%%................%%%%............................................
m ..%%%%................%%%%...........................%%%................%%%%............................................
m ..%%%%...............%%%%............................%%................%%%%%............................................
m %%%%%%%%.%%..%.%.%...%%%%%.....%%.%.%%...............%%%%...%...%%.....%%%%%.....%.%.%...%..%%.........%.%%.%.%.%.%%%%%%
m %%%%%%%%%%%%%%%%%%%%%%%%%.......%%%%%%...............%%%%%%%%%%%%.......%%%......%%%%%%%%%%%%%%%%%%%%%%%%%%%%%%%%%%%%%%%
m %%%%%%%%%%%%%%%%%%%%%%%%%......%%%%%%......%...%%%..%%%%%%%%%%%%%......%%%%.......%%%%%%%%%%%%%%%%%%%%%%%%%%%%%%%%%%%%%%
m %%%%%%%%%%%%%%%%%%%%%%%%%%.....%%%%%%%.....%%%%%%%%%%%%%%%%%%%%%%%.....%%%%%......%%%%%%%%%%%%%%%%%%%%%%%%%%%%%%%%%%%%%%
m %.%%.%%%%%%%%%%%.%.%%%%..%......%%%%%.......%%%%%%%.....%%..%%..%%.....%...%........%.%.%.%..%%%%.%..%%%%.%%%%.%%......%
m ...1.......%%%%%...............%%%%%%%.....%%%%%%%%.....................................................................
m ...........%%%%................%%.%%.%.....%...%%%......................................................................
m ............%%%.........................................................................................................
m ............%%%.........................................................................................................
m ............%%%.........................................................................................................
m ..%.%%..%.%%%%%........%%.%%.........................%.%......%%........%.%%.%%...%%%..%.%%%%%%%..%..%%.%..........%.%..
m %%%%%%%%%%%%%%%%......%%%%%%.........................%%%.....%%%%%.....%%%%%%%%%%%%%%%%%%%%%%%%%%%%%%%%%%%.....%%%%%%%%%
m %%%%%%%%%%%%%%%.......%%%%%......%%..%.%..%%%.%......%%%......%%%%......%%%%%%%%%%%%%%%%%%%%%%%%%%%%%%%%%%......%%%%%%%%
m %%%%%%%%%%%%%%%......%%%%%%%......%%%%%%%%%%%%%......%%%......%%%%......%%%%%%%%%%%%%%%%%%%%%%%%%%%%%%%%%.......%%%%%%%%
m ...%%%%.%..%%.........%%%%%%......%%%%%%%%%%%%%......%%%.....%%%%%......%%%%%%%%..%%%%.%%%.%%%.%%%.%.%%%%%......%..%...%
m .....................%%%%%%......%%%%%%%%%%%%%%%.....%%......%%%%......%%%%..........................%%%%%..............
m .....................%%.%........%%%%%%.%.%%..%......%%%.....%%%%......%%%%%.........................%%%%...............
m .................................%%%%................%%.......%%%%......%%%%..........................%%%%..............
m .................................%%%%................%%%.....%%%%.......%%%%.........................%%%%...............
m ..................................%%%................%%%......%%%%......%%%..........................%%%%...............
m %%%%%%.%...%..%.%%...............%%%%%...............%%%......%%%......%%%%%.....%%.%%........%..%.%%%%%%%.%.%%%%%%%%.%.
m %%%%%%%%%%%%%%%%%%................%%%................%%.......%%%%......%%%......%%%%......%%%%%%%%%%%%%%%%%%%%%%%%%%%%%
m %%%%%%%%%%%%%%%%%.........%.....%%%%%%.....%%.....%.%%%%......%%%......%%%%......%%%%%.....%%%%%%%%%%%%%%%%%%%%%%%%%%%%%
m %%%%%%%%%%%%%%%%%%......%%%%%%%%%%%%%.......%%%%%%%%%%%......%%%%......%%%%......%%%%......%%%%%%%%%%%%%%%%%%%%%%%%%%%%%
m .%.%.%..%..%%%%%%.......%%%%%%%%%%%%%%.....%%%%%%%%%%%%......%%%........%%%%.....%%%%.......%%%%...%%%.%.%...%%...%%%.%.
m ...........%%%%%%......%%%%%%%%%%%%%%.......%%%%%%%%%%%%.........................%%%%.......%%%%........................
m ...........%%%%%%%.....%%%%%...%%%%%%......%%%.%.%..%%%%.........................%%%%.......%%%.........................
m ..............%%%.......%%%%.....%%%%%................%%.........................%%%%.......%%%.........................
m ..............%%%.......%%%......%%%%%................%%..........................%%%......%%%%%........................
m .............%%%%......%%%%%.....%%%%................%%%.........................%%%%%.....%%%%%........................
m .%%...%%......%%%%......%%%......%%%%%...............%%%%%%%%%............%%..%%.%%%%%.....%%%%%..........%%%%%%.%......
m .%%%%%%%......%%%......%%%%......%%%%%...............%%%%%%%%%%%%......%%%%%%%%%%%%%%......%%%%%......%%%%%%%%%%%%%.....
m ..%%%%%......%%%%%.....%%%%%.....%%%%%%%%.%..%.%......%%%%%%%%%%%.......%%%%%%%%%%%%%%......%%%......%%%%%%%%%%%%%%%....
m .%%%%%%.......%%%%.....%%%%%......%%%%%%%%%%%%%.......%%%%%%%%%%%.......%%%%%%%%%%%%%......%%%%......%%%%%%%%%%%%%%.....
m .%%%%%%......%%%%%.....%%%%.....0%%%%%%%%%%%%%%......%%%%%%%%%%%%%......%%....%.%%%%%........%%%.....%%%%%.%.%.%.%%.....
m .%%%%%%%......%%%%......%%%%.....%%%%%%%%%%%%%%.......%%%%%%%%%%%%................%%%.................%%%...............
m .%%%%.%%.....%%%%%......%%%.......%%%%...%%%.%%.......%%%%...%%%%%...............%%%%%................%%%...............
m ..............%%%%......%%%......%%%%%................%%%......%%%...............%%%%.................%%%%..............
m ..............%%%......%%%%......%%%%%................%%%.......%%................%%%%...............%%%%%..............
m .............%%%%%......%%%.......%%%%................%%%%......%%...............%%%%.................%%%%..............
m ..............%%%.......%%%%......%%%%................%%%%.....%%%%%%%%%.%%......%%%%%%..%..%.%%%%.%%%%%%%........%%%%..
m .............%%%%%......%%%.......%%%%................%%%%......%%%%%%%%%%%%......%%%%%%%%%%%%%%%%%%%%%%%%.....%%%%%%%..
m .....%.......%%%%%.....%%%%%......%%%%.....%%%%%.....%%%%%......%%%%%%%%%%%%......%%%%%%%%%%%%%%%%%%%%%%%%......%%%%%%..
m ...%%%%......%%%%%......%%%.......%%%%.....%%%%......%%%%%......%%%%%%%%%%%.......%%%%%%%%%%%%%%%%%%%%%%%.......%%%%%%..
m ...%%%%%......%%%%......%%%.......%%%.......%%%......%%%%......%%%%%%%%%%%%......%.%.....%%%%..%.%..%%.%%%.....%%%%%%...
m ....%%%.......%%%%.....%%%%......%%%%%.....%%%%.......%%%......%%%%%%%%%%%%%...................................%%%%%%...
m ...%%%%%......%%%%........%......%%%%......%%%%%......%%%........%%..%..%%%%...................................%%%..%...
m ....%%%%.....%%%%%................%%%%......%%%%.........................%%%............................................
m ...%%%%%.....%%%%%...............%%%%......%%%%%..........................%%............................................
m ....%%%%......%%%................%%%%%.....%%%%%..........................%%............................................
m ...%%%%%......%%%%...............%%%%......%%%%%.........................%%%%.%.%%%%%.%.%%...%%%.....%%...%%............
m ....%%%%......%%%................%%%%%......%%%..........................%%%%%%%%%%%%%%%%%%%%%%.......%%%%%%............
m %..%%%%......%%%%%..%.%%.%%.......%%%%.....%%%%%....%.%.%......%%%%%......%%%%%%%%%%%%%%%%%%%%%.......%%%%%......%.%%%%%
