# map type: blank
# random seed: 1820467150
# hill distance  66, 29  78, 17   9, 84  66, 72  21, 29  21, 72   9, 17  78, 84
#        66, 29       0      76     114     113      61     140      95      95 
#        78, 17      76       0     140      95      95     114     113      61 
#         9, 84     114     140       0      95      95      76      61     113 
#        66, 72     113      95      95       0     140      61     114      76 
#        21, 29      61      95      95     140       0     113      76     114 
#        21, 72     140     114      76      61     113       0      95      95 
#         9, 17      95     113      61     114      76      95       0     140 
#        78, 84      95      61     113      76     114      95     140       0 
players 8
rows 112
cols 112
m %%%.%...%%.%%..%..%%.%%%%.....%%%%%%%%%%%....%.%......%.%....%%%%%%%%%%%.....%%%%.%%..%..%%.%%...%.%%%%%......%%
m %..............................%%%%%%%%%......................%%%%%%%%%..............................%%%......%%
m %.............................%%%%%%%%%%%....................%%%%%%%%%%%.............................%%%......%%
m ...............................%%%%%%%%%......................%%%%%%%%%...............................%%......%%
m ...............................%%%%%%%%%%....................%%%%%%%%%%...............................%%......%%
m %.....%%.%...%..%.%.%..%.......%%%%%%%%%%.%%.%%.%....%.%%.%%.%%%%%%%%%%.......%..%.%.%..%...%.%%.....%%%%....%%%
m .....%%%%%%%%%%%%%%%%%%%%.....%%%%%%%%%%%%%%%%%%......%%%%%%%%%%%%%%%%%%.....%%%%%%%%%%%%%%%%%%%%.....%%......%%
m ......%%%%%%%%%%%%%%%%%%%.....%%%%%%%%%%%%%%%%%%......%%%%%%%%%%%%%%%%%%.....%%%%%%%%%%%%%%%%%%%......%%%....%%%
m %.....%..%%%...%.%.%%%%%......%%%...%.%%%...%..%%....%%..%...%%%.%...%%%......%%%%%.%.%...%%%..%.....%%%%....%%%
m .................4....%%......................................................%%....7.................%%......%%
m %....................%%%%....................................................%%%%....................%%%......%%
m %....................%%%%....................................................%%%%....................%%%......%%
m ......................%%%....................................................%%%......................%%......%%
m %......%.%.%%..%%%..%%%%%.........................%%.........................%%%%%..%%%..%%.%.%......%%%%....%%%
m ......%%%%%%%%%%%%%%%%%%%%%%%..%%.....%%%%........%%........%%%%.....%%..%%%%%%%%%%%%%%%%%%%%%%%......%%%....%%%
m %....%%%%%%%%%%%%%%%%%%%%%%%%%%%%%....%%%%....%%%%%%%%%%....%%%%....%%%%%%%%%%%%%%%%%%%%%%%%%%%%%....%%%......%%
m %.....%....%%%%.%.%..%%%%%%%%%%%%.....%%%......%%%%%%%%......%%%.....%%%%%%%%%%%%..%.%.%%%%....%.....%.%......%.
m ......................%%%%.%%.%%%.....%%%%....%.%%%%%%.%....%%%%.....%%%.%%.%%%%................................
m .......................%%%....%%%%.....%%%........%%........%%%.....%%%%....%%%.................................
m .......................%%.....%%%.....%%%%........%%........%%%%.....%%%.....%%.................................
m ......................%%%......%%%....%%%.........%%.........%%%....%%%......%%%................................
m .......................%%%...3%%%......%%%........%%........%%%......%%%2...%%%.................................
m .%....%.%%.%%%%%%.....%%%%.....%%%.....%%%....%%%.%%.%%%....%%%.....%%%.....%%%%.....%%%%%%.%%.%....%.%%......%%
m %%.....%%%%%%%%%%......%%%....%%%.....%%%%.....%%%%%%%%.....%%%%.....%%%....%%%......%%%%%%%%%%.....%%%........%
m %......%%%%%%%%%%.....%%%......%%......%%%....%%%%%%%%%%....%%%......%%......%%%.....%%%%%%%%%%......%%........%
m %.....%%%%%%%%%%%.....%%%......%%%.....%%.....%%%%%%%%%%.....%%.....%%%......%%%.....%%%%%%%%%%%.....%%%......%%
m ......%%%%%%%%%%%.....%%%%.....%%.....%%%%.....%%%%%%%%.....%%%%.....%%.....%%%%.....%%%%%%%%%%%................
m ......%%%%%%%%%%%.....%%%%....%%%.....%%%......%%%%%%%%......%%%.....%%%....%%%%.....%%%%%%%%%%%................
m .......%%%%%%%%%.......%%.....%%%......%%%.....%%%%%%%%.....%%%......%%%.....%%.......%%%%%%%%%.................
m ......%%%%%%%%%%%......%%%....%%%%....%%%.....%%%%%%%%%%.....%%%....%%%%....%%%......%%%%%%%%%%%................
m ..%..%%%%%%%%%%%%......%%......%%.....%%%.....%%%%%%%%%%.....%%%.....%%......%%......%%%%%%%%%%%%..%..%%......%%
m %%%%%%%%%%%%%%%%.......%%%.....%%%.....%%%.....%%%%%%%%.....%%%.....%%%.....%%%.......%%%%%%%%%%%%%%%%%%......%%
m %%%%%%%%%%.%%%..%.....%%%.....%%%%.....%%%....%%%%%%%%%%....%%%.....%%%%.....%%%.....%..%%%.%%%%%%%%%%%........%
m %%%%%%%%%..............%........%......%%.....%%%%%%%%%%.....%%......%........%..............%%%%%%%%%%........%
m %%%%%%%%..............................%%%%.....%%%%%%%%.....%%%%..............................%%%%%%%%%%......%%
m %%%%%%%%...............................%%%....%%%%%%%%%%....%%%...............................%%%%%%%%%........%
m %%%%%%%%%.............................%%%%.....%%%%%%%%.....%%%%.............................%%%%%%%%%%........%
m %%%%%%%%.......%%.....................%%%......%%%%%%%%......%%%.....................%%.......%%%%%%%%%%......%%
m %%%%%%%%.....%%%......%%.%.%%.%..%..%%%%%%.....%%%%%%%%.....%%%%%%..%..%.%%.%.%%......%%%.....%%%%%%%%%%.%%%%.%%
m %%%%%%%%%....%%%%......%%%%%%%%%%%%%%%%%%%....%%%%%%%%%%....%%%%%%%%%%%%%%%%%%%......%%%%....%%%%%%%%%%%%%%%%%%%
m %%..%..%%....%..%.....%%%%%%%%%%%%%%%%%%%%.....%%%%%%%%.....%%%%%%%%%%%%%%%%%%%%.....%..%....%%..%..%%%%%%%%%%%%
m ........................%%....%%.%.....%%.....%%%%%%%%%%.....%%.....%.%%....%%........................%%%%%%%%%%
m %.............................................%%%%%%%%%%.............................................%%%%%%%%%%%
m %..............................................%%%%%%%%..............................................%%%%%%%%%%%
m %..............................................%%%%%%%%..............................................%%%%%%%%%%%
m %.............................................%%%%%%%%%%.............................................%%%%%%%%%%%
m ........................%%....%%.%.....%%.....%%%%%%%%%%.....%%.....%.%%....%%........................%%%%%%%%%%
m %%..%..%%....%..%.....%%%%%%%%%%%%%%%%%%%%.....%%%%%%%%.....%%%%%%%%%%%%%%%%%%%%.....%..%....%%..%..%%%%%%%%%%%%
m %%%%%%%%%....%%%%......%%%%%%%%%%%%%%%%%%%....%%%%%%%%%%....%%%%%%%%%%%%%%%%%%%......%%%%....%%%%%%%%%%%%%%%%%%%
m %%%%%%%%.....%%%......%%.%.%%.%..%..%%%%%%.....%%%%%%%%.....%%%%%%..%..%.%%.%.%%......%%%.....%%%%%%%%%%.%%%%.%%
m %%%%%%%%.......%%.....................%%%......%%%%%%%%......%%%.....................%%.......%%%%%%%%%%......%%
m %%%%%%%%%.............................%%%%.....%%%%%%%%.....%%%%.............................%%%%%%%%%%........%
m %%%%%%%%...............................%%%....%%%%%%%%%%....%%%...............................%%%%%%%%%........%
m %%%%%%%%..............................%%%%.....%%%%%%%%.....%%%%..............................%%%%%%%%%%......%%
m %%%%%%%%%..............%........%......%%.....%%%%%%%%%%.....%%......%........%..............%%%%%%%%%%........%
m %%%%%%%%%%.%%%..%.....%%%.....%%%%.....%%%....%%%%%%%%%%....%%%.....%%%%.....%%%.....%..%%%.%%%%%%%%%%%........%
m %%%%%%%%%%%%%%%%.......%%%.....%%%.....%%%.....%%%%%%%%.....%%%.....%%%.....%%%.......%%%%%%%%%%%%%%%%%%......%%
m ..%..%%%%%%%%%%%%......%%......%%.....%%%.....%%%%%%%%%%.....%%%.....%%......%%......%%%%%%%%%%%%..%..%%......%%
m ......%%%%%%%%%%%......%%%....%%%%....%%%.....%%%%%%%%%%.....%%%....%%%%....%%%......%%%%%%%%%%%................
m .......%%%%%%%%%.......%%.....%%%......%%%.....%%%%%%%%.....%%%......%%%.....%%.......%%%%%%%%%.................
m ......%%%%%%%%%%%.....%%%%....%%%.....%%%......%%%%%%%%......%%%.....%%%....%%%%.....%%%%%%%%%%%................
m ......%%%%%%%%%%%.....%%%%.....%%.....%%%%.....%%%%%%%%.....%%%%.....%%.....%%%%.....%%%%%%%%%%%................
m %.....%%%%%%%%%%%.....%%%......%%%.....%%.....%%%%%%%%%%.....%%.....%%%......%%%.....%%%%%%%%%%%.....%%%......%%
m %......%%%%%%%%%%.....%%%......%%......%%%....%%%%%%%%%%....%%%......%%......%%%.....%%%%%%%%%%......%%........%
m %%.....%%%%%%%%%%......%%%....%%%.....%%%%.....%%%%%%%%.....%%%%.....%%%....%%%......%%%%%%%%%%.....%%%........%
m .%....%.%%.%%%%%%.....%%%%.....%%%.....%%%....%%%.%%.%%%....%%%.....%%%.....%%%%.....%%%%%%.%%.%....%.%%......%%
m .......................%%%...1%%%......%%%........%%........%%%......%%%0...%%%.................................
m ......................%%%......%%%....%%%.........%%.........%%%....%%%......%%%................................
m .......................%%.....%%%.....%%%%........%%........%%%%.....%%%.....%%.................................
m .......................%%%....%%%%.....%%%........%%........%%%.....%%%%....%%%.................................
m ......................%%%%.%%.%%%.....%%%%....%.%%%%%%.%....%%%%.....%%%.%%.%%%%................................
m %.....%....%%%%.%.%..%%%%%%%%%%%%.....%%%......%%%%%%%%......%%%.....%%%%%%%%%%%%..%.%.%%%%....%.....%.%......%.
m %....%%%%%%%%%%%%%%%%%%%%%%%%%%%%%....%%%%....%%%%%%%%%%....%%%%....%%%%%%%%%%%%%%%%%%%%%%%%%%%%%....%%%......%%
m ......%%%%%%%%%%%%%%%%%%%%%%%..%%.....%%%%........%%........%%%%.....%%..%%%%%%%%%%%%%%%%%%%%%%%......%%%....%%%
m %......%.%.%%..%%%..%%%%%.........................%%.........................%%%%%..%%%..%%.%.%......%%%%....%%%
m ......................%%%....................................................%%%......................%%......%%
m %....................%%%%....................................................%%%%....................%%%......%%
m %....................%%%%....................................................%%%%....................%%%......%%
m .................6....%%......................................................%%....5.................%%......%%
m %.....%..%%%...%.%.%%%%%......%%%...%.%%%...%..%%....%%..%...%%%.%...%%%......%%%%%.%.%...%%%..%.....%%%%....%%%
m ......%%%%%%%%%%%%%%%%%%%.....%%%%%%%%%%%%%%%%%%......%%%%%%%%%%%%%%%%%%.....%%%%%%%%%%%%%%%%%%%......%%%....%%%
m .....%%%%%%%%%%%%%%%%%%%%.....%%%%%%%%%%%%%%%%%%......%%%%%%%%%%%%%%%%%%.....%%%%%%%%%%%%%%%%%%%%.....%%......%%
m %.....%%.%...%..%.%.%..%.......%%%%%%%%%%.%%.%%.%....%.%%.%%.%%%%%%%%%%.......%..%.%.%..%...%.%%.....%%%%....%%%
m ...............................%%%%%%%%%%....................%%%%%%%%%%...............................%%......%%
m ...............................%%%%%%%%%......................%%%%%%%%%...............................%%......%%
m %.............................%%%%%%%%%%%....................%%%%%%%%%%%.............................%%%......%%
m %..............................%%%%%%%%%......................%%%%%%%%%..............................%%%......%%
m %%%.%...%%.%%..%..%%.%%%%.....%%%%%%%%%%%....%.%......%.%....%%%%%%%%%%%.....%%%%.%%..%..%%.%%...%.%%%%%......%%
m %%%%%%%%%%%%%%%%%%%%%%%%%.....%%%%%%%%%%%%%%%%%%......%%%%%%%%%%%%%%%%%%.....%%%%%%%%%%%%%%%%%%%%%%%%%%%%....%%%
m %%%%%%%%%%%%%%%%%%%%%%%%%.....%%%%%.%.%%%%%%%%%%......%%%%%%%%%%.%.%%%%%.....%%%%%%%%%%%%%%%%%%%%%%%%%%%%....%%%
m %.%%%.%%..%.%.%%%%.%%%.%%......%%......%%%%%%%%%......%%%%%%%%%......%%......%%.%%%.%%%%.%.%..%%.%%%.%%%......%%
m ...............................%%%.....%%%%%%%%%%....%%%%%%%%%%.....%%%.........................................
m ...............................%%%.....%%%%%%%%%......%%%%%%%%%.....%%%.........................................
m ..............................%%%......%%%%%%%%%......%%%%%%%%%......%%%........................................
m ...............................%%%....%%%%%%%%%%......%%%%%%%%%%....%%%.........................................
m ...%.%%.%%...%%.%....%.%.......%%%.....%%%%%%%%%%....%%%%%%%%%%.....%%%.......%.%....%.%%...%%.%%.%...%.%%..%%.%
m %%%%%%%%%%%%%%%%%.....%%......%%%.....%%%%%%%%%%%....%%%%%%%%%%%.....%%%......%%.....%%%%%%%%%%%%%%%%%%%%%%%%%%%
m %%%%%%%%%%%%%%%%%....%%%......%..%........%...%%%....%%%...%........%..%......%%%....%%%%%%%%%%%%%%%%%%%%%%%%%%%
m %%%%%%%%%%%%%%%%.....%%%......................................................%%%.....%%%%%%%%%%%%%%%%%%%%%%%%%%
m %%%%%%%%%%%%%%%%%%%%%%%%%%........................%%........................%%%%%%%%%%%%%%%%%%%%%%%%%%%%%%%%%%%%
m %%%%%%%%%%%%%%%%%%%%%%%%%%........................%%........................%%%%%%%%%%%%%%%%%%%%%%%%%%%%%%%%%%%%
m %%%%%%%%%%%%%%%%.....%%%......................................................%%%.....%%%%%%%%%%%%%%%%%%%%%%%%%%
m %%%%%%%%%%%%%%%%%....%%%......%..%........%...%%%....%%%...%........%..%......%%%....%%%%%%%%%%%%%%%%%%%%%%%%%%%
m %%%%%%%%%%%%%%%%%.....%%......%%%.....%%%%%%%%%%%....%%%%%%%%%%%.....%%%......%%.....%%%%%%%%%%%%%%%%%%%%%%%%%%%
m ...%.%%.%%...%%.%....%.%.......%%%.....%%%%%%%%%%....%%%%%%%%%%.....%%%.......%.%....%.%%...%%.%%.%...%.%%..%%.%
m ...............................%%%....%%%%%%%%%%......%%%%%%%%%%....%%%.........................................
m ..............................%%%......%%%%%%%%%......%%%%%%%%%......%%%........................................
m ...............................%%%.....%%%%%%%%%......%%%%%%%%%.....%%%.........................................
m ...............................%%%.....%%%%%%%%%%....%%%%%%%%%%.....%%%.........................................
m %.%%%.%%..%.%.%%%%.%%%.%%......%%......%%%%%%%%%......%%%%%%%%%......%%......%%.%%%.%%%%.%.%..%%.%%%.%%%......%%
m %%%%%%%%%%%%%%%%%%%%%%%%%.....%%%%%.%.%%%%%%%%%%......%%%%%%%%%%.%.%%%%%.....%%%%%%%%%%%%%%%%%%%%%%%%%%%%....%%%
m %%%%%%%%%%%%%%%%%%%%%%%%%.....%%%%%%%%%%%%%%%%%%......%%%%%%%%%%%%%%%%%%.....%%%%%%%%%%%%%%%%%%%%%%%%%%%%....%%%
