# map type: blank
# random seed: 2026353659
# hill distance  22, 67  22, 28  93, 28  93, 67
#        22, 67       0      91     100      53 
#        22, 28      91       0      53     100 
#        93, 28     100      53       0      91 
#        93, 67      53     100      91       0 
players 4
rows 112
cols 112
m .........................%%%........................................%%%.............................%%%%%%%%....
m .........%%%.%..%%..%%.%%%%......%.%%.%..%%..........%%..%.%%.%......%%%%.%%..%%..%.%%%..............%%%%%%.....
m .........%%%.%..%%..%%.%%%%......%.%%.%..%%..........%%..%.%%.%......%%%%.%%..%%..%.%%%..............%%%%%%.....
m .........................%%%........................................%%%.............................%%%%%%%%....
m ........................%%%..........................................%%%.............................%%%%%%.....
m ........................%%%..........................................%%%............................%%%%%%%%....
m ........................%%%..........................................%%%............................%%%%%%%%....
m .%..%%%....%.....%%......%%%.....%%......%%%.%%..%%.%%%......%%.....%%%......%%.....%....%%%..%......%%%%%%.....
m %%%%%%%%%%%%.....%%......%%%.....%%.....%%%%%%%%%%%%%%%%.....%%.....%%%......%%.....%%%%%%%%%%%%.....%%%%%%.....
m %%%%%%%%%%%%.....%%......%%%....%%%%....%%%%%%%%%%%%%%%%....%%%%....%%%......%%.....%%%%%%%%%%%%.....%%%%%%.....
m %%%%%...%%%%....%.%%......%%.....%%%....%%.%..%%%%..%.%%....%%%.....%%......%%.%....%%%%...%%%%%....%..%%..%....
m .%%%.....%%%....................%%%%........................%%%%....................%%%.....%%%.................
m %%%......%%.....................%%%%........................%%%%.....................%%......%%%................
m %%%%.....%%.....................%%%%........................%%%%.....................%%.....%%%%................
m %%%%....%%%......................%%%........................%%%......................%%%....%%%%................
m %%%.....%%%%....%.%%....%.%%...%%%%%....%%%..........%%%....%%%%%...%%.%....%%.%....%%%%.....%%%.....%%..%%.....
m %%%%.....%%.....%%%......%%%%%%%%%%%.....%%..........%%.....%%%%%%%%%%%......%%%.....%%.....%%%%.....%%%%%%.....
m %%%......%%%.....%%%.....%%%%%%%%%%.....%%%%........%%%%.....%%%%%%%%%%.....%%%.....%%%......%%%.....%%%%%%.....
m %%%%.....%%%............%%%%....%%%.....%.%..........%.%.....%%%....%%%%............%%%.....%%%%.....%%%%%%.....
m .%%%.....%%......................%%..........................%%......................%%.....%%%.....%%%%%%%%....
m .%%%.....%%......................%%..........................%%......................%%.....%%%.....%%%%%%%%....
m .%%%.....%%.....................%%%%........................%%%%.....................%%.....%%%......%%%%%%.....
m .%%.....%%%.................2....%%%........................%%%....3.................%%%.....%%.....%%%%%%%%....
m %%%%....%%%.....%.%.....%%.%%%%.%%%%......%..........%......%%%%.%%%%.%%.....%.%.....%%%....%%%%....%%%%%%%%....
m %%%%....%%%.....%%%......%%%%%%%%%%%.....%%..........%%.....%%%%%%%%%%%......%%%.....%%%....%%%%....%%%%%%%%....
m .%%%....%%%%.....%%%....%%%%%%%%%%%.....%%%..........%%%.....%%%%%%%%%%%....%%%.....%%%%....%%%.....%%%%%%%%....
m %%%......%%......%%%.....%%%%%%..%%.....%%%..........%%%.....%%..%%%%%%.....%%%......%%......%%%....%.%%%%.%....
m %%%......%%%............%%%%.............%%..........%%.............%%%%............%%%......%%%................
m %%%.....%%%..............%%.............%%%%........%%%%.............%%..............%%%.....%%%................
m .%%%.....%%..............%%%............%%%..........%%%............%%%..............%%.....%%%.................
m .%%%.....%%%.............%%%.............%%%........%%%.............%%%.............%%%.....%%%.................
m .%%%.....%%%....%%.%.%.%%%%%........%%%.%%%%........%%%%.%%%........%%%%%.%.%.%%....%%%.....%%%.....%..%%..%....
m %%%.....%%%%%%%%%%%%%%%%%%%.....%%%%%%%%%%%%........%%%%%%%%%%%%.....%%%%%%%%%%%%%%%%%%%.....%%%.....%%%%%%.....
m .%%......%%%%%%%%%%%%%%%%%%%.....%%%%%%%%%%..........%%%%%%%%%%.....%%%%%%%%%%%%%%%%%%%......%%.....%%%%%%%%....
m .%%%....%%%.%%%.%%%%...%%%%%....%%%%...%%..............%%...%%%%....%%%%%...%%%%.%%%.%%%....%%%.....%%%%%%%%....
m %%%..............%%.............%%%%........................%%%%.............%%..............%%%....%%%%%%%%....
m .%%.............%%%.............%%%..........................%%%.............%%%.............%%......%%%%%%.....
m %%%%............%%%.............%%%..........................%%%.............%%%............%%%%.....%%%%%%.....
m .%%.............%%%%.............%%..........................%%.............%%%%.............%%.....%%%%%%%%....
m .%%.....%%%%....%%%%....%%%%%...%%%%....%.%%%......%%%.%....%%%%...%%%%%....%%%%....%%%%.....%%......%%%%%%.....
m .%%.....%%%.....%%%.....%%%%%%%%%%%......%%%%%%%%%%%%%%......%%%%%%%%%%%.....%%%.....%%%.....%%......%%%%%%.....
m .%%%....%%%%....%%%.....%%%%%%%%%%%%....%%%%%%%%%%%%%%%%....%%%%%%%%%%%%.....%%%....%%%%....%%%.....%%%%%%%%....
m %.%%....%%%.....%%%%.......%%%.%%%%.....%%.%.%....%.%.%%.....%%%%.%%%.......%%%%.....%%%....%%.%......%%%%......
m .........%%......%%%.............%%%........................%%%.............%%%......%%.........................
m ........%%%.....%%%..............%%..........................%%..............%%%.....%%%........................
m ........%%%%.....%%%.............%%..........................%%.............%%%.....%%%%........................
m .........%%......%%%.............%%..........................%%.............%%%......%%.........................
m %...%.%%%%%%....%%%%.%...%..%...%%%%.%.%.%%%........%%%.%.%.%%%%...%..%...%.%%%%....%%%%%%.%...%....%%....%%....
m %%%%%%%%%%%.....%%%%%%%%%%%%%%%%%%%%%%%%%%%..........%%%%%%%%%%%%%%%%%%%%%%%%%%%.....%%%%%%%%%%%%%%%%%%%%%%%%%%%
m %%%%%%%%%%%.....%%%%%%%%%%%%%%%%%%%%%%%%%%%..........%%%%%%%%%%%%%%%%%%%%%%%%%%%.....%%%%%%%%%%%%%%%%%%%%%%%%%%%
m ..%%%%%%%%.........%%%%%.%.%.%..%.%..%...%............%...%..%.%..%.%.%.%%%%%.........%%%%%%%%..%%.%%%%%%%%%%.%%
m ....................................................................................................%%%%%%%%....
m .....................................................................................................%%%%%%.....
m .....................................................................................................%%%%%%.....
m .....................................................................................................%%%%%%.....
m %..%...%...%.......%%%...%.%%.%.%.......%%%.%%%%%%%%.%%%.......%.%.%%.%...%%%.......%...%...%..%..%.%%%%%%%%.%..
m %%%%%%%%%%%.....%%%%%%%%%%%%%%%%%%%.....%%%%%%%%%%%%%%%%.....%%%%%%%%%%%%%%%%%%%.....%%%%%%%%%%%%%%%%%%%%%%%%%%%
m %%%%%%%%%%%.....%%%%%%%%%%%%%%%%%%%.....%%%%%%%%%%%%%%%%.....%%%%%%%%%%%%%%%%%%%.....%%%%%%%%%%%%%%%%%%%%%%%%%%%
m %%%%%%%%%%%.....%%%%%%%%%%%%%%%%%%%.....%%%%%%%%%%%%%%%%.....%%%%%%%%%%%%%%%%%%%.....%%%%%%%%%%%%%%%%%%%%%%%%%%%
m %%%%%%%%%%%.....%%%%%%%%%%%%%%%%%%%.....%%%%%%%%%%%%%%%%.....%%%%%%%%%%%%%%%%%%%.....%%%%%%%%%%%%%%%%%%%%%%%%%%%
m %..%...%...%.......%%%...%.%%.%.%.......%%%.%%%%%%%%.%%%.......%.%.%%.%...%%%.......%...%...%..%..%.%%%%%%%%.%..
m .....................................................................................................%%%%%%.....
m .....................................................................................................%%%%%%.....
m .....................................................................................................%%%%%%.....
m ....................................................................................................%%%%%%%%....
m ..%%%%%%%%.........%%%%%.%.%.%..%.%..%...%............%...%..%.%..%.%.%.%%%%%.........%%%%%%%%..%%.%%%%%%%%%%.%%
m %%%%%%%%%%%.....%%%%%%%%%%%%%%%%%%%%%%%%%%%..........%%%%%%%%%%%%%%%%%%%%%%%%%%%.....%%%%%%%%%%%%%%%%%%%%%%%%%%%
m %%%%%%%%%%%.....%%%%%%%%%%%%%%%%%%%%%%%%%%%..........%%%%%%%%%%%%%%%%%%%%%%%%%%%.....%%%%%%%%%%%%%%%%%%%%%%%%%%%
m %...%.%%%%%%....%%%%.%...%..%...%%%%.%.%.%%%........%%%.%.%.%%%%...%..%...%.%%%%....%%%%%%.%...%....%%....%%....
m .........%%......%%%.............%%..........................%%.............%%%......%%.........................
m ........%%%%.....%%%.............%%..........................%%.............%%%.....%%%%........................
m ........%%%.....%%%..............%%..........................%%..............%%%.....%%%........................
m .........%%......%%%.............%%%........................%%%.............%%%......%%.........................
m %.%%....%%%.....%%%%.......%%%.%%%%.....%%.%.%....%.%.%%.....%%%%.%%%.......%%%%.....%%%....%%.%......%%%%......
m .%%%....%%%%....%%%.....%%%%%%%%%%%%....%%%%%%%%%%%%%%%%....%%%%%%%%%%%%.....%%%....%%%%....%%%.....%%%%%%%%....
m .%%.....%%%.....%%%.....%%%%%%%%%%%......%%%%%%%%%%%%%%......%%%%%%%%%%%.....%%%.....%%%.....%%......%%%%%%.....
m .%%.....%%%%....%%%%....%%%%%...%%%%....%.%%%......%%%.%....%%%%...%%%%%....%%%%....%%%%.....%%......%%%%%%.....
m .%%.............%%%%.............%%..........................%%.............%%%%.............%%.....%%%%%%%%....
m %%%%............%%%.............%%%..........................%%%.............%%%............%%%%.....%%%%%%.....
m .%%.............%%%.............%%%..........................%%%.............%%%.............%%......%%%%%%.....
m %%%..............%%.............%%%%........................%%%%.............%%..............%%%....%%%%%%%%....
m .%%%....%%%.%%%.%%%%...%%%%%....%%%%...%%..............%%...%%%%....%%%%%...%%%%.%%%.%%%....%%%.....%%%%%%%%....
m .%%......%%%%%%%%%%%%%%%%%%%.....%%%%%%%%%%..........%%%%%%%%%%.....%%%%%%%%%%%%%%%%%%%......%%.....%%%%%%%%....
m %%%.....%%%%%%%%%%%%%%%%%%%.....%%%%%%%%%%%%........%%%%%%%%%%%%.....%%%%%%%%%%%%%%%%%%%.....%%%.....%%%%%%.....
m .%%%.....%%%....%%.%.%.%%%%%........%%%.%%%%........%%%%.%%%........%%%%%.%.%.%%....%%%.....%%%.....%..%%..%....
m .%%%.....%%%.............%%%.............%%%........%%%.............%%%.............%%%.....%%%.................
m .%%%.....%%..............%%%............%%%..........%%%............%%%..............%%.....%%%.................
m %%%.....%%%..............%%.............%%%%........%%%%.............%%..............%%%.....%%%................
m %%%......%%%............%%%%.............%%..........%%.............%%%%............%%%......%%%................
m %%%......%%......%%%.....%%%%%%..%%.....%%%..........%%%.....%%..%%%%%%.....%%%......%%......%%%....%.%%%%.%....
m .%%%....%%%%.....%%%....%%%%%%%%%%%.....%%%..........%%%.....%%%%%%%%%%%....%%%.....%%%%....%%%.....%%%%%%%%....
m %%%%....%%%.....%%%......%%%%%%%%%%%.....%%..........%%.....%%%%%%%%%%%......%%%.....%%%....%%%%....%%%%%%%%....
m %%%%....%%%.....%.%.....%%.%%%%.%%%%......%..........%......%%%%.%%%%.%%.....%.%.....%%%....%%%%....%%%%%%%%....
m .%%.....%%%.................0....%%%........................%%%....1.................%%%.....%%.....%%%%%%%%....
m .%%%.....%%.....................%%%%........................%%%%.....................%%.....%%%......%%%%%%.....
m .%%%.....%%......................%%..........................%%......................%%.....%%%.....%%%%%%%%....
m .%%%.....%%......................%%..........................%%......................%%.....%%%.....%%%%%%%%....
m %%%%.....%%%............%%%%....%%%.....%.%..........%.%.....%%%....%%%%............%%%.....%%%%.....%%%%%%.....
m %%%......%%%.....%%%.....%%%%%%%%%%.....%%%%........%%%%.....%%%%%%%%%%.....%%%.....%%%......%%%.....%%%%%%.....
m %%%%.....%%.....%%%......%%%%%%%%%%%.....%%..........%%.....%%%%%%%%%%%......%%%.....%%.....%%%%.....%%%%%%.....
m %%%.....%%%%....%.%%....%.%%...%%%%%....%%%..........%%%....%%%%%...%%.%....%%.%....%%%%.....%%%.....%%..%%.....
m %%%%....%%%......................%%%........................%%%......................%%%....%%%%................
m %%%%.....%%.....................%%%%........................%%%%.....................%%.....%%%%................
m %%%......%%.....................%%%%........................%%%%.....................%%......%%%................
m .%%%.....%%%....................%%%%........................%%%%....................%%%.....%%%.................
m %%%%%...%%%%....%.%%......%%.....%%%....%%.%..%%%%..%.%%....%%%.....%%......%%.%....%%%%...%%%%%....%..%%..%....
m %%%%%%%%%%%%.....%%......%%%....%%%%....%%%%%%%%%%%%%%%%....%%%%....%%%......%%.....%%%%%%%%%%%%.....%%%%%%.....
m %%%%%%%%%%%%.....%%......%%%.....%%.....%%%%%%%%%%%%%%%%.....%%.....%%%......%%.....%%%%%%%%%%%%.....%%%%%%.....
m .%..%%%....%.....%%......%%%.....%%......%%%.%%..%%.%%%......%%.....%%%......%%.....%....%%%..%......%%%%%%.....
m ........................%%%..........................................%%%............................%%%%%%%%....
m ........................%%%..........................................%%%............................%%%%%%%%....
m ........................%%%..........................................%%%.............................%%%%%%.....
