# map type: blank
# random seed: 376614269
# hill distance  84, 86  14,  5  40, 12  47, 84  71, 56  68, 36  23, 40  72, 91  21, 77  35, 72  33, 37  91, 53  28, 52  87, 96  75,  3  26, 17  88, 33  38, 49  52,  0   9, 89
#        84, 86       0      45      68      39      43      66      83      17      44      63      96      42      76      29      46      69      63      83      46      26 
#        14,  5      45       0      55      84      88      77      44      58      55      88      51      69      61      32      39      24      52      68      65      33 
#        40, 12      68      55       0      55      77      52      45      51      84      65      32      88      58      61      44      33      69      39      24      88 
#        47, 84      39      84      55       0      52      69      68      32      55      24      61      77      51      58      45      88      88      44      33      65 
#        71, 56      43      88      77      52       0      25      66      36      69      52      59      25      59      72      63      88      40      42      63      69 
#        68, 36      66      77      52      69      25       0      63      59      88      69      36      40      72      59      42      63      25      43      52      88 
#        23, 40      83      44      45      68      66      63       0      96      39      46      29      43      17      76      83      26      42      46      69      63 
#        72, 91      17      58      51      32      36      59      96       0      61      56      83      59      83      42      29      82      72      76      29      39 
#        21, 77      44      55      84      55      69      88      39      61       0      33      58      52      32      51      68      65      77      45      88      24 
#        35, 72      63      88      65      24      52      69      46      56      33       0      39      63      29      82      69      68      88      26      57      57 
#        33, 37      96      51      32      61      59      36      29      83      58      39       0      72      42      83      76      29      59      17      56      82 
#        91, 53      42      69      88      77      25      40      43      59      52      63      72       0      36      59      66      69      25      63      88      52 
#        28, 52      76      61      58      51      59      72      17      83      32      29      42      36       0      83      96      39      59      29      82      56 
#        87, 96      29      32      61      58      72      59      76      42      51      82      83      59      83       0      17      56      36      96      39      29 
#        75,  3      46      39      44      45      63      42      83      29      68      69      76      66      96      17       0      63      43      83      26      46 
#        26, 17      69      24      33      88      88      63      26      82      65      68      29      69      39      56      63       0      52      46      57      57 
#        88, 33      63      52      69      88      40      25      42      72      77      88      59      25      59      36      43      52       0      66      69      63 
#        38, 49      83      68      39      44      42      43      46      76      45      26      17      63      29      96      83      46      66       0      63      69 
#        52,  0      46      65      24      33      63      52      69      29      88      57      56      88      82      39      26      57      69      63       0      68 
#         9, 89      26      33      88      65      69      88      63      39      24      57      82      52      56      29      46      57      63      69      68       0 
players 4
rows 98
cols 98
m ....................................................................%%%%%%%%%%%%%%................
m .........................................%.%%..........%%.%%.......%%%%%%........%................
m ........................................%%%%%%.......%%%%%%%........%%%%%........%................
m ........................................%%%%%%........%%%%%%.......%%%%%%........%................
m .......%%%%%........%%%%.%.%%.%..%%%%..%%..%%%.......%%%%%%%.......%%%%%%........%........%.%..%..
m ......%%%%%.........%%%%%%%%%%%%%%%%........%.........%%%%%%.......%%%%%%........%........%%%%%...
m ......%%%%%%........%%%%%%%%%%%%%%%%%.......%........%%%%%%%.......%%%%%%........%.......%%%%%%%..
m .....%%%%%%%.......%%%%%%%%%%%%%%%%%%.......%........%%%%%%...........%%.%.......%.......%%%%%%...
m .....%%%%%%%.......%%%%%%%%%%%%%%%%%%.......%%........%%%%%......................%........%%%%%%..
m .....%%%%%%%........%%%%%%%%%%%%%%%%........%%........%%%%%..............................0%%%%%...
m ......%....%.......%......%%%%%%%%%%........%.........%%%%%...............................%%%%%...
m ..........................%%%%%%%%%%%.......%%........%%%%%%......................%%%%%%%%%%%%%...
m ..........................%%%%%%%%%%%.......%........%%%%%%.......................%%%%%%%%%%%%%...
m ..........................%%%%%%%%%%........%%.......%%%%%%%......................%%%%%%%%%%%%%%..
m .....0....................%%%%%%%%%%%.......%%........%%%%%%......................%%%%%%%%%%%%%...
m ..........................%%%%%%%%%%........%%.......%%%%%%%.......%.%%%%%.......%%%%%%%%%%%%%%...
m ..........................%%%%%%%%%%%.......%.........%%%%%%.......%%%%%%........%%%%%%%%%%%%%%...
m ..........................%%%%%%%%%%%.......%........%%%%%%........%%%%%%........%%%%%%%%%%%%%%%..
m ......%%.%%%......%%%%%%%%%%..%%%...%.......%.........%%%%%%.......%%%%%%.........%%%%%%%%%%%%%%..
m .....%%%%%%%%%%%............................%%........%%%%%........%%%%%%........%%%%%%%%%%%%%%%..
m .....%%%%%%%%%%%............................%.........%%%%%%........%%%%%%.......%%%%%%%%%%%%%%%..
m .....%%%%%%%%%%%............................%..........%%.%%..........%%%....2....%%%....%%%.%%%..
m ......%%%%%%%%%%...............................................................................%..
m ......%%%%%%%%%%........................1......................................................%..
m ......%%%%%%%%%%...............................................................................%..
m ......%%%%%%%%%%...............................................................................%..
m .....%%%%%%%%%%%.3.%%..............%%%%........................................................%..
m .....%%%%%%%%%%%%%%%%%%.......%%%%%%%%%........................................................%..
m .....%%%%%%%%%%%%%%%%%.........%%%%%%%%.............1..........................................%..
m ......%%%%%%%%%%%%%%%%%.......%%%%%%%%%%%%%%%%%.%%%......%%%.......%.%.%....%...%%%%%%%%%%%%%%%%..
m .....%%%%%%%%%%%%%%%%%.........%%%%%%%%%%%%%%%%%%%%%%%%%%%%.........%%%%%%%%%%%%%%%%%.......%%%%..
m .....%%%%%%%%%%%%%%%%%.........%%%%%%%%%%%%%%%%%%%%%%%%%%%%.........%%%%%%%%%%%%%%%%%.......%%%%..
m %%%%%%%%%%...%....%.%.%.......%%%......%%%.%%%%%%%%%%%%%%%%%.......%%%%%%%%%%%%%%%%%........%%%%%%
m .....................................0.............%%%%%%%%.........%%%%%%%%%%%%%%%%%.......%.....
m ...................................................%%%%%%%%%.......%%%%%%%%%%%%%%%%%%.......%.....
m ...................................................%%%%..............%%.2.%%%%%%%%%%%.......%.....
m ..........................................................................%%%%%%%%%%........%.....
m ..........................................................................%%%%%%%%%%........%.....
m .................................................0........................%%%%%%%%%%........%.....
m ..........................................................................%%%%%%%%%%........%.....
m %....%%%....3....%%%..........%%.%%..........%............................%%%%%%%%%%%.......%%%.%%
m %%%%%%%%%.......%%%%%%........%%%%%%.........%............................%%%%%%%%%%%.......%%%%%%
m %%%%%%%%%........%%%%%%........%%%%%........%%............................%%%%%%%%%%%.......%%%%%%
m %%%%%%%%.........%%%%%%.......%%%%%%.........%.......%...%%%..%%%%%%%%%%......%%%.%%........%%%%%%
m %%%%%%%%%........%%%%%%........%%%%%%........%.......%%%%%%%%%%%............................%%%%%%
m %%%%%%%%%........%%%%%%.......%%%%%%.........%.......%%%%%%%%%%%.............................%%%%%
m %%%%%%%%%.......%%%%%.%.......%%%%%%%.......%%........%%%%%%%%%%.............................%%%%%
m %%%%%%%%......................%%%%%%........%%.......%%%%%%%%%%%....................1........%%%%%
m %%%%%%%%......................%%%%%%%.......%%........%%%%%%%%%%............................%%%%%%
m %%%%%%%%.......................%%%%%%........%.......%%%%%%%%%%%.............................%%%%%
m %%%%%%%%......................%%%%%%........%%.......%%%%%%%%%%%.............................%%%%%
m ...............................%%%%%.........%........%%%%%%%%%%......%.......%....%.........%%%%%
m 1..............................%%%%%........%%........%%%%%%%%%%%%%%%%........%%%%%%%........%%%%%
m ........%......................%%%%%........%%.......%%%%%%%%%%%%%%%%%%.......%%%%%%%.......%%%%%%
m %.......%.......%.%%...........%%%%%%........%.......%%%%%%%%%%%%%%%%%%.......%%%%%%%........%%%%%
m %.......%........%%%%%%.......%%%%%%%........%.......%%%%%%%%%%%%%%%%%........%%%%%%........%%%%%%
m ........%........%%%%%%.......%%%%%%.........%........%%%%%%%%%%%%%%%%.........%%%%%.........%%%%%
m ........%........%%%%%%.......%%%%%%%.......%%%..%%..%%%%..%.%%.%.%%%%........%%%%%.........%..%.%
m ........%........%%%%%%.......%%%%%%........%%%%%%................................................
m ........%........%%%%%........%%%%%%%.......%%%%%%................................................
m ........%........%%%%%%.......%%.%%..........%%.%.................................................
m ........%%%%%%%%%%%%%%............................................................................
m ........%%%%%%%%%%%%%%%...........................................................................
m .........%%%%%%%%%%%%%%...........................................................................
m .........%%%%%%%%%%%%%............................................................................
m ........%%%%%%%%%%%%%%%.............................%%%.%.......%%%%%%....%.%%%%.%.%%.......%..%.%
m ........%%%%%%%%%%%%%%.............................%%%%%........%%%%%%%%%%%%%%%%%%%%%.......%%%%%%
m ........%%%%%%%%%%%%%%.............................%%%%%%........%%%%%%%%%%%%%%%%%%%........%%%%%%
m .........%%%%%%%%%%%%%%.......%.%..%0...........%%%%%%%%........%%%%%%%%%%%%%%%%%%%%%........%%%%%
m .........%%%%%%%%%%%%%%........%%%%%........%%%%%%%%%%%%........%%%%%%%%%%%%%%%%%%%%%........%%%%%
m %........%%%%%%%%%%%%%%.......%%%%%%%........%%%%%%%%%%%%........%%%%%%%%%%%%%%%%%%%.........%%%%%
m %.......%%%.%.%%..%%%.%.......%%%%%%%........%%%%%...%%.3........%.%.%%....%%.%.%............%%%%%
m %.............................%%%%%%.......................................................3.%%%%%
m %..............................%%%%%.........................................................%%%%%
m ......................%..........%%%........................................................%%%%..
m ...2..................%%%........%%%%.......................................................%%%%..
m .......................%%%.......%%%%.......................................................%%%%..
m .......................%%.........%%%........................................................%%%..
m ......................%%%%........%%%.......................................................%%%%..
m .....%%%%%%%%%%%%%%%%%%%%%........%%%.......%%.........%.........%%%...%%.%.%%%...%.........%%%%..
m .......%...%%%.%.%%...%%%.........%.........%%.......%%%........%%%%%%%%%%%%%%%%%%%%%.......%%%%..
m .....................................................%%%........%%%%........................%%%%..
m .....................................................%%%.........%%.........................%%%...
m .....................................................%%%%.......%%%.........................%%%%..
m .....................................................%%%%........%%%..................3.....%%%%..
m ......................................................%%%..........%........................%%%%..
m ......................................................%%%%%..............................%%%%%%...
m ......................................................%%%%%%.............................%%%%%%.2.
m .........%.%.%%....%%.%.%........2.%%...%%%%%........%%%%%%%.......%.%%%..%%.%.%%%.......%%%%%%...
m ......%%%%%%%%%%%%%%%%%%%........%%%%%%%%%%%%........%%%%%%%.......%%%%%%%%%%%%%%........%%%%%%...
m .....%%%%%%%%%%%%%%%%%%%%%........%%%%%%%%%%%%........%%%%%........%%%%%%%%%%%%%%.........%%%%%...
m .....%%%%%%%%%%%%%%%%%%%%%........%%%%%%%%...........1%..%.%.......%%%%%%%%%%%%%%.........%%%%%...
m ......%%%%%%%%%%%%%%%%%%%........%%%%%%.............................%%%%%%%%%%%%%%........%%%%%%..
m .....%%%%%%%%%%%%%%%%%%%%%........%%%%%.............................%%%%%%%%%%%%%%........%%%%%%..
m .....%%.%.%%%%.%....%%%%%%.......%.%%%.............................%%%%%%%%%%%%%%%........%.%..%..
m ....................................................................%%%%%%%%%%%%%.................
m ...................................................................%%%%%%%%%%%%%%.................
m ...................................................................%%%%%%%%%%%%%%%................
