rows 96
cols 96
players 3
m .........%%%.............%%%.....%%%..............................%%%.....................%%%...
m .........%%%%............%%%%.....%%..............................%%%.....................%%%...
m .........%%%%............%%%%.....%%..............................%%%.....................%%%...
m .%..%....%%%......%%...%.%%%.....%%%.......%%....%%.%......%%....%%%......%.%....%%.%.....%%....
m ..%%%....%%%%.....%%%%%%%%%%.....%%%%....%%%%....%%%......%%%....%%%%....%%%......%%%.....%%....
m ..%%%.....%%......%%%%%%%%%%%....%%%%.....%%.....%%%%....%%%%.....%%%....%%%......%%%.....%%%...
m ..%%%....%.%.....%.%%..%...%.....%%.......%%......%%......%%.....%%%%....%%%.....%%%.....%..%...
m .%%%%.....................................%%%0....%%%....%%%%.....%%%.....%%%....%%%%...........
m .%%%.....................................%%%.....%%%......%%......%%%....%%%%....%%%%...........
m .%%%%.....................................%%%....%%%.....%%%%....%%%%....%%%%.....%%%...........
m .%%%%.....................................%%%.....%%.....%%%......%%%....%%%%....%%%%...........
m %%%%%%%%%%%%......%%%%..%%..%.%...%%...%.%%%%%%.%%%%......%%.....%%%%....%%%%....%%%%%..%%%.%%%%
m %%%%%%%%%%%%%....%%%%%%%%%%%%%%%%%%%%%%%%%%%%%%%%%%%%.....%%%.....%%.....%%%%....%%%%%%%%%%%%%%%
m %%%%%%%%%%%%.....%%%%%%%%%%%%%%%%%%%%%%%%%%%%%%%%%%%%.....%%%....%%%%.....%%%....%%%%%%%%%%%%%%%
m .%%%.%.%%%..%....%%%%..%%%.%.%.%%%..%%..%.%.%%%.%%%%.....%%%......%%.....%.......%.%%%..%%%%%.%%
m .................%%%%.............................%%%............%%%.....................%%%%...
m .................%%%%.............................%%%............%%%%....................%%%....
m ..................%%%............................%%%%............%%%%....................%%%%...
m ..................%%%............................%%%..............%%%....................%%%....
m %.%%.....%%%.....%%%%%%%%%%%......%.......%.......%%.....%.%...%.%%%.....%..%.......%%%%%%%%%%.%
m %%%%%.....%%%....%%%%%%%%%%%.....%%%.....%%%......%%%....%%%%%%%%%%%......%%%....%%%%%%%%%%%%%%%
m %%%%......%%%....%%%%%%%%%%%%.....%%%.....%%.....%%%.....%%%%%%%%%%%.....%%%%.....%%%%%%%%%%%%%%
m %..%......%......%.%..%%%%%%%....%%%......%%.....%%%.....%%%%..%.%..%.......%....%%%%.%.%.%.%%..
m ..................................%%%.............%%%............................%%%%...........
m ..................................%%.............%%%%............................%%%%...........
m .................................%%%.............%%%.............................%%%............
m ..................................%%%.............%%.............................%%%............
m .%%........%%..%..%%.........%%%%%%%%....%..%%.%.%%%%..%..%..%%....%%....%..%%%%%%%%%....%%%....
m .%%%%.....%%%%%%%%%%%.....%%%%%%%%%%......%%%%%%%%%%%%%%%%%%%%%%%%%%%....%%%%%%%%%%%.....%%%....
m ..%%.....%%%%%%%%%%%.....%%%%%%%%%%%%.....%%%%%%%%%%%%%%%%%%%%%%%%%%.....%%%%%%%%%%%.....%%%....
m ..%%.....%....%.%%%.%......%%%%..%%%.........%%%%.....%%.%%%%%%...%%......%%%%%..%.%%.....%%%...
m ..%%%.............................%%%....................%%%.............%%%.............%%%....
m .%%%..............................%%%.....................%%%............%%%.............%%%....
m ..%%..............................%%%.....................%%%............%%%%............%%%%...
m ..%%..............................%%%.....................%%%............%%%%............%%%%...
m .%%%.......%%....%%.%......%%....%%%......%.%....%%.%.....%%.....%..%....%%%......%%...%.%%%....
m .%%%%....%%%%....%%%......%%%....%%%%....%%%......%%%.....%%......%%%....%%%%.....%%%%%%%%%%....
m .%%%%.....%%.....%%%%....%%%%.....%%%....%%%......%%%.....%%%.....%%%.....%%......%%%%%%%%%%%...
m .%%.......%%......%%......%%.....%%%%....%%%.....%%%.....%..%.....%%%....%.%.....%.%%..%...%....
m ..........%%%2....%%%....%%%%.....%%%.....%%%....%%%%............%%%%...........................
m .........%%%.....%%%......%%......%%%....%%%%....%%%%............%%%............................
m ..........%%%....%%%.....%%%%....%%%%....%%%%.....%%%............%%%%...........................
m ..........%%%.....%%.....%%%......%%%....%%%%....%%%%............%%%%...........................
m ..%%...%.%%%%%%.%%%%......%%.....%%%%....%%%%....%%%%%..%%%.%%%%%%%%%%%%%%%%......%%%%..%%..%.%.
m %%%%%%%%%%%%%%%%%%%%%.....%%%.....%%.....%%%%....%%%%%%%%%%%%%%%%%%%%%%%%%%%%....%%%%%%%%%%%%%%%
m %%%%%%%%%%%%%%%%%%%%%.....%%%....%%%%.....%%%....%%%%%%%%%%%%%%%%%%%%%%%%%%%.....%%%%%%%%%%%%%%%
m %%..%%..%.%.%%%.%%%%.....%%%......%%.....%.......%.%%%..%%%%%.%%.%%%.%.%%%..%....%%%%..%%%.%.%.%
m ..................%%%............%%%.....................%%%%....................%%%%...........
m ..................%%%............%%%%....................%%%.....................%%%%...........
m .................%%%%............%%%%....................%%%%.....................%%%...........
m .................%%%..............%%%....................%%%......................%%%...........
m ..%.......%.......%%.....%.%...%.%%%.....%..%.......%%%%%%%%%%.%%.%%.....%%%.....%%%%%%%%%%%....
m .%%%.....%%%......%%%....%%%%%%%%%%%......%%%....%%%%%%%%%%%%%%%%%%%%.....%%%....%%%%%%%%%%%....
m ..%%%.....%%.....%%%.....%%%%%%%%%%%.....%%%%.....%%%%%%%%%%%%%%%%%%......%%%....%%%%%%%%%%%%...
m .%%%......%%.....%%%.....%%%%..%.%..%.......%....%%%%.%.%.%.%%..%..%......%......%.%..%%%%%%%...
m ..%%%.............%%%............................%%%%...........................................
m ..%%.............%%%%............................%%%%...........................................
m .%%%.............%%%.............................%%%............................................
m ..%%%.............%%.............................%%%............................................
m %%%%%....%..%%.%.%%%%..%..%..%%....%%....%..%%%%%%%%%....%%%.....%%........%%..%..%%.........%%%
m %%%%......%%%%%%%%%%%%%%%%%%%%%%%%%%%....%%%%%%%%%%%.....%%%.....%%%%.....%%%%%%%%%%%.....%%%%%%
m %%%%%.....%%%%%%%%%%%%%%%%%%%%%%%%%%.....%%%%%%%%%%%.....%%%......%%.....%%%%%%%%%%%.....%%%%%%%
m .%%%.........%%%%.....%%.%%%%%%...%%......%%%%%..%.%%.....%%%.....%%.....%....%.%%%.%......%%%%.
m ..%%%....................%%%.............%%%.............%%%......%%%...........................
m ..%%%.....................%%%............%%%.............%%%.....%%%............................
m ..%%%.....................%%%............%%%%............%%%%.....%%............................
m ..%%%.....................%%%............%%%%............%%%%.....%%............................
m .%%%......%.%....%%.%.....%%.....%..%....%%%......%%...%.%%%.....%%%.......%%....%%.%......%%...
m .%%%%....%%%......%%%.....%%......%%%....%%%%.....%%%%%%%%%%.....%%%%....%%%%....%%%......%%%...
m ..%%%....%%%......%%%.....%%%.....%%%.....%%......%%%%%%%%%%%....%%%%.....%%.....%%%%....%%%%...
m .%%%%....%%%.....%%%.....%..%.....%%%....%.%.....%.%%..%...%.....%%.......%%......%%......%%....
m ..%%%.....%%%....%%%%............%%%%.....................................%%%1....%%%....%%%%...
m ..%%%....%%%%....%%%%............%%%.....................................%%%.....%%%......%%....
m .%%%%....%%%%.....%%%............%%%%.....................................%%%....%%%.....%%%%...
m ..%%%....%%%%....%%%%............%%%%.....................................%%%.....%%.....%%%....
m .%%%%....%%%%....%%%%%..%%%.%%%%%%%%%%%%%%%%......%%%%..%%..%.%...%%...%.%%%%%%.%%%%......%%....
m ..%%.....%%%%....%%%%%%%%%%%%%%%%%%%%%%%%%%%%....%%%%%%%%%%%%%%%%%%%%%%%%%%%%%%%%%%%%.....%%%...
m .%%%%.....%%%....%%%%%%%%%%%%%%%%%%%%%%%%%%%.....%%%%%%%%%%%%%%%%%%%%%%%%%%%%%%%%%%%%.....%%%...
m ..%%.....%.......%.%%%..%%%%%.%%.%%%.%.%%%..%....%%%%..%%%.%.%.%%%..%%..%.%.%%%.%%%%.....%%%....
m .%%%.....................%%%%....................%%%%.............................%%%...........
m .%%%%....................%%%.....................%%%%.............................%%%...........
m .%%%%....................%%%%.....................%%%............................%%%%...........
m ..%%%....................%%%......................%%%............................%%%............
m .%%%.....%..%.......%%%%%%%%%%.%%.%%.....%%%.....%%%%%%%%%%%......%.......%.......%%.....%.%...%
m %%%%......%%%....%%%%%%%%%%%%%%%%%%%%.....%%%....%%%%%%%%%%%.....%%%.....%%%......%%%....%%%%%%%
m %%%%.....%%%%.....%%%%%%%%%%%%%%%%%%......%%%....%%%%%%%%%%%%.....%%%.....%%.....%%%.....%%%%%%%
m .%..%.......%....%%%%.%.%.%.%%..%..%......%......%.%..%%%%%%%....%%%......%%.....%%%.....%%%%..%
m .................%%%%.............................................%%%.............%%%...........
m .................%%%%.............................................%%.............%%%%...........
m .................%%%.............................................%%%.............%%%............
m .................%%%..............................................%%%.............%%............
m ...%%....%..%%%%%%%%%....%%%.....%%........%%..%..%%.........%%%%%%%%....%..%%.%.%%%%..%..%..%%.
m %%%%%....%%%%%%%%%%%.....%%%.....%%%%.....%%%%%%%%%%%.....%%%%%%%%%%......%%%%%%%%%%%%%%%%%%%%%%
m %%%%.....%%%%%%%%%%%.....%%%......%%.....%%%%%%%%%%%.....%%%%%%%%%%%%.....%%%%%%%%%%%%%%%%%%%%%%
m ..%%......%%%%%..%.%%.....%%%.....%%.....%....%.%%%.%......%%%%..%%%.........%%%%.....%%.%%%%%%.
m .........%%%.............%%%......%%%.............................%%%....................%%%....
