# map type: blank
# random seed: 160237201
# hill distance   6, 18  80, 51   8, 75  20, 71  68, 23  44, 95  30, 42  78, 90  92, 47  32,  3  54, 66  56, 27
#         6, 18       0      69      91      85      41      73      88      88      51      51     120      61 
#        80, 51      69       0      48      64      40      88      61      91      22      96      51      48 
#         8, 75      91      48       0      22      88      64      69      51      40      48      61      96 
#        20, 71      85      64      22       0      96      48      51      73      48      40      41      88 
#        68, 23      41      40      88      96       0      48      73      51      48      64      85      22 
#        44, 95      73      88      64      48      48       0      85      41      96      22      51      40 
#        30, 42      88      61      69      51      73      85       0     120      41      91      88      51 
#        78, 90      88      91      51      73      51      41     120       0      85      61      88      69 
#        92, 47      51      22      40      48      48      96      41      85       0      88      73      64 
#        32,  3      51      96      48      40      64      22      91      61      88       0      69      48 
#        54, 66     120      51      61      41      85      51      88      88      73      69       0      91 
#        56, 27      61      48      96      88      22      40      51      69      64      48      91       0 
players 4
rows 96
cols 96
m ...%%%....%.................%%....%................%%%...%%%.........%%%...%%%...............%%%
m ...%%.....%%................%%....%%................%....%%%.........%%.....%.................%%
m ...%%.....%................%%....%%.................%%....%%.........%%%...%%%...............%%.
m %%%%%....%%%....%......%....%....%%%%..%.%..%%.%....%%...%%%%%%%%....%%....%%%.%%.....%%......%%
m %%%%%.....%%...%%%....%%....%%....%%%%%%%%%%%%%....%%.....%%%%%%%%...%%.....%%%%%%%%%%%%%%...%%%
m .%%.%....%.%....%.....%.....%.....%%%.%.%%%.%%%............%.%%%%%...%%%...%...%.%.%.%.%%....%%%
m ...............%%.3...%...........%.............................%%......................%....%%.
m ...............%%%...%%%..........%%............................%%......................%%...%%%
m ...............%%.....%...........%%...........................%%%.........2...........%%....%%.
m ....%%...%......%%....%..........%%....%..%%%%%%...%%%%%%%%....%%%%%%..%.........%......%%...%%%
m ....%%....%.....%.....%.....%.....%%....%%%%%%%....%%%%%%%%....%%%%%%%%%...%%%....%....%%%...%%%
m ...%%%....%%...%%......%....%....%%%....%%%%.%%%...%..%.%%.%......%.%%%....%%%....%%...%%%...%%.
m ....%.....%%...%%...........%.....%%...%%%...%%%......................%%....%....%%%...%%....%%.
m ....%%...%%%...%%%..........%.....%%...%%....%%......................%%%...%%%....%%....%....%%.
m ....%%...%%%...%%%.........%%....%%%...%%%...%%......................%%%....%%....%.....%%...%%%
m ....%%%%.%%%....%%...%.%...%%%....%%%%%%%%....%%.....%%%.%%.%%...%....%%%%%%%....%%%%..%%%...%%%
m ...%%%%%%%%%....%%%%%%%%....%%...%%%%%%%%%....%....%%%%%%%%%%%%%%%...%%%%%%%%%...%%%%%%%%%...%%%
m ....%%..........%%.%..............%%%..%%%...%.%...%%%...%..%%.%%%...%..%%.%%....%..%%%%%%...%%.
m ....%%..........%%...............%%%...............%%%.........%%%......................%....%%%
m ...%%...........%%...............%%%...............%%...........%%......................%....%%%
m ....%%..........%................%%.................%%..........%......3................%....%%%
m ....%%.....%%%%%%%...%%.....%.%%%%%%%%%%%.%.........%%...%%....%%%...%.%......%%%%.%...%%%...%%.
m ...%%....%%%%%%%%%....%%...%%%%%%%%%%%%%%%%%%%%%....%....%%%....%%....%....%%%%%%%%%....%%...%%.
m ...%%.......%%.%%%...%%%...%%%%%.%%%%%%.%%.%..%....%%.....%%...%%%...%%.....%%%%.%%%...%%%...%%%
m ...%%%...............%%%...%%%....%.................%%....%................%%%...%%%.........%%%
m ....%.................%%...%%.....%%................%%....%%................%....%%%.........%%.
m ...%%%...............%%....%%.....%................%%....%%.................%%....%%.........%%%
m ...%%%.%%.....%%......%%%%%%%....%%%....%......%....%....%%%%..%.%..%%.%....%%...%%%%%%%%....%%.
m ....%%%%%%%%%%%%%%...%%%%%%%%.....%%...%%%....%%....%%....%%%%%%%%%%%%%....%%.....%%%%%%%%...%%.
m ...%...%.%.%.%.%%....%%%.%%.%....%.%....%.....%.....%.....%%%.%.%%%.%%%............%.%%%%%...%%%
m ................%....%%................%%.0...%...........%.............................%%......
m ................%%...%%%...............%%%...%%%..........%%............................%%......
m ...3...........%%....%%................%%.....%...........%%...........................%%%......
m .........%......%%...%%%....%%...%......%%....%..........%%....%..%%%%%%...%%%%%%%%....%%%%%%..%
m ...%%%....%....%%%...%%%....%%....%.....%.....%.....%.....%%....%%%%%%%....%%%%%%%%....%%%%%%%%%
m ...%%%....%%...%%%...%%....%%%....%%...%%......%....%....%%%....%%%%.%%%...%..%.%%.%......%.%%%.
m ....%....%%%...%%....%%.....%.....%%...%%...........%.....%%...%%%...%%%......................%%
m ...%%%....%%....%....%%.....%%...%%%...%%%..........%.....%%...%%....%%......................%%%
m ....%%....%.....%%...%%%....%%...%%%...%%%.........%%....%%%...%%%...%%......................%%%
m %%%%%....%%%%..%%%...%%%....%%%%.%%%....%%...%.%...%%%....%%%%%%%%....%%.....%%%.%%.%%...%....%%
m %%%%%%...%%%%%%%%%...%%%...%%%%%%%%%....%%%%%%%%....%%...%%%%%%%%%....%....%%%%%%%%%%%%%%%...%%%
m %%.%%....%..%%%%%%...%%.....%%..........%%.%..............%%%..%%%...%.%...%%%...%..%%.%%%...%..
m ................%....%%%....%%..........%%...............%%%...............%%%.........%%%......
m ................%....%%%...%%...........%%...............%%%...............%%...........%%......
m ................%....%%%....%%..........%................%%.................%%..........%......0
m ......%%%%.%...%%%...%%.....%%.....%%%%%%%...%%.....%.%%%%%%%%%%%.%.........%%...%%....%%%...%.%
m ...%%%%%%%%%....%%...%%....%%....%%%%%%%%%....%%...%%%%%%%%%%%%%%%%%%%%%....%....%%%....%%....%.
m ....%%%%.%%%...%%%...%%%...%%.......%%.%%%...%%%...%%%%%.%%%%%%.%%.%..%....%%.....%%...%%%...%%.
m ...%%%...%%%.........%%%...%%%...............%%%...%%%....%.................%%....%.............
m ....%....%%%.........%%.....%.................%%...%%.....%%................%%....%%............
m ....%%....%%.........%%%...%%%...............%%....%%.....%................%%....%%.............
m ....%%...%%%%%%%%....%%....%%%.%%.....%%......%%%%%%%....%%%....%......%....%....%%%%..%.%..%%.%
m ...%%.....%%%%%%%%...%%.....%%%%%%%%%%%%%%...%%%%%%%%.....%%...%%%....%%....%%....%%%%%%%%%%%%%.
m ...........%.%%%%%...%%%...%...%.%.%.%.%%....%%%.%%.%....%.%....%.....%.....%.....%%%.%.%%%.%%%.
m ................%%......................%....%%................%%.1...%...........%.............
m ................%%......................%%...%%%...............%%%...%%%..........%%............
m ...............%%%.........0...........%%....%%................%%.....%...........%%............
m ...%%%%%%%%....%%%%%%..%.........%......%%...%%%....%%...%......%%....%..........%%....%..%%%%%%
m ...%%%%%%%%....%%%%%%%%%...%%%....%....%%%...%%%....%%....%.....%.....%.....%.....%%....%%%%%%%.
m ...%..%.%%.%......%.%%%....%%%....%%...%%%...%%....%%%....%%...%%......%....%....%%%....%%%%.%%%
m ......................%%....%....%%%...%%....%%.....%.....%%...%%...........%.....%%...%%%...%%%
m .....................%%%...%%%....%%....%....%%.....%%...%%%...%%%..........%.....%%...%%....%%.
m .....................%%%....%%....%.....%%...%%%....%%...%%%...%%%.........%%....%%%...%%%...%%.
m .....%%%.%%.%%...%....%%%%%%%....%%%%..%%%...%%%....%%%%.%%%....%%...%.%...%%%....%%%%%%%%....%%
m ...%%%%%%%%%%%%%%%...%%%%%%%%%...%%%%%%%%%...%%%...%%%%%%%%%....%%%%%%%%....%%...%%%%%%%%%....%.
m ...%%%...%..%%.%%%...%..%%.%%....%..%%%%%%...%%.....%%..........%%.%..............%%%..%%%...%.%
m ...%%%.........%%%......................%....%%%....%%..........%%...............%%%............
m ...%%...........%%......................%....%%%...%%...........%%...............%%%............
m ....%%..........%......1................%....%%%....%%..........%................%%.............
m ....%%...%%....%%%...%.%......%%%%.%...%%%...%%.....%%.....%%%%%%%...%%.....%.%%%%%%%%%%%.%.....
m ....%....%%%....%%....%....%%%%%%%%%....%%...%%....%%....%%%%%%%%%....%%...%%%%%%%%%%%%%%%%%%%%%
m ...%%.....%%...%%%...%%.....%%%%.%%%...%%%...%%%...%%.......%%.%%%...%%%...%%%%%.%%%%%%.%%.%..%.
m ....%%....%................%%%...%%%.........%%%...%%%...............%%%...%%%....%.............
m ....%%....%%................%....%%%.........%%.....%.................%%...%%.....%%............
m ...%%....%%.................%%....%%.........%%%...%%%...............%%....%%.....%.............
m ....%....%%%%..%.%..%%.%....%%...%%%%%%%%....%%....%%%.%%.....%%......%%%%%%%....%%%....%......%
m ....%%....%%%%%%%%%%%%%....%%.....%%%%%%%%...%%.....%%%%%%%%%%%%%%...%%%%%%%%.....%%...%%%....%%
m ....%.....%%%.%.%%%.%%%............%.%%%%%...%%%...%...%.%.%.%.%%....%%%.%%.%....%.%....%.....%.
m ..........%.............................%%......................%....%%................%%.2...%.
m ..........%%............................%%......................%%...%%%...............%%%...%%%
m ..........%%...........................%%%.........1...........%%....%%................%%.....%.
m .........%%....%..%%%%%%...%%%%%%%%....%%%%%%..%.........%......%%...%%%....%%...%......%%....%.
m ....%.....%%....%%%%%%%....%%%%%%%%....%%%%%%%%%...%%%....%....%%%...%%%....%%....%.....%.....%.
m ....%....%%%....%%%%.%%%...%..%.%%.%......%.%%%....%%%....%%...%%%...%%....%%%....%%...%%......%
m ....%.....%%...%%%...%%%......................%%....%....%%%...%%....%%.....%.....%%...%%.......
m ....%.....%%...%%....%%......................%%%...%%%....%%....%....%%.....%%...%%%...%%%......
m ...%%....%%%...%%%...%%......................%%%....%%....%.....%%...%%%....%%...%%%...%%%......
m ...%%%....%%%%%%%%....%%.....%%%.%%.%%...%....%%%%%%%....%%%%..%%%...%%%....%%%%.%%%....%%...%.%
m ....%%...%%%%%%%%%....%....%%%%%%%%%%%%%%%...%%%%%%%%%...%%%%%%%%%...%%%...%%%%%%%%%....%%%%%%%%
m ..........%%%..%%%...%.%...%%%...%..%%.%%%...%..%%.%%....%..%%%%%%...%%.....%%..........%%.%....
m .........%%%...............%%%.........%%%......................%....%%%....%%..........%%......
m .........%%%...............%%...........%%......................%....%%%...%%...........%%......
m .........%%.................%%..........%......2................%....%%%....%%..........%.......
m ....%.%%%%%%%%%%%.%.........%%...%%....%%%...%.%......%%%%.%...%%%...%%.....%%.....%%%%%%%...%%.
m ...%%%%%%%%%%%%%%%%%%%%%....%....%%%....%%....%....%%%%%%%%%....%%...%%....%%....%%%%%%%%%....%%
m ...%%%%%.%%%%%%.%%.%..%....%%.....%%...%%%...%%.....%%%%.%%%...%%%...%%%...%%.......%%.%%%...%%%
