# map type: blank
# random seed: 1252033277
# hill distance  28,100 125, 24  25,  4 105,104 128,120  68, 80   5, 84   8, 40  65,124  48, 20  85, 44  88,  0  45, 64 108, 60
#        28,100       0     131      77     103      72      72      59      98      65      98     113     112      53     112 
#       125, 24     131       0      84      92      77     113      92      59     124     103      84      65     124      53 
#        25,  4      77      84       0     124      65     131      92      53      84      59     124     103      92     113 
#       105,104     103      92     124       0      59      65      84     131      84     113      92      53     124      77 
#       128,120      72      77      65      59       0     112      53      98     103     112     131      72     113      98 
#        68, 80      72     113     131      65     112       0     103     112      77      98      53      98      59      72 
#         5, 84      59      92      92      84      53     103       0      77     124     131     124     113      84      65 
#         8, 40      98      59      53     131      98     112      77       0     113      72     103     112      65      72 
#        65,124      65     124      84      84     103      77     124     113       0      53      92      59      92     131 
#        48, 20      98     103      59     113     112      98     131      72      53       0      65      72      77     112 
#        85, 44     113      84     124      92     131      53     124     103      92      65       0      77      84      59 
#        88,  0     112      65     103      53      72      98     113     112      59      72      77       0     131      98 
#        45, 64      53     124      92     124     113      59      84      65      92      77      84     131       0     103 
#       108, 60     112      53     113      77      98      72      65      72     131     112      59      98     103       0 
players 7
rows 140
cols 140
m %%%%%%%%%%.%%...%.%%%%%%.......%.%%..%.%%%%.......%.%%%%%%%%%%%%.....%%.%........%%......%..%%......%%..%%%%%%%%%%%%%%%%%%%%%%%%%%%%%%......
m %%%%%%%%%%%%%%%%%%%%%%%%.....%%%%%%%%%%%%%%%......%%%%%%%%%%%%%......%%%%%.....%%%%......%%%%%.....%%%%%%%%%%%%%%%%%%%%%%%%%%%%%%%%%%.......
m %%%%%%%%%%%%%%%%%%%%%%%......%%%%%%%%%%%%%%......%%%%%%%%%%%%%%.......%%%%.....%%%%%......%%%%......%%%%%%%%%%%%%%%%%%%%%%%%%%%%%%%%%%.....%
m %%%%%%%%%%%%%%%%%%%%%%%......%%%%%%%%%%%%%%......%%%%%%%%%%%%%%%......%%%......%%%%%......%%%.......%%%%%%%%%%%%%%%%%%%%%%%%%%%%%%%%%.......
m %%..%.%%%%%%%%.%.....%%.......%%%%%.%%..%..%.....%%%%%%..%%%.%.......%%%%.......%%%%......%%%......%.%..%%%%%%%%%%....%%.....%%%.%%%%......%
m ..............................%%%%...............%%%%%...............%%%%%.....%%%%.1....%%%%.................%%%%...............%%%%.......
m ..............................%%%%...............%%%%%...............%%%%%......%%%.......%%%%...............%%%%%...............%%%%.......
m .............................%%%%%...............%%%%%................%%%%.....%%%%.......%%%%................%%%................%%%%%......
m ..............................%%%.......5........%%%%.................%%%.......%%%%.....%%%%................%%%%................%%%%%......
m ..............................%%%................%%%%................%%%%%......%%%%......%%%................%%%%%...............%%%%%......
m %%...%%%.%.%%.%%%%%.%%%%.....%%%%%..............%%%%%.........%%%%...%%%%%.....%%%%%..%.%%%%%.......%%%......%%%%%.....%%........%%%%%.....%
m %%%%%%%%%%%%%%%%%%%%%%%.......%%%%......%%%%%%%%%%%%%.......%%%%%%%%%%%%%......%%%%%%%%%%%%%%......%%%%.......%%%%......%%%%.....%%%%.......
m %%%%%%%%%%%%%%%%%%%%%%%......%%%%%......%%%%%%%%%%%%%.......%%%%%%%%%%%%%......%%%%%%%%%%%%%%%.....%%%%......%%%%.......%%%%.....%%%%.......
m %%%%%%%%%%%%%%%%%%%%%%%......%%%%......%%%%%%%%%%%%%%%.....%%%%%%%%%%%%%%%......%%%%%%%%%%%%%......%%%%.......%%%%.....%%%%%.....%%%%%......
m %..%.%..%%..%%.%..%%%%%........%%......%%%%.%%%..%.%%%.....%...%.%...%%.%......%%%%.%.%%.%%.%......%%%%%.....%.%........%%%%.......%%.......
m ....................................................................................................%%%%...............%%%%.................
m ....................................................................................................%%%................%%%%.................
m ...................................................................................................%%%%%...............%%%%.................
m ...................................................................................................%%%%................%%%%%................
m ....................................................................................................%%%%...............%%%%%................
m .%%......%..%%......%%..%%%%%%%%%%%%%%%%%%%%%%%%%%%%%%......%%%%%%%%%%.%%...%.%%%%%%.......%.%%..%.%%%%.......%.%%%%%%%%%%%%.....%%.%.......
m %%%......%%%%%.....%%%%%%%%%%%%%%%%%%%%%%%%%%%%%%%%%%.......%%%%%%%%%%%%%%%%%%%%%%%%.....%%%%%%%%%%%%%%%......%%%%%%%%%%%%%......%%%%%.....%
m %%%%......%%%%......%%%%%%%%%%%%%%%%%%%%%%%%%%%%%%%%%%.....%%%%%%%%%%%%%%%%%%%%%%%%......%%%%%%%%%%%%%%......%%%%%%%%%%%%%%.......%%%%.....%
m %%%%......%%%.......%%%%%%%%%%%%%%%%%%%%%%%%%%%%%%%%%.......%%%%%%%%%%%%%%%%%%%%%%%......%%%%%%%%%%%%%%......%%%%%%%%%%%%%%%......%%%......%
m %%%%......%%%......%.%..%%%%%%%%%%....%%.....%%%.%%%%......%%%..%.%%%%%%%%.%.....%%.......%%%%%.%%..%..%.....%%%%%%..%%%.%.......%%%%.......
m %%%.0....%%%%.................%%%%...............%%%%.....................................%%%%...............%%%%%...............%%%%%.....%
m %%%.......%%%%...............%%%%%...............%%%%.....................................%%%%...............%%%%%...............%%%%%......
m %%%.......%%%%................%%%................%%%%%...................................%%%%%...............%%%%%................%%%%.....%
m %%%%.....%%%%................%%%%................%%%%%....................................%%%.......4........%%%%.................%%%.......
m %%%%......%%%................%%%%%...............%%%%%....................................%%%................%%%%................%%%%%......
m %%%%..%.%%%%%.......%%%......%%%%%.....%%........%%%%%.....%%%...%%%.%.%%.%%%%%.%%%%.....%%%%%..............%%%%%.........%%%%...%%%%%.....%
m %%%%%%%%%%%%%......%%%%.......%%%%......%%%%.....%%%%.......%%%%%%%%%%%%%%%%%%%%%%%.......%%%%......%%%%%%%%%%%%%.......%%%%%%%%%%%%%......%
m %%%%%%%%%%%%%%.....%%%%......%%%%.......%%%%.....%%%%.......%%%%%%%%%%%%%%%%%%%%%%%......%%%%%......%%%%%%%%%%%%%.......%%%%%%%%%%%%%......%
m %%%%%%%%%%%%%......%%%%.......%%%%.....%%%%%.....%%%%%......%%%%%%%%%%%%%%%%%%%%%%%......%%%%......%%%%%%%%%%%%%%%.....%%%%%%%%%%%%%%%......
m %%%.%.%%.%%.%......%%%%%.....%.%........%%%%.......%%.......%..%.%..%%..%%.%..%%%%%........%%......%%%%.%%%..%.%%%.....%...%.%...%%.%......%
m ....................%%%%...............%%%%.................................................................................................
m ....................%%%................%%%%.................................................................................................
m ...................%%%%%...............%%%%.................................................................................................
m ...................%%%%................%%%%%................................................................................................
m ....................%%%%...............%%%%%................................................................................................
m %%%%.......%.%%..%.%%%%.......%.%%%%%%%%%%%%.....%%.%........%%......%..%%......%%..%%%%%%%%%%%%%%%%%%%%%%%%%%%%%%......%%%%%%%%%%.%%...%.%%
m %%%%.....%%%%%%%%%%%%%%%......%%%%%%%%%%%%%......%%%%%.....%%%%......%%%%%.....%%%%%%%%%%%%%%%%%%%%%%%%%%%%%%%%%%.......%%%%%%%%%%%%%%%%%%%%
m %%%......%%%%%%%%%%%%%%......%%%%%%%%%%%%%%.......%%%%.....%%%%%......%%%%......%%%%%%%%%%%%%%%%%%%%%%%%%%%%%%%%%%.....%%%%%%%%%%%%%%%%%%%%%
m %%%......%%%%%%%%%%%%%%......%%%%%%%%%%%%%%%......%%%......%%%%%......%%%.......%%%%%%%%%%%%%%%%%%%%%%%%%%%%%%%%%.......%%%%%%%%%%%%%%%%%%%%
m .%%.......%%%%%.%%..%..%.....%%%%%%..%%%.%.......%%%%.......%%%%......%%%......%.%..%%%%%%%%%%....%%.....%%%.%%%%......%%%..%.%%%%%%%%.%....
m ..........%%%%...............%%%%%...............%%%%%.....%%%%.6....%%%%.................%%%%...............%%%%...........................
m ..........%%%%...............%%%%%...............%%%%%......%%%.......%%%%...............%%%%%...............%%%%...........................
m .........%%%%%...............%%%%%................%%%%.....%%%%.......%%%%................%%%................%%%%%..........................
m ..........%%%.......3........%%%%.................%%%.......%%%%.....%%%%................%%%%................%%%%%..........................
m ..........%%%................%%%%................%%%%%......%%%%......%%%................%%%%%...............%%%%%..........................
m %%%%.....%%%%%..............%%%%%.........%%%%...%%%%%.....%%%%%..%.%%%%%.......%%%......%%%%%.....%%........%%%%%.....%%%...%%%.%.%%.%%%%%.
m %%%.......%%%%......%%%%%%%%%%%%%.......%%%%%%%%%%%%%......%%%%%%%%%%%%%%......%%%%.......%%%%......%%%%.....%%%%.......%%%%%%%%%%%%%%%%%%%%
m %%%......%%%%%......%%%%%%%%%%%%%.......%%%%%%%%%%%%%......%%%%%%%%%%%%%%%.....%%%%......%%%%.......%%%%.....%%%%.......%%%%%%%%%%%%%%%%%%%%
m %%%......%%%%......%%%%%%%%%%%%%%%.....%%%%%%%%%%%%%%%......%%%%%%%%%%%%%......%%%%.......%%%%.....%%%%%.....%%%%%......%%%%%%%%%%%%%%%%%%%%
m %%%........%%......%%%%.%%%..%.%%%.....%...%.%...%%.%......%%%%.%.%%.%%.%......%%%%%.....%.%........%%%%.......%%.......%..%.%..%%..%%.%..%%
m ................................................................................%%%%...............%%%%.....................................
m ................................................................................%%%................%%%%.....................................
m ...............................................................................%%%%%...............%%%%.....................................
m ...............................................................................%%%%................%%%%%....................................
m ................................................................................%%%%...............%%%%%....................................
m %%..%%%%%%%%%%%%%%%%%%%%%%%%%%%%%%......%%%%%%%%%%.%%...%.%%%%%%.......%.%%..%.%%%%.......%.%%%%%%%%%%%%.....%%.%........%%......%..%%......
m %%%%%%%%%%%%%%%%%%%%%%%%%%%%%%%%%.......%%%%%%%%%%%%%%%%%%%%%%%%.....%%%%%%%%%%%%%%%......%%%%%%%%%%%%%......%%%%%.....%%%%......%%%%%.....%
m %%%%%%%%%%%%%%%%%%%%%%%%%%%%%%%%%%.....%%%%%%%%%%%%%%%%%%%%%%%%......%%%%%%%%%%%%%%......%%%%%%%%%%%%%%.......%%%%.....%%%%%......%%%%......
m %%%%%%%%%%%%%%%%%%%%%%%%%%%%%%%%%.......%%%%%%%%%%%%%%%%%%%%%%%......%%%%%%%%%%%%%%......%%%%%%%%%%%%%%%......%%%......%%%%%......%%%.......
m .%..%%%%%%%%%%....%%.....%%%.%%%%......%%%..%.%%%%%%%%.%.....%%.......%%%%%.%%..%..%.....%%%%%%..%%%.%.......%%%%.......%%%%......%%%......%
m ..........%%%%...............%%%%.....................................%%%%...............%%%%%...............%%%%%.....%%%%.5....%%%%.......
m .........%%%%%...............%%%%.....................................%%%%...............%%%%%...............%%%%%......%%%.......%%%%......
m ..........%%%................%%%%%...................................%%%%%...............%%%%%................%%%%.....%%%%.......%%%%......
m .........%%%%................%%%%%....................................%%%.......2........%%%%.................%%%.......%%%%.....%%%%.......
m .........%%%%%...............%%%%%....................................%%%................%%%%................%%%%%......%%%%......%%%.......
m %%%......%%%%%.....%%........%%%%%.....%%%...%%%.%.%%.%%%%%.%%%%.....%%%%%..............%%%%%.........%%%%...%%%%%.....%%%%%..%.%%%%%.......
m %%%.......%%%%......%%%%.....%%%%.......%%%%%%%%%%%%%%%%%%%%%%%.......%%%%......%%%%%%%%%%%%%.......%%%%%%%%%%%%%......%%%%%%%%%%%%%%......%
m %%%......%%%%.......%%%%.....%%%%.......%%%%%%%%%%%%%%%%%%%%%%%......%%%%%......%%%%%%%%%%%%%.......%%%%%%%%%%%%%......%%%%%%%%%%%%%%%.....%
m %%%.......%%%%.....%%%%%.....%%%%%......%%%%%%%%%%%%%%%%%%%%%%%......%%%%......%%%%%%%%%%%%%%%.....%%%%%%%%%%%%%%%......%%%%%%%%%%%%%......%
m %%%%.....%.%........%%%%.......%%.......%..%.%..%%..%%.%..%%%%%........%%......%%%%.%%%..%.%%%.....%...%.%...%%.%......%%%%.%.%%.%%.%......%
m %%%%...............%%%%.....................................................................................................................
m %%%................%%%%.....................................................................................................................
m %%%%...............%%%%....................................................................................................................%
m %%%................%%%%%...................................................................................................................%
m %%%%...............%%%%%....................................................................................................................
m %%%.......%.%%%%%%%%%%%%.....%%.%........%%......%..%%......%%..%%%%%%%%%%%%%%%%%%%%%%%%%%%%%%......%%%%%%%%%%.%%...%.%%%%%%.......%.%%..%.%
m %%%%......%%%%%%%%%%%%%......%%%%%.....%%%%......%%%%%.....%%%%%%%%%%%%%%%%%%%%%%%%%%%%%%%%%%.......%%%%%%%%%%%%%%%%%%%%%%%%.....%%%%%%%%%%%
m %%%......%%%%%%%%%%%%%%.......%%%%.....%%%%%......%%%%......%%%%%%%%%%%%%%%%%%%%%%%%%%%%%%%%%%.....%%%%%%%%%%%%%%%%%%%%%%%%......%%%%%%%%%%%
m %%%......%%%%%%%%%%%%%%%......%%%......%%%%%......%%%.......%%%%%%%%%%%%%%%%%%%%%%%%%%%%%%%%%.......%%%%%%%%%%%%%%%%%%%%%%%......%%%%%%%%%%%
m %..%.....%%%%%%..%%%.%.......%%%%.......%%%%......%%%......%.%..%%%%%%%%%%....%%.....%%%.%%%%......%%%..%.%%%%%%%%.%.....%%.......%%%%%.%%..
m .........%%%%%...............%%%%%.....%%%%.4....%%%%.................%%%%...............%%%%.....................................%%%%......
m .........%%%%%...............%%%%%......%%%.......%%%%...............%%%%%...............%%%%.....................................%%%%......
m .........%%%%%................%%%%.....%%%%.......%%%%................%%%................%%%%%...................................%%%%%......
m 1........%%%%.................%%%.......%%%%.....%%%%................%%%%................%%%%%....................................%%%.......
m .........%%%%................%%%%%......%%%%......%%%................%%%%%...............%%%%%....................................%%%.......
m ........%%%%%.........%%%%...%%%%%.....%%%%%..%.%%%%%.......%%%......%%%%%.....%%........%%%%%.....%%%...%%%.%.%%.%%%%%.%%%%.....%%%%%......
m %%%%%%%%%%%%%.......%%%%%%%%%%%%%......%%%%%%%%%%%%%%......%%%%.......%%%%......%%%%.....%%%%.......%%%%%%%%%%%%%%%%%%%%%%%.......%%%%......
m %%%%%%%%%%%%%.......%%%%%%%%%%%%%......%%%%%%%%%%%%%%%.....%%%%......%%%%.......%%%%.....%%%%.......%%%%%%%%%%%%%%%%%%%%%%%......%%%%%......
m %%%%%%%%%%%%%%.....%%%%%%%%%%%%%%%......%%%%%%%%%%%%%......%%%%.......%%%%.....%%%%%.....%%%%%......%%%%%%%%%%%%%%%%%%%%%%%......%%%%......%
m %%%.%%%..%.%%%.....%...%.%...%%.%......%%%%.%.%%.%%.%......%%%%%.....%.%........%%%%.......%%.......%..%.%..%%..%%.%..%%%%%........%%......%
m ............................................................%%%%...............%%%%.........................................................
m ............................................................%%%................%%%%.........................................................
m ...........................................................%%%%%...............%%%%.........................................................
m ...........................................................%%%%................%%%%%........................................................
m ............................................................%%%%...............%%%%%........................................................
m %%%%%%%%%%%%%%......%%%%%%%%%%.%%...%.%%%%%%.......%.%%..%.%%%%.......%.%%%%%%%%%%%%.....%%.%........%%......%..%%......%%..%%%%%%%%%%%%%%%%
m %%%%%%%%%%%%%.......%%%%%%%%%%%%%%%%%%%%%%%%.....%%%%%%%%%%%%%%%......%%%%%%%%%%%%%......%%%%%.....%%%%......%%%%%.....%%%%%%%%%%%%%%%%%%%%%
m %%%%%%%%%%%%%%.....%%%%%%%%%%%%%%%%%%%%%%%%......%%%%%%%%%%%%%%......%%%%%%%%%%%%%%.......%%%%.....%%%%%......%%%%......%%%%%%%%%%%%%%%%%%%%
m %%%%%%%%%%%%%.......%%%%%%%%%%%%%%%%%%%%%%%......%%%%%%%%%%%%%%......%%%%%%%%%%%%%%%......%%%......%%%%%......%%%.......%%%%%%%%%%%%%%%%%%%%
m .....%%%.%%%%......%%%..%.%%%%%%%%.%.....%%.......%%%%%.%%..%..%.....%%%%%%..%%%.%.......%%%%.......%%%%......%%%......%.%..%%%%%%%%%%....%%
m .........%%%%.....................................%%%%...............%%%%%...............%%%%%.....%%%%.3....%%%%.................%%%%......
m .........%%%%.....................................%%%%...............%%%%%...............%%%%%......%%%.......%%%%...............%%%%%......
m .........%%%%%...................................%%%%%...............%%%%%................%%%%.....%%%%.......%%%%................%%%.......
m .........%%%%%....................................%%%.......0........%%%%.................%%%.......%%%%.....%%%%................%%%%.......
m .........%%%%%....................................%%%................%%%%................%%%%%......%%%%......%%%................%%%%%......
m %........%%%%%.....%%%...%%%.%.%%.%%%%%.%%%%.....%%%%%..............%%%%%.........%%%%...%%%%%.....%%%%%..%.%%%%%.......%%%......%%%%%.....%
m %%%%.....%%%%.......%%%%%%%%%%%%%%%%%%%%%%%.......%%%%......%%%%%%%%%%%%%.......%%%%%%%%%%%%%......%%%%%%%%%%%%%%......%%%%.......%%%%......
m %%%%.....%%%%.......%%%%%%%%%%%%%%%%%%%%%%%......%%%%%......%%%%%%%%%%%%%.......%%%%%%%%%%%%%......%%%%%%%%%%%%%%%.....%%%%......%%%%.......
m %%%%.....%%%%%......%%%%%%%%%%%%%%%%%%%%%%%......%%%%......%%%%%%%%%%%%%%%.....%%%%%%%%%%%%%%%......%%%%%%%%%%%%%......%%%%.......%%%%.....%
m %%%%.......%%.......%..%.%..%%..%%.%..%%%%%........%%......%%%%.%%%..%.%%%.....%...%.%...%%.%......%%%%.%.%%.%%.%......%%%%%.....%.%........
m %%%.....................................................................................................................%%%%...............%
m %%%.....................................................................................................................%%%................%
m %%%....................................................................................................................%%%%%...............%
m %%%%...................................................................................................................%%%%................%
m %%%%....................................................................................................................%%%%...............%
m %%%%.....%%.%........%%......%..%%......%%..%%%%%%%%%%%%%%%%%%%%%%%%%%%%%%......%%%%%%%%%%.%%...%.%%%%%%.......%.%%..%.%%%%.......%.%%%%%%%%
m %%%......%%%%%.....%%%%......%%%%%.....%%%%%%%%%%%%%%%%%%%%%%%%%%%%%%%%%%.......%%%%%%%%%%%%%%%%%%%%%%%%.....%%%%%%%%%%%%%%%......%%%%%%%%%%
m %%%.......%%%%.....%%%%%......%%%%......%%%%%%%%%%%%%%%%%%%%%%%%%%%%%%%%%%.....%%%%%%%%%%%%%%%%%%%%%%%%......%%%%%%%%%%%%%%......%%%%%%%%%%%
m %%%%......%%%......%%%%%......%%%.......%%%%%%%%%%%%%%%%%%%%%%%%%%%%%%%%%.......%%%%%%%%%%%%%%%%%%%%%%%......%%%%%%%%%%%%%%......%%%%%%%%%%%
m .%.......%%%%.......%%%%......%%%......%.%..%%%%%%%%%%....%%.....%%%.%%%%......%%%..%.%%%%%%%%.%.....%%.......%%%%%.%%..%..%.....%%%%%%..%%%
m .........%%%%%.....%%%%.2....%%%%.................%%%%...............%%%%.....................................%%%%...............%%%%%......
m .........%%%%%......%%%.......%%%%...............%%%%%...............%%%%.....................................%%%%...............%%%%%......
m ..........%%%%.....%%%%.......%%%%................%%%................%%%%%...................................%%%%%...............%%%%%......
m ..........%%%.......%%%%.....%%%%................%%%%................%%%%%....................................%%%.......6........%%%%.......
m .........%%%%%......%%%%......%%%................%%%%%...............%%%%%....................................%%%................%%%%.......
m ..%%%%...%%%%%.....%%%%%..%.%%%%%.......%%%......%%%%%.....%%........%%%%%.....%%%...%%%.%.%%.%%%%%.%%%%.....%%%%%..............%%%%%.......
m %%%%%%%%%%%%%......%%%%%%%%%%%%%%......%%%%.......%%%%......%%%%.....%%%%.......%%%%%%%%%%%%%%%%%%%%%%%.......%%%%......%%%%%%%%%%%%%.......
m %%%%%%%%%%%%%......%%%%%%%%%%%%%%%.....%%%%......%%%%.......%%%%.....%%%%.......%%%%%%%%%%%%%%%%%%%%%%%......%%%%%......%%%%%%%%%%%%%.......
m %%%%%%%%%%%%%%......%%%%%%%%%%%%%......%%%%.......%%%%.....%%%%%.....%%%%%......%%%%%%%%%%%%%%%%%%%%%%%......%%%%......%%%%%%%%%%%%%%%.....%
m ...%.%...%%.%......%%%%.%.%%.%%.%......%%%%%.....%.%........%%%%.......%%.......%..%.%..%%..%%.%..%%%%%........%%......%%%%.%%%..%.%%%.....%
m ........................................%%%%...............%%%%.............................................................................
m ........................................%%%................%%%%.............................................................................
m .......................................%%%%%...............%%%%.............................................................................
m .......................................%%%%................%%%%%............................................................................
m ........................................%%%%...............%%%%%............................................................................
