# map type: blank
# random seed: -2052201180
# hill distance  18, 24  56, 62   5, 37  43, 11
#        18, 24       0      52      26      38 
#        56, 62      52       0      38      26 
#         5, 37      26      38       0      52 
#        43, 11      38      26      52       0 
players 4
rows 64
cols 64
m .......................%%.....%%%%.....%%.....%%%%..............
m ......................%%......%%%%............%%%%..............
m .....................%..........................................
m ..................%.%...........................................
m ..%%%%......%....%%%%.....................................%.%...
m ...%%......%.....%%%.................1.....................%%...
m ...%%%...........%.......%.....%.%....%.%%.....%%.........%%%...
m ....%..........................%%.....%%%......%%.........%%.%..
m ...............................%%......%%%....%%%%..............
m ...............................%%%.....%.%.......%..............
m .............................%%%%%..............................
m ..........%.%.....%%%........%%%%%..............................
m ..%......%%%%....%%%%....%%%%%%%%%.....................%%%..%%..
m ...%......%%%.....%%%.....%%%%%%%%....................%%%%%%%...
m ..%.%.......%....%.%%....%..%%%%%%....%.%.....%.......%%%%%%%%..
m ................................................................
m ................................................................
m ................................................................
m ........................3.......................................
m ..%.%....%...............%%......%....................%%%..%%%..
m ..%%%.....%%%.....%%......%%%.........................%%%%%%%%..
m ..%%.....%%%.....%%%.....%%%.....%....................%%%%%%%%..
m ..%%.....%%.%.....%......%.%%....................%....%.%%%%%...
m ..%%%....................................................%%%%...
m ..%%%.....................................................%%%%..
m ..%%%......................................................%%%..
m ..%%......................................................%%%%..
m .................%.%%......%.....%..............................
m ..................%%%....%%%....................................
m ..................%%%....%%%....................................
m .................%%%%......%%............%.......%%.............
m .......%%......%%%%..............................%%.......%.....
m ........%%%....%%%..............................................
m ........%%%....%%%..............................................
m ..%.....%......%%.%.............................................
m ................................%%....%%%%......................
m ...............................%%%....%%%.......................
m ...............................%%%....%%%%......................
m ...............................%%%.....%%%%.....................
m .......%%.%......%.....%.%%.....%%.....%%%%%.%....%.............
m ..%.....%%%.....%%%.....%%%.....%%....%%%%%%%%..................
m .......%%%......%%.....%%%.....%%%....%%%%%%%%..................
m ..%......%%...............%....%.%....%%%..%%%..................
m ...........2....................................................
m ................................................................
m ................................................................
m ................................................................
m ..%%%%%%..%....%%.%....%.......%.%....%%%%%%%%.......%.....%.%..
m ..%%%%%%%%.....%%%.....%%%......%......%%%%%%%..................
m ..%%%%%%%%%....%%%%....%%%%......%....%%..%%%...................
m ..%%%%%........%%%.....%.%......................................
m ..%%%%%.........................................................
m ..%%%.............................................%.......%.%...
m ...%%.............................................%%%%....%%%...
m ...%%..........................%......%.%%.........%%......%%%..
m ..%.%.....%.......%...........%%%......%%%.........%%.....%%.%..
m ................%%%.....%......%%......%%.....................0.
m ...............%%%%....%......%%%%.....%.%......................
m ...............%.%..............................................
m ..............%.................................................
m ..%%%%......%%....................................%%%%..........
m ..%%%%.....%%.....................................%%%%.....%%...
m ...%%%.....%%%.........%%%.....%.%......%.....%..%%%%.....%%%...
m ..%.%.....%%%.........%%%.....%%%......%%%.....%%%%..%.....%....
