# map type: blank
# random seed: -903682668
# hill distance   1, 67  26, 23  22, 49  44, 44  49, 66  27, 71  45, 20  70, 48
#         1, 67       0      53      39      52      25      30      53      22 
#        26, 23      53       0      30      39      52      25      22      53 
#        22, 49      39      30       0      27      44      27      52      25 
#        44, 44      52      39      27       0      27      44      25      30 
#        49, 66      25      52      44      27       0      27      30      39 
#        27, 71      30      25      27      44      27       0      39      52 
#        45, 20      53      22      52      25      30      39       0      53 
#        70, 48      22      53      25      30      39      52      53       0 
players 4
rows 72
cols 72
m ....................%%%%................................................
m ....................%%%%...........................................1....
m ........%%%...%%%%...........................................%.......%..
m %.......%%%%%%%%%%..........................................%%......%%%%
m %.......%%%%%%%%%.......%%.%....%%%.........%%%........%..%.%........%%%
m %%......%%%%%%%%%%......%%%%%%%%%%%.......%%%%%.......%%%%%%%%.......%%%
m %%......%%%%%%%%%.......%%%%%%%%%%%.......%%%%%........%%%%%%%......%%%%
m %%......%%%%%%%%%.......%%%%%%%%%%%%.......%%%%.......%%.%.%........%..%
m .............%%%%........%%%%%%%%%%........%%%%.......%%................
m ............%%%%%........%%%%%.%.%%%......%.%.%........%................
m .............%%%%%.......%%%%%..........................................
m ............%%%%%%......%%%%%%..........................................
m ............%%%%%%......%%%%%%..........................................
m ............%.%.........%%%%%%..........................................
m ............................................................%%......%%.%
m ............................................................%%......%%%%
m ............................................%%%%......%%%.%%%%......%%%%
m ...........................................%%%%........%%%%%%........%%%
m ...........................................%%%%%......%%%%%%%%......%%%%
m ..........................................%%%%%%......%%.%...........%%%
m .%%.........%..%%..........%%%............%%%%%.......%%................
m %%%%%........%%%%........%%%%%.............%...........%................
m .%%%%%......%%%%%%.......%%%%%......%%%%%%.......2......................
m .%%%%%.......%%%%%.......%%%%........%%%%%..............................
m .%%%%%......%%%%%%......%%%%%.......%%%%%%..............................
m ..%%.%...................%..%%......%%%.%...............................
m .......................3................................................
m .......................................................................0
m ......................................................%%.%%%............
m .......................................................%%%%%............
m ......................................................%%%%%%............
m .......................................................%%%%%............
m .%%%.%.......%%.%.......%%.%%.......%%%.%..............%%%%%...%.%......
m %%%%%%......%%%%%%.......%%%%.......%%%%%..............%%%%%%%%%%%......
m ...%%%.........%%..........%%%........%%%.........%%%%%%%%%%%%%%%.......
m ..%%%.........%%%.........%%%.........%%%.........%%%%%%%%%%%%%%%%......
m ...%%%.........%%%.........%%%.........%%%........%%%%%%%%%%%%%%%%......
m ...%%%........%%%..........%%.........%%%..........%%%%%%%%%%%%%%%......
m ...%%%%%.......%%%%.......%%%%%%......%%%%%%......%%%%%%%%%%%...........
m ...%.%%%.......%%.%%.......%.%%.......%.%%%.......%.%...%%%%%...........
m ........................................................%%%%%...........
m ........................................................%%%%%%..........
m ........................................................%%%%%...........
m ........................................................%%%.%%..........
m ............................................1...........................
m ....................2...................................................
m ...%.%%%......%%..%...................%.%%..............................
m ..%%%%%%.......%%%%%......%%%%%%......%%%%%.............................
m ..%%%%%........%%%%.......%%%%%.......%%%%%.............................
m ..%%%%%%......%%%%%.......%%%%%%......%%%%%.......................3.....
m %.............%%%%%........%%%%........%%%%%................%...........
m %%............%%%..........%%..%.........%%.................%%.......%%%
m %%..........................................%%%...........%.%%......%%%%
m %...........................................%%%%......%%%%%%%%......%%%%
m %...........................................%%%........%%%%%%........%%%
m ............................................%%%%......%%%%.%%%......%%%%
m ............................................%%%%......%%................
m ............................................%.%%......%%................
m ..............%%%%%%.........%.%........................................
m ..............%%%%%%......%%%%%%........................................
m ..............%%%%%%......%%%%%%........................................
m ..............%%%%%.......%%%%%.........................................
m .%......%%%.%.%%%%%........%%%%%............................%........%.%
m %........%%%%%%%%%%........%%%%.............................%%.......%%%
m %.......%%%%%%%%%%%%.......%%%%%%%%%......%%%..%........%.%.%%.......%%%
m %%.......%%%%%%%%%%%.......%%%%%%%%%......%%%%%%......%%%%%%%........%%%
m %%.......%%%%%%%%%%%......%%%%%%%%%%......%%%%%.......%%%%%%%%.......%%%
m .........%%%....%.%%.......%%%%%%%%%.......%%%%........%.%..%........%%%
m ..........................%%%%%%%%%%.......%%%%%......%%................
m ..........................%%%%...%%%..........%.......%.................
m ....................%%%%........................0.......................
m ....................%%%%................................................
