# map type: blank
# random seed: -1574409511
# hill distance  11, 37  30, 67 100, 18  61, 95  42, 76  91,  6  73, 29  53, 49
#        11, 37       0     121      38     100     100      59      68      54 
#        30, 67     121       0     121      59      21     142      95      67 
#       100, 18      38     121       0     100     100      21      64      92 
#        61, 95     100      59     100       0      38     121      54      68 
#        42, 76     100      21     100      38       0     121      92      64 
#        91,  6      59     142      21     121     121       0      67      95 
#        73, 29      68      95      64      54      92      67       0      40 
#        53, 49      54      67      92      68      64      95      40       0 
players 2
rows 108
cols 108
m ............%%%%%........%%%%................................%%%...%%.%%...%%.%.............................
m .%%..........%%%%%......%%%%%.........%%%%......%.....%%%%%%%%%%%%%%%%%%%%%%%%%......%%%%%.....%%%%..%......
m %%%%%........%%%%.......%%%%%%......%%%%%........%%%%%%%%%%%%%%%%%%%%%%%%%%%%%.......%%%%%%%%%%%%%%%%.......
m .%%%%%......%%%%%.......%%%%%........%%%%.......%%%%%%%%%%%%%%%%%%%%%%%%%%%%%%%......%%%%%%%%%%%%%%%%.......
m %%%%%%......%%%%%.......%%%%%.......%%%%%%......%%%%%%%%%%%%%%%%%%%%%%%%%%%%%%.......%%%%%%%%%%%%%%%%%......
m %%%%%%......%%%%%%.......%%%%%......%%%%%%.......%%%%%%.%%%.%..%...%.%.%%.%%.........%%%%%%%%%%%%%%%%.......
m ..%%........%.%%........%%.%........%.%%.........%%%%%................................%%%%%%%%%%%%..........
m ..................................................%%%%................................%%%%%%%%%%............
m ..................................................%%%%%...............................%%%%%%%%%%............
m .................................................%%%%%................................%%%%%%%%%%............
m .................................................%%%%%................................%%%%%%%%%%............
m .....................................0...........%%%%%%..............................%%%%%%%%%%%............
m ..................................................%%%%..........%%%%%%%..%%%%%%......%%%%%%.................
m %%..%.%%..%..%%.%.%%%%...%%%.%......%%.%%%%.......%%%%%.......%%%%%%%%%%%%%%%%.......%%%%%%......%%%%%.%.%.%
m %%%%%%%%%%%%%%%%%%%%%%%%%%%%%%......%%%%%%........%%%%%......%%%%%%%%%%%%%%%%%%......%%%%%.......%%%%%%%%%%%
m %%%%%%%%%%%%%%%%%%%%%%%%%%%%%%......%%%%%%........%%%%........%%%%%%%%%%%%%%%%........%%%%.......%%%%%%%%%%%
m %%%%%%%%%%%%%%%%%%%%%%%%%%%%%........%%%%%........%%%%.......%%%%%%%%%%%%%%%%%........%%%%.......%%%%%%%%%%%
m %%%%%%%%%%%%%%%%%%%%%%%%%%%%%.......%.%%%%.......%%%%.%.......%%%.%%%.%%.%%%%%.......%..%........%%%%%%%%%%%
m ..%.%.......%%%..%%%..%..%...%............................................%%%%....................%%%%%%%%%%
m ..........................................................................%%%%...................%%%%%%%%%%%
m ..........................................................................%%%%....................%%%%%%%%%%
m .........................................................................%%%%%...................%%%%%%%%%%%
m .........................................................................%%%%%....................%%%%%%%%%%
m .........................................................................%%%%%%..................%%%%%%%%%%%
m ........................................%%.......%.%..%......%%.%..%%%.%%%%%%%%.......%.%%.......%%%%%......
m .%%%%%...%...%...%.......%.%%%........%%%%%.......%%%%........%%%%%%%%%%%%%%%%%......%%%%%.......%%%%%......
m .%%%%%%%%%%%%%%%%.......%%%%%%........%%%%.......%%%%%%.......%%%%%%%%%%%%%%%%.......%%%%%%.......%%%%%.....
m .%%%%%%%%%%%%%%%%.......%%%%%%%......%%%%%%.......%%%%........%%%%%%%%%%%%%%%%........%%%%%.......%%%%......
m .%%%%%%%%%%%%%%%%%.......%%%%%.......%%%%%........%%%%%.......%%%%%%%%%%%%%%%%........%%%%.......%%%%%%.....
m .%%%%%%%%%%%%%%%%..........%%%%......%%%%%%.......%%%.%......%%%%%%%%%%%%%%%%%.........%%%........%%%%......
m ..%%%%%%%%%%%%%%%%....................%%%%%..................%%%%%%0......%%%%...................%%%%%......
m ..%%%%%%%%%%%%%%%.....................%%%%%..................%%%%%%......%%%%%%..................%%%%%......
m ..%%%%%%%%%%%%%%%%....................%%%%....................%%%%%......%%%%%....................%%%%......
m .%%%%%%%%%%%%%%%%....................%%%%%....................%%%%%.......%%%%%...................%%%%......
m ..%%%%%%%%%%%%%%%%....................%%%%....................%%%%.......%%%%%...................%%%%%......
m ..%%%%%%%%%%%%%%%%....................%%%%%..................%%%%%........%%%%....................%%%%......
m ..%%%%%%%%%%%%%%%...........%%%%.%...%%%%%%.......%..%........%%%%.......%%%%%%....%%..%%%%.......%%%%%.....
m .%%%%%%%%%%%%%%%%%........%%%%%%%%%%%%%%%%........%%%%........%%%%.......%%%%%%%%%%%%%%%%%.......%%%%%%.....
m ..%%%%%%%%%%%%%%%%.......%%%%%%%%%%%%%%%%%.......%%%%%%.......%%%%%.......%%%%%%%%%%%%%%%%%......%%%%%%.....
m ..%%%%%%%%%%%%%%%%........%%%%%%%%%%%%%%%%.......%%%%%.......%%%%%.......%%%%%%%%%%%%%%%%%%.......%%%%......
m ..%%%%%%%%%%%%%%%%........%%%%%%%%%%%%%%%%........%%%%.......%%%%%%......%%%%%%%%%%%%%%%%%.......%%%%%......
m .%..%.%.%.%%.%%%%%.......%%%%%%.%...%..%.%.......%%%%%%......%%%%%.......%...%.%%%%..%...%........%%%%%.....
m .........................%%%%%...................%%%%%%.......%%%%%.........1....................%%%%%%.....
m ..........................%%%%%...................%%%%%......%%%%%...............................%%%%%%.....
m ..........................%%%%...................%%%%%........%%%%...............................%%%%%......
m .........................%%%%%....................%%%%%.......%%%%%..............................%%%%%......
m ..........................%%%%....................%%%%%......%%%%%%...............................%%%%%.....
m ..........................%%%%%...................%%%%.......%%%%%%...............................%%%%......
m ..%%....................%%%%%%%........%.........%%%%%........%%%%%......%.%.%%..%.%.%%%%.%.......%%%%......
m .%%%%.........%..%%..%..%%%%%%.......%%%%%.......%%%%%........%%%%%......%%%%%%%%%%%%%%%%%%......%%%%%%.....
m ..%%%........%%%%%%%%%%%%%%%%%.......%%%%%........%%%%.......%%%%%.......%%%%%%%%%%%%%%%%%.......%%%%%......
m .%%%%%.......%%%%%%%%%%%%%%%%%%......%%%%%%......%%%%%.......%%%%%%......%%%%%%%%%%%%%%%%%%......%%%%%......
m .%%%%%......%%%%%%%%%%%%%%%%%%........%%%%%.......%%%%%.......%%%%%......%%%%%%%%%%%%%%%%%........%%%%......
m .%%%%%......%%%%%%%%%%%%%%%%%%........%%%%.......1....%......%%%%%%......%...%%.%..%..%..%.......%%%..%.....
m ...%.%......%%%%%%.%...%%..%..%..............................%%%%%%.........................................
m ............%%%%%.............................................%%%%%.........................................
m .............%%%%%...........................................%%%%%..........................................
m ............%%%%%.............................................%%%%..........................................
m .............%%%%............................................%%%%%%.........................................
m .............%%%%............................................%%%%%..........................................
m .............%%%%%..................%.%.%.%......%%%..%.......%%%%%......%%%%%........%.%%%......%%%.%......
m ...%%%...%..%%%%%........%%%.........%%%%%%......%%%%%........%%%%.......%%%%%........%%%%.....1.%%%%.......
m .%%%%%%%%%%%%%%%%........%%%%%......%%%%%%%......%%%%%.......%%%%%%......%%%%%%......%%%%%%.......%%%%......
m .%%%%%%%%%%%%%%%%%......%%%%%%.......%%%%%........%%%%........%%%%.......%%%%%%......%%%%%%......%%%%%......
m %%%%%%%%%%%%%%%%%........%%%%%......%%%%%%.......%%%%%%.......%%%%........%%%%.......%%%%%.......%%%%%......
m %%%%%%%%%%%%%%%%%%.......%%%%%.......%%%%%%.......%%%%%.......%..%%.......%%%%%......%..%%.......%%%%%......
m .%.%.%%%...%%..............%%.......%%%..%%......%%%%%%...................%%%%...................%..........
m .................................................%%%%%%..................%%%%%..............................
m .................................................%%%%%%..................%%%%%%.............................
m ..................................................%%%%%..................%%%%%%.............................
m .................................................%%%%%%...................%%%%%.............................
m .................................................%%%%%%...................%%%%..............................
m ................................................%%%%%%%%.%%...%...%%%..%%%%%%%%......%.%%...................
m %.%...........%%.%%.%...%%.%.0......%%%.%.%%%.%%%%%%%%%%%%%%%%%%%%%%%%%%%%%%%%........%%%%%..%%%.....%......
m .%%%%%......%%%%%%%%%%%%%%%%%.......%%%%%%%%%%%%%%%%%%%%%%%%%%%%%%%%%%%%%%%%%%........%%%%%%%%%%%%%%%%......
m %%%%%%.......%%%%%%%%%%%%%%%%.......%%%%%%%%%%%%%%%%%%%%%%%%%%%%%%%%%%%%%%%%%%%.......%%%%%%%%%%%%%%%%......
m .%%%%%.......%%%%%%%%%%%%%%%%........%%%%%%%%%%%%%%%%%%%%%%%%%%%%%%%%%%%%%%%%%........%%%%%%%%%%%%%%%%......
m .%%%%.......%%%%%%%%%%%%%%%%%........%%%%%%%%%%%%%%%%%%...%.%%.%%%%%.%%..%...%........%%%%%%%%%%%%%%%.......
m %.%.%%........%..%%%.%%.....%%......%...%%%%%%%%%%%%%%%..............................%%%%%..%..%.%%..%......
m ................................................%%%%%................................%%%%...................
m .................................................%%%%................................%%%%%..................
m ................................................%%%%%................................%%%%%..................
m ................................................%%%%%%...............................%%%%%..................
m .................................................%%%%................................%%%%...................
m .................................................%%%%%......%.%.%%%......%%%.%.......%%%%%..................
m %....%%%...%...%%%.%..%%..%%.%%.%.%%..%..........%%%%%.......%%%%%........%%%.......%%%%%.........%.%.......
m %%%%%%%%%%%%%%%%%%%%%%%%%%%%%%%%%%%%%%%%%%......%%%%%.......%%%%%.........%%%%......%%%%%........%%%%%......
m .%%%%%%%%%%%%%%%%%%%%%%%%%%%%%%%%%%%%%%%%........%%%%%.......%%%%%.......%%%%.......%%%%%%.......%%%%%......
m %%%%%%%%%%%%%%%%%%%%%%%%%%%%%%%%%%%%%%%%%........%%%%%......%%%%%........%%%%........%%%%.......%%%%%%......
m .%%%%%%%%%%%%%%%%%%%%%%%%%%%%%%%%%%%%%%%%%.......%%%%%......%%.%.%........%%%%.......%%%%.......%%%%%.......
m .%%%%%%%%%....%.%.%..%%%%%.%%%%%..%.%.%..%......%%%%%%......%.............%.%%.......%%%%.......%%%%%%......
m %%%%%%1.........................................%%%%%%..............................%%%%%%......%%%%%%......
m %%%%%%..........................................%%%%%...............................%%%%%.......%%%%%%......
m %%%%%%...........................................%%%%%...............................%%%%%......%%%%%.......
m .%%%%%...........................................%%%%%..............................%%%%%.......%%%%%%......
m %%%%%%..........................................%%%%%...............................%%%%%%.......%%%%%......
m %%%%%%..........................................%%%%%................................%%%%%.......%%%%.......
m %%%%%%.%%.%.%%.%%%......%%%%%%......%%%%...%%%..%%%%%%......%..%%........%%%%%.......%%%%.......%%%%%%...%%%
m %%%%%%%%%%%%%%%%%........%%%%.......%%%%%%%%%%%%%%%%%.......%%%%%%%......%%%%%.......%%%%%......%%%%%%%%%%%%
m %%%%%%%%%%%%%%%%%.......%%%%%.......%%%%%%%%%%%%%%%%%.......%%%%%%.......%%%%%......%%%%%%......%%%%%%%%%%%%
m %%%%%%%%%%%%%%%%%.0......%%%%.......%%%%%%%%%%%%%%%%%........%%%%%%......%%%%%......%%%%%.......%%%%%%%%%%%%
m %%%%%%%%%%%%%%%%%%......%%%%%%......%%%%%%%%%%%%%%%%%%......%.%..%%......%%%%%.......%%%%.......%%%%%%%%%%%%
m %%.....%.%..%%%%%.......%%%%%%........%%.%..%%%.%..%................................%%.%........%.%........%
m .............%%%%%.......%%%%..................................................%%%%%........................
m .............%%%%%.......%%%%%.................................................%%%%%........................
m .............%%%%%......%%%%%..................................................%%%%%........................
m .............%%%%%.......%%%%..................................................%%%%%........................
m ............%%%%%.......%%%%%%.................................................%%%%%........................
