# map type: blank
# random seed: 1633548019
# hill distance 129,108  57, 68  73, 79  86, 12 143,106  35, 21 120, 57  62, 95  33,  7  46, 84  84,142 134, 55
#       129,108       0     112      87     109      52     115     114      84     109      85      93     108 
#        57, 68     112       0      67      87     122      95     114     132      85      67     131      84 
#        73, 79      87      67       0      84     131     122      95      67     112     132     114      85 
#        86, 12     109      87      84       0     115     114      93      85     108     112      52     109 
#       143,106      52     122     131     115       0     105     118     114      93      95     105     114 
#        35, 21     115      95     122     114     105       0     105     131      52     114     118      93 
#       120, 57     114     114      95      93     118     105       0     122     115     131     105      52 
#        62, 95      84     132      67      85     114     131     122       0      87      67      95     112 
#        33,  7     109      85     112     108      93      52     115      87       0      84     114     109 
#        46, 84      85      67     132     112      95     114     131      67      84       0     122      87 
#        84,142      93     131     114      52     105     118     105      95     114     122       0     115 
#       134, 55     108      84      85     109     114      93      52     112     109      87     115       0 
players 4
rows 144
cols 144
m ......%%%.................%%.....%%%...............................%%%.........................%%%....%%%......................%%%....%%%.......
m ......%%%%................%%.....%%%......%%%.....%.%.....%.%......%%%........................%%%%....%%%......................%%%.....%%%......
m .......%%%...............%%%.....%%%.....%%%%%%%%%%%%%%%%%%%%%.....%%%........................%%%%.....%%%....................%%%%.....%%.......
m %%.....%%%%%..............%%%.....%%.....%%%%%%%%%%%%%%%%%%%%......%%%%%%.....%%.%.%..%%%.....%%%.....%%%%.....%.%....%.%%%..%%%%%.....%%%.%..%%
m %%........%%.....%.%%..%.%%%%....%%%%....%%%%%%.%%.%%.%%%%%%%%.....%%%%%%%.....%%%%%%%%%%%.....%%.....%%%......%%%....%%%%%%%%%%%%....%%%%%%%%%%
m %%........%%%.....%%%%%%%%%%%....%%%.....%%%%..............%%......%%%%%%......%%%%%%%%%%%.....%%......%%%.....%%.....%%%%%%%%%%%%....%%%%%%%%%%
m %.........%%%....%%%%%%%%%%%.....%%%%....%%%%.............%%%%.....%%%%%%%.....%%%.....%.%.....%%%.....%%.....%..%......%%.%%.%%%.......%%%.....
m .........%.......%%%%.%...%%.....%...........%............%%%%....%%%%%%%%....%%%.............%%%%....%%%.....................%%%%..............
m ..................%%.......................................%%%....%%%%%%%%....%%%.............%%%.....%%%%....................%%%...............
m .................%%%%............................%.%%.....%%%......%%%%%%%.....%%.............%%%%....%%%.....................%%%%..............
m .................%%%.............................%%%%.....%%%%.....%%%%%%%.....%%..............%%%....%%%%....................%%%...............
m %%%%.............%%%%............................%%%%%....%%%%.....%%%%%%.....%%%%%%.%.%%%%%..%%%%....%%%.....%%....%...%......%%.....%%%%.%%%..
m %%%%..............%%%.%%%%%%.%.%..%%...%.%%...%.%%%%%......%%%....%%%.%%%.....%%%%%%%%%%%%%%%%%%%......%%......%%%%%%%%%%%.....%%%.....%%%%%%%%%
m %%%%%....%%%......%%%%%%%%%%%%%%%%%%%%%%%%%%%%%%%%%%%%................%%%.....%%%%%%%%%%%%%%%%%%%%.....%%%.....%%%%%%%%%%%....%%%%.....%%%%%%%%%
m %%%%.....%%%.....%%%%%%%%%%%%%%%%%%%%%%%%%%%%%%%%%%%%..................%%.....%%%%.%.%%....%..%%.......%%%.....%%%%%.%%%%%....%%%......%.%....%%
m .%%%%....%.%%.......%%..%%%%%%%%%..%%%..%%%.%.%..%.%%..........................%%%....................%%%%.............%%%....%%%.............%.
m ..%%%....................%%%..................................................%%%.....................%%%%.............%%%.....%%...............
m ..%%......................%%%.............................%%....%..%%.........%%%%.....................%%%.............%%......%%%..............
m .%%%%.....................%%%............................%%%%%%%%%%%%%.........%%.....................%%%%.............%%.....%%%...............
m .%%%%....................%%%.............................%%%%%%%%%%%%%.%......%%%%.....%......%%.......%%%.%..%%.%.....%%.....%%%%.....%%%%%....
m ..%%.....%....%%.%.%.....%%%%.....%%%%%.....%%.%%%%%......%%%%%%%%%%.....%....%%%%.....%%......%%%....%%%%%%%%%%%%.....%%.....%%%%.....%%%%%%...
m ..%%%....%%%%%%%%%%%.....%%%%....%%%%%%%%%%%%%%%%%%%.....%%%%%%%%%%%...........%%.....%%%%.....%%.....%%%%%%%%%%%......%%......%%......%%%%%%...
m .%%%%....%%%%%%%%%%%%.....%%......%%%%%%%%%%%%%%%%%%......%%%%%%%%%%%...........%......%%%....%..%.....%%%%.%%.%.......%%%....%%%......%%%%%%...
m .%..%......%...%.%%%.....%%%......%%%.........%%%%%%.....%.%%...%%%%%....%............%%%%.............................%%%.....%%.....%..%%%....
m .................%%%%.............%%%.............%%%.............%%%.................%%%.............................%%%.....%%%%.......%%%....
m .................%%%%............%%%..............%%..............%%...................%%%............................%%%%.....%%.........%%....
m .................%%%%.............%%%............%%%.............%%%..................%%%.............................%%%%.....%%%.......%%%....
m .................%%%%.............%%%............%%%%.............%%%.................%%%%%%%%%%.%.%....%%.....%.%%%..%%%%....%%%%%%%....%%%....
m ..%%%%%%..%%......%%%....%%.%.....%%%....%%......%%%%....%%......%%%.......%..........%%%%%%%%%%%%%%%%%%%.....%%%%%%%%%%%%.....%%%%%......%%%...
m .%%%%%%%%%%%.....%%%......%%......%%%.....%%......%%%%%%%%%%.....%%%%.....%%%..........%%%%%%%%%%%%%%%%%%%.....%%%%%%%%%%%....%%%%%%%....%%%....
m ..%%%%%%%%%%......%%%....%%%.....%%%%....%%%%....%%%%%%%%%%%......%%.....%%%...........%%.....%%%%%...%.%......%%%%..%........%%%%%%%....%%%%...
m ...%..%%..........%%%.......%....%.......%%%......%...%..%%%%....%%%%....%%%..................%%%%.............%%...............%.%.......%%....
m ..................%%......................%%%............%%%......%%.....%%%%.................%%%.............%%%........................%%%....
m .......1..........%%%.....................%%%............%%%%....%%%......%%..................%%%%.............%%........................%%%....
m .................%%%.....................%%%.............%%%......%%%....%%%%..................%%..............%%........................%%%....
m .................%%%.2....................%%%.............%%.....%%%......%%%............%....%%%.......%..%%%%%%%....%.%.%%.............%%%....
m ....%.....%.%.....%%%...%%.%..%.%..%%%%%%%%%%....%.%......%%......%%%....%%%%%..%.%%.....%.....%%.....%%%%%%%%%%%%.....%%%%%%.....%%%.%%.%%%%...
m .%%%%%%%%%%%.....%%%%%%%%%%%%%%%%%%%%%%%%%%%%....%%%%....%%%%.....%%%....%%%%%%%%%%%%.........%%%.....%%%%%%%%%%%.....%%%%%%%....%%%%%%%%%%%....
m ..%%%%%%%%%%%....%%%%%%%%%%%%%%%%%%%%%%%%%%%%.....%%......%%......%%%....%%%%%%%%%%%%..........%%%......%...%.%.......%%%%%%.....%%%%%%%%%%%%...
m ....%..%%%%%%....%%..%%%.%%..%%%%%...%%.%.%%......%%%.....%%.....%%%......%%%.%..%%%%.........%%%%.....................%%%%%.....%%%.%%%.%.%....
m .........%%%%.....................................%%..............%%.....%%%......%%%..........%%......................%%%%%....................
m ..........%%%.....................................%%.............%%%.....%%%%....%%%.....%....%%%%.....................%%%%%....................
m .........%%%.....................................%%%..............%%......%%.....%%%%....%....%%%.....................%%%%%%%...................
m ..........%%%.....................................%%%............%%%%.....%%.....%%%%....%.....%%%%.%.%...%.%.%.%%.%..%%%%%%....................
m %%%%%.....%%%......%..%%%...%%.%%%.%......%.%....%%%%%.%....%%.%.%%%%.....%%......%%%.........%%%%%%%%%%%%%%%%%%%%%%%%%%%%%%.....%...%%.........
m %%%%.....%%%%....%%%%%%%%%%%%%%%%%%%......%%......%%%%%%%%%%%%%%%%%%%.....%%.....%%%%....%....%%%%%%%%%%%%%%%%%%%%%%%%%%%%%%%....%%%%%%%%%%%%%%%
m %%%%%.....%%%....%%%%%%%%%%%%%%%%%%%%....%%%.....%%%%%%%%%%%%%%%%%%%%....%%%%.....%%0.........%%%%%....%%%.%..%.%.%..%%%..%%%....%%%%%%%%%%%%%%%
m %%.%.....%..%.....%%%%.%%%...%%%.%%%%....%..%....%%%%%%%.%.%.%.%%.%%%.....%%%....%........................................%%......%%%%%%%%%%%%%%
m %................%%%%.............%%.............%%%......................%%....................................................%%%%%%%%%%%....%
m %................%%%..............%%.............%%%......................%%%.............................................%....%%%%%%%%%%%%....%
m %.................%%%............%%%%............%%%.....................%%%%..................................................%%%%%%%%%%%%....%
m %.................%%.............%%%.............%%%......................%%.............%.%...%....%%.%%%.%.%%%......%..%.........%%%%%.%.....%
m %%%%%............%%%%.....%%%....%%%.......%%%.%.%%%.....%%....%%%.%.....%%%%%%.%%%%%....%%%%%%%%%%%%%%%%%%%%%%%%..............................%
m %%%%%....%%%.....%%%.....%%%.....%%%......%%%%%%%%%%%.........................%%%%%%%....%%%%%%%%%%%%%%%%%%%%%%%%%.............................%
m %%%%%....%%%......%%%....%%%%....%%%.....%%%%%%%%%%%%.........................%%%%%%.....%.%%.%%....%.%%%%%%.%..%..............................%
m %%%%%.....%%.....%..%....%%%......%%%......%.%%.%%%...........................%%%%%%%....%.............%%%......................................
m %%%%%%%%%%%%%.............%%.....%%%%.........................................%%%%%%%%%%%%............%%%................%%.%%.%%%%..%%...%.....
m %%%%%%%%%%%%%.............%%......%%.......................%%%%.%%%%2.....%%.%%%%%%%%%%%%..............%%...............%%%%%%%%%%%%%%%%%%%....%
m %%%%%%%%%%%%.............%%%.....%%%%.....................%%%%%%%%%%%.....%%%%%%%%%%%%%%%%.............%%%.............%%%%%%%%%%%%%%%%%%%.....%
m %.%..%.%%%%%%.............%%.....%%%......................%%%%%%%%%%%.....%%%%%%%%%%%%%%%%....%.%.%%%.%%%................%%.%.%%%%%....%%%%.....
m .......%%%%%%.%..%.%.....%%%%....%%%%%.%.%%................%%%.%%%.%.%....%%%%%%%%%%%%%%%%.....%%%%%%%%%%%......................%%%.....%%......
m ........%%%%%%%%%%%%%.....%%%%%%%%%%%%%%%%%%%.............%%%.............%%%%%%%%%%%%%%%%.....%%%%%%%%%%%.....................%%%%.....%%%.....
m .......%%%%%%%%%%%%%%....%%%%%%%%%%%%%%%%%%%...............%%..............%%%%%%%%%%%%.%%.....3%%%%.%%%%.......................%%......%%......
m .......%%%%%%%%%%%%%.....%...%%..%%%%.%%.%%................%%%............%%%%%%%%%%%%.........................................%%%%.....%%......
m ..%.....%%.....%%%%%......................................%%%.............%....%%%%%%%...........................%%%.%%.%......%%%......%%%....%
m %%......%%%....%%%%%%..............................%..%.%%%%%%.%....%%.%%.%.....%%%%%%.........................%%%%%%%%%%%%.....%%%....%%%%....%
m %%%.....%%%....%%%%%%.............................%%%%%%%%%%%%%%%%%%%%%%%%%....%%%%%%%.........................%%%%%%%%%%%......%%%.....%%%.....
m %%%............%%%%%%..............................%%%%%%%%%%%%%%%%%%%%%%%%....%%%%%.%%%%%%.....%.%%%....%%.....%%%.%.%%%.......%%%....%%%.....%
m %%.................%%.....%.%%%%%.........%..%......%%%.%.%%%.%%....%...%.%.............%%......................%%%.............%%%.............
m %%.................%%....%%%%%%%%%%%%..................................................%%%%.....................%%%............%%%%............%
m %%%................%%....%%%%%%%%%%%%....%.............................................%%%......................%%%.............%%..............
m %%%................%%....%%%%%%%%%%%....................................................%%......................%%%.............%%.............%
m %%.....%..%.....%.%%%%%%%%%%%%%%%%......%%........................................%....%%%.....%%%.%%.%.%.%.%%%%%%%....%..%....%%%%.%%%...%%%.%%
m %%%....%%%.....%%%%%%%%%%%%%%%%%%%%....%%%..%%%..%.%.%..%.%%%....%%%%%.........1%%.....%%%%....%%%%%%%%%%%%%%%%%%%%.....%%%....%%%%%%%%%%%%%%%%%
m %%%....%%%%.....%%%%%%%%%%%%%%%%%%%....%%%%%%%%%%%%%%%%%%%%%%%%%%%%%%%....%....%%%%.....%%.....%%%%%%%%%%%%%%%%%%%......%%......%%%%%%%%%%%%%%%%
m %......%%%.....%%%%%.........%%...%.....%%%%%%%%%%%%%%%%%%%%%%%%%%%%%%.........%%%......%%.....%%%%.%.%%....%.%%%%%....%.%......%.%%%.%%...%%%..
m .......%%%..............................%%%%%%..%.%%.%.%.%...%.%.%%%%.....%....%%%%.....%%.....%%%%............%%%..............................
m ........%%%............................%%%%%%%.....................%%%....%....%%%%.....%%......%%..............%%%.............................
m .......%%%..............................%%%%%.....................%%%%....%.....%%%....%%%%.....%%%.............%%..............................
m .......%%%%.............................%%%%%......................%%..........%%%......%%%.....%%..............%%..............................
m .%%....%%%%%%..%........%.%.%%%.%%%.....%%%%%.....................%%%%.........%%%%..%.%%%......%%%.....%%.....%%%......%%.%.%%...%%%%%..%%.%%%.
m %%%....%%%%%%%%%%%.....%%%%%%%%%%%%.....%%%%%%.......%.%...%......%%%..........%%%%%%%%%%%%....%%%......%%......%%.....%%%%%%%%%%%%%%%%%%%%%%%%%
m %%%.....%%%%%%%%%%%.....%%%%%%%%%%%....%%%%%%%.....%%%%%%%%%%%.....%%%.........%%%%%%%%%%%%....%%%.....%%%%....%%%%....%%%%%%%%%%%%%%%%%%%%%%%%%
m %%.....%.%.....%.......%%%%.%%.%%%.....%%%%%%.....%%%%%%%%%%%%.....%%.....%.....%%.%..%%%%%....%%%......%%......%.%....%%%%%%%%%%..%.%..%.%%...%
m %%%.....................%%%.............%%.%.%....%%%%%%%..%.......%%%....%............%%%......%%%.....%%.............%%%....................3.
m %%%.....................%%%........................%%..............%%..................%%%%....%%%......%%%.............%%%.....................
m %%..........0...........%%%........................%%.............%%%%..................%%......%%%....%%%%............%%%.....................%
m %%......................%%%........................%%%.............%%%.................%%%%.....%%......%%%............%%%......................
m %%..........%%..%.......%%.......%.%...............%%.............%%%%..................%%%....%%%%....%%%%..%...%......%%%.......%....%.......%
m %%......%%%%%%%%%%.....%%%%....%%%%%%%........%..%%%%......%.%...%%%%%.....%%...........%%%.....%%......%%%%%%%%%%%....%%%%....%%%%.....%%%....%
m %%%.....%%%%%%%%%%%.....%%%....%%%%%%%....%%%%%%%%%%%.....%%%%%%%%%%%%%%%%%%%..........%%%.....%%%%.....%%%%%%%%%%......%%.....%%%......%%......
m %%......%%..%%%%%%.....%%%......%%%%%.....%%%%%%%%%%%%.....%%%%%%%%%%%%%%%%%%%..........%.......%%%......%%....%%%%......%%....%%%.....%.%%....%
m %%%.....................%%%....%%%%%%%....%%%%..%%%.%.....%%....%.%.%%%%%%%%%%.................%%%.............%%%%............%%%.............%
m %%%.....................%%%.......%%%.....%%%%.............................%%%..................%%%.............%%%............%%%.............%
m %%%.....................%%.........%%.....%%%%............................%%%...................%%..............%%..............%%%............%
m %%%.....................%%%.......%%%%.....%%%.............................%%%.................%%%.............%%%.............%%%.............%
m %%%.%...%......%..%.....%%%..%.....%%.....%%%.............................%%%%............%....%%%%%...%%.%.....%%%%%%.........%%%......%%%.....
m %%%%%%%%%%%....%%%%....%%%%%%......%%%....%%%.......%.%%.%%%%.....%..%....%%%......%...........%%%%%%%%%%%......%%%%%%%%%%%%%%%%%%......%%.....%
m %%%%%%%%%%%....%%%.....%%%%%%......%%......%%......%%%%%%%%%%%.....%%.....%%%%.....%%...........%%%%%%%%%%%.....%%%%%%%%%%%%%%%%%%%....%%%%.....
m %.%.%%....%.....%%.....%%%%%%.....%%%%.....%%.....%%%%%%%%%%%%....%%%......%%.....%%%%....%.....%%%%%%%%%%......%%%%%.%%.....%%%%%.....%%%%.....
m ...............%%%%.....%%%%%.....%%%%.....%%.....%.%%..%.%%%.......%%......%.....%%%%......%.%%%%%%%%%%%%%.............................%%%.....
m ...............%%%%................%%%.....%%.............%%%%.....................%%.........%%%%%%%%%%%%%............................%%%......
m ................%%................%%%......%%.............%%%.....................%%%%.........%%..%....%%.............................%%%......
m ...............%%%.................%%.....%%%.............%%%%.....................%%%..................................................%%%.....
m .......%%.%....%%%%..%.............%%%....%%%.............%%%%....................%%%..........................%%.%..%.%.%%%..%%%..%%%%%%%%%..%%
m %%%.....%%%.....%%%%%%....%.%......%%%....%%%%%.%%%%%.....%%%.......%%..%....%%.%.%%%%.....%%..................%%%%%%%%%%%%%%%%%%%%%%%%%%%%%%%%%
m %%......%%%....%%%%%%%%%%%%%%.....%%%%....%%%%%%%%%%%.....%%%.....%%%%%%%%%%%%%%%%%%%%.....%%%................%%%%%%%%%%%%%%%%%%%%%%%%%%%%%%%%%%
m %%..............%%%%%%%%%%%%%.....%%%.....%%%%%%%%%%%......%%......%%%%%%%%%%%%%%%%%%%.....%%%.%%%....%%%......%%%%%.%...%%.%...%%..%.%.%%%%%%.%
m %%%.............%%%%..%%%.%%%%.....%%......%...%....%%.....%%%....%%%%..%%%%%.%.%%%%%%.....%%%%%%.....%%%%....%%%%%............................%
m %%%................................%%%....................%%%%....%%%..............%%.....%%%%%%%.....%%%%.....%%%%.............................
m %%%...............................%%%%.....................%%%....%%%%.............%%.....%%%%%%%......%%%.....%%.%............................%
m %%.................................%%%....................%%%%.....%%%.............%%%....%%%%%%%%....%%%.......................................
m %%%.......%.......................%%%%.....................%%%....%%%%.............%%%....%%%%%%%%....%%%%............%...........%.....%%...%.%
m %%%....%%%.........%.....%%%.......%%%.%%.%%......%..%.....%%.....%%%.....%.%.....%%%.....%%%%%%%.....%%%%.............%%%%....%%%%.....%%%%%%%%
m %%.....%%%........%%%%%%%%%%%%....%%%%%%%%%%%%.....%%.....%%%......%%.....%%%%%%%%%%%......%%%%%%......%%..............%%%%.....%%%....%%%%%%%%%
m %.%.....%%........%%%%%%%%%%%%....%%%%%%%%%%%%....%%%......%%%.....%%.....%%%%%%%%%%%.....%%%%%%%.....%%%%%%%%.%%.%%.%%%%%%....%%%%....%%%%.%..%
m ........%%%%%.....%%%%..%.%%%.....%%%%%..%%%.%....%.%.....%%%%.....%%%.....%%%..%.%.%%.....%%%%%%......%%%%%%%%%%%%%%%%%%%%.....%%.....%%%......
m ..........%%%..............%%.....%%%%....................%%%.....%%%%........................%%%.....%%%%%%%%%%%%%%%%%%%%%.....%%%.....%%%.....
m ..........%%%%............%%%.....%%%......................%%%....%%%%........................%%%......%.%.....%.%.....%%%......%%%.....%%......
m ...........%%%.............%%%....%%%......................%%%....%%%.........................%%%...............................%%%.....%%......
m .%........%%%..............%%......%%%...................1.%%%.....%%%........................%%%.............................%%%%......%%%.....
m %%%%%%....%%%.....%%%.....%%%%.%.%%%%%......%.%%%%%.%%.%..%%%......%%%%.%.%.%%.....%%..%%%%%%%%%%..............................%%%......%%%....%
m %%%%%%.....%%%....%%%.....%%%%%%%%%%%.....%%%%%%%%%%%%%%%%%%%.....%%%%%%%%%%%.....%%%%%%%%%%%%%%%%.............................%%%%....%%%%....%
m %.%.%%....%%%%.....%%%.....%%%%%%%%%%......%%%%%%%%%%%%%%%%%%%.....%%%%%%%%%%......%%%%%%%....%%%%......%.......%.....%%..%%..%%%%%.....%%%....%
m ..........%%......%%%.....%.%%.%%%..%.....%%%%%%%%.%....%%.%%%.....%%.%%..%%.%....%%%%%%%%.....%%%.....%%......%%%.....%%%%%%%%%%%%.............
m ...................%%......................%%......................................%%%%%%%....%%%%.....%%.....%%%%.....%%%%%%%%%%%%.............
m ..................%%%.....................%%%%.....................................%%%%%%%.....%.%....%%%%.....%%%....%%%.%%.%%.%...............
m ..................%%%.....................%%%.....................................%%%%.................%%......%%%..............................
m %%.........................................%%......................................%%%.................%%.....%%%%..........................%%..
m %%.........................%%........%.....%%.............%.%%%%.%%%%%........%%.%%%%%................%%%...2.%%%%........................%%%%%%
m %%%......................%%%%......%%%.....%%%....%%%......%%%%%%%%%%......%%%%%%%%%%%................%%%......%%.........................%%%%%%
m .%%......................%%%%......%%......%%.....%%%.....%%%%%%%%%%%......%%%%%%%%%%%.%%.....%.%..%.%%%%......%%......%%%....%%%.....%...%%%.%%
m .................%%.%%.%%%...%.....%%%....%%%......%%......%%%%.%..%.%.....%%.%%%%%%%%%%%......%%%%%%%%%%%.....%%%.....%%......%%......%%%%.....
m .................%%%%%%%%%.........................%%......%%%................%%%%%%%%%%%......%%%%%%%%%%......%%%....%%%.....%%%......%%%%.....
m ..................%%%%%%%%........................%%%%.3...%%%................%%%%%.%%........%%%%%.%%%%.%.............%%.....%........%%.......
m ..................%%..%%..........................%%%%.....%%.................%%%......................................%%.......................
m %%................................................%%%......%%.................%%%%.....................................%%%.....................%
m %%.................................%.%%.%%.%%%....%%%.....%%%%....%.%.....%%%%%%%.....................................%%%%.....................%
m %................................%%%%%%%%%%%%.....%%%%.....%%.....%%%%....%%%%%%%......................................%%......................%
m %%......%%.......................%%%%%%%%%%%%.....%%%......%%.....%%%.....%%%%%%%%....%.%%..%%.%%.....%%%.%%....%.%%%%%%%%.....%..%%%.%%.%.....%
m %.....%%%%....%%.%.%%....%%%.....%%%%%..%%..%%.....%.......%......%%%%....%%%%%%%......%%%%%%%%%%.....%%%%%%%%%%%%%%%%%%%......%%%%%%%%%%.....%%
m %%....%%%.....%%%%%%%....%%%%....%%%%.............................%%%%%%%%%%%%%%%%.....%%%%%%%%%%%.....%%%%%%%%%%%%%%%%%%%.....%%%%%%%%%%%.....%
m %%.....%%%....%%%%%%%....%%%......%%%..............................%%%%%%%%%%..%%.....%%.%.%.%%%%......%%%..%.%%.%%%%%.%......%%%%%.%.%%%%.....%
m .......%%%........%......%%%......%%%%.............................%%%........................%%%.....%%%.0...................%%%......%%.......
