# map type: blank
# random seed: 808159024
# hill distance  28, 37  70,115  28, 57 115, 40  90,115 115, 20  73, 82  53, 82
#        28, 37       0      84      20      92     100      72      90      70 
#        70,115      84       0     100      90      20      70      92      72 
#        28, 57      20     100       0      72     116      92      70      50 
#       115, 40      92      90      72       0      70      20      84     100 
#        90,115     100      20     116      70       0      50      72      92 
#       115, 20      72      70      92      20      50       0     100     116 
#        73, 82      90      92      70      84      72     100       0      20 
#        53, 82      70      72      50     100      92     116      20       0 
players 4
rows 120
cols 120
m ..........................................................................................................%%%%%%........
m %.%.......%%%%....%..%%.%%%%%%..%%.%%.%%%.%.%%%..%.%......%%%%%%......%%%%................%..%%.%..........%%%%%%.%.%.%.
m %%%........%%%%%%%%%%%%%%%%%%%%%%%%%%%%%%%%%%%%%%%%........%%%%........%%%%..............%%%%%%%%%%.......%%%%%%%%%%%%%%
m %%%%......%%%%%%%%%%%%%%%%%%%%%%%%%%%%%%%%%%%%%%%%%.......%%%%%.......%%%%%%............%%%%%%%%%%%.......%%%%%%%%%%%%%%
m %%%........%%%%%%%%%%%%%%%%%%%%%%%%%%%%%%%%%%%%%%%%%.......%%%%.......%%%%%..............%%%%%%%%%%%......%%%.%%%%%%%%%%
m ..%%...........%%%%%......%%%%%.......%%%%%%%%%%%%%.......%%%%%%.......%%%%..............%%%%%%%%%......................
m ..%...........%%%%%%.......%%%%.......%%...................%%%%%......%.................%%%%%%..%%......................
m ..%%%%%.......%%%%%........%%%%%......%%................................................%%%%%...........................
m ..%%%%%%......%%%%%%.......%%%%%......%%.................................................%%%%...........................
m ..%%%%%%.......%%%%........%%%%%......%%................................................%%%%%%..........................
m ..%%.%%.......%%%..%........%%........%%.................................................%%%%%..........................
m ......................................%%.................................................%%%..............%.............
m ......................................%%...................................................%..............%%%...........
m ......................................%%........%%........%..%%%.......%%.%%............................%%%%%...........
m ......................................%%......%%%%%........%%%%.......%%%%%%............................%%%%%%..........
m ......................................%%......%%%%%.......%%%%%%......%%%%%%.............................%%%%...........
m ......................................%%......%%%%%........%%%%%.......%%%%%.............................%%%%%..........
m .......%......%%%%%...................%%.......%%%%.......%%%%%%...........%........................%%..%%%%%%..........
m ...%%%%.......%%%%%%.......%%%%%%%%%%%%%.......%%%%%......%%%%%...........%%........................%%%%%%%%%...........
m ...%%%%%.......%%%%.......%%%%%%%%%%%%%%%%%%%%%%%%%%%%%%%%%%%%%%%%%........%%%%%%%%%%%%%.%%%......%%%%%%%%%%%...........
m ..%%%%%%.......%%%%%.......%%%%%%%%%%%%%%%%%%%%%%%%%%%%%%%%%%%%%%%%%......%%%%%%%%%%%%%%%%%%.......%%%%%%%%%%%..........
m ...%%%%........%%%%........%%%%%%%%%%%%%%%%%%%%%%%%%%%%%%%%%%%%%%%%........%%%%%%%%%%%%%%%%%.......%%%%%%%%%%...........
m ....%%%%......%%%%%%......%.%..%%%.%.%%%.%%.%%..%%%%%%.%%..%....%%%%.......%.%.%.%.%.%%%%%%..........%.%%..%............
m ......................................................................................%%%%%%............................
m ......................................................................................%%%%%%............................
m ........................................................................................%%%%............................
m .........................................................................................%%%............................
m ........................................................................................%%%%............................
m .....................................3...................0...............................%%%............................
m %...%..%......%%%%%.......%%%%....%..%.....%.........%.%.%%.%..%%%%.......%%..%%%%......%%%%...........................%
m %%%%%%%........%%%%%.......%%%%%%%%%%%%%%%%........%%%%%%%%%%%%%%%%%.......%%%%%%%.......%%%.........................%%%
m %%%%%%%........%%%%.......%%%%%%%%%%%%%%%%%.......%%%%%%%%%%%%%%%%%%.......%%%%%%%......%%%%.........................%%%
m %%%%%%%........%%%%%.......%%%%%%%%%%%%%%%%%......%%%%%%%%%%%%%%%%%.......%%%%%%%%.......%%%........................%%%%
m %%%%%%%.......%%%%%%......%%%%%%%%%%%%%%%%%........%%%%%%%%%%%%%%%%........%%%%%%.......%%%%........................%%%%
m %%%%%%%........%%.%%.......%%%%%....%%.....%......%%%%%%.%%%%.%.%%%........%%%%%%........%%%.........................%%%
m %%%%%%%...................%%%%%....................%%%%%..................%%%%%%%%......%%%%%%%%%%.........%.........%%%
m %%%%%%%...................%%%%%%...................%%%%...................%%..%..%........%.%.%%%%.......%%%%........%%%
m %%%%%%%...................%%%%%%...................%%%%%......................................%%%........%%%%%......%%%%
m %%%%%%%....................%%%%%..................%%%%%.......................................%%%%.......%%%%%.......%%%
m %%%%%%%%...................%%%%%..................%%%%%.......................................%%%%.......%%%%%.......%%%
m ......%%..................%%%%%%...................%%%%%.......................................%%.......%.%%.%......%...
m ...............%...%.......%%%%%%.%%%%.%..........%%%%%%.........%%%%%..................................................
m ...............%%%%%......%%%%%%%%%%%%%%%%%.......%%%%%........%%%%%%%..................................................
m ..............%%%%%.......%%%%%%%%%%%%%%%%%.......%%%%%%......%%%%%%%%.........%%.......%.%.............................
m ..............%%%%%.......%%%%%%%%%%%%%%%%%%.......%%%%.......%%%%%%%%......%%%%%%......%%%%............................
m ...............%%%%........%%%%%%%%%%%%%%%%.......%%%%%%.......%%%%%%%......%%%%%%......%%%%............................
m ...............%%%%.......%%..%%%.%%...%%%........%%%..........%%%%%%.......%%%%%%......%%%%............................
m %.........%%..................................................%%%%%%%........%%%%%.......%%%.%%%.%......%%...%......%...
m %%......%%%%%%................................................%%..%%........%%%%%........%%%%%%%%%......%%%%%%......%%%%
m %%.......%%%%%...............................................................%%%%........%%%%%%%%%......%%%%%%......%%%%
m %........%%%%%..............................................................%%%%%%.......%%%%%%%%.......%%%%%%......%%%%
m %%.......%%%%%..............................................................%%%%%.......%%%%%%%%%.......%%%%%%......%%%%
m %%......%%..................................................................%%%%%%.......%%%%%.%.%.......%.%.%.......%.%
m .....................%%%%%.%.%%.......%...%..........%..%%..................%%%%%%3......%%%............................
m ....................%%%%%%%%%%%%......%%%%%%.......%%%%%%%...................%%%%.......%%%%............................
m ....................%%%%%%%%%%%.......%%%%%%.......%%%%%%........%.%.%%..%.%%%%%%%......%%%%............................
m ....................%%%%%%%%%%%%.......%%%%%.......%%%%%%........%%%%%%%%%%%%%%%%........%%%............................
m ....................%%%%%%%%%%%%......%%%%%........%%%%%%%.......%%%%%%%%%%%%%%%%%......%%%%............................
m ....................%%%%%%%%%%%.......%.%%.%......%%%%%%%.......%%%%%%%%%%%%%%%%%.......%%%%............................
m %.%%%..%.%%%.%.......%%%%%%%%%%%..................%%%%%%%.......%%%%%%%%%%%%%%%%%.......%%%%%.............%..%......%.%.
m %%%%%%%%%%%%%%......%%%%%%%%%%%%..................%%%...........%%.%%%.%%...%.%%........%%%%%%%%%........%%%%.......%%%%
m %%%%%%%%%%%%%........%%%%%%%%%%.........................................................%%%%%%%%%%.......%%%%%......%%%%
m %%%%%%%%%%%%%.......%%%%%%%%%%%.........................................................%%%%%%%%%%.......%%%%.......%%%%
m %%%%%%%%%%%%%%......%%%%%%%%%%%%.........................................................%%%%%%%%........%%%%........%%%
m %%.%%%%%%%%%%%.......%.%%.%%..%%.........................................................%%%..%%%........%%%%%.......%%%
m %.......%%%%%%..............................%%..........................................%%%%.............%%%%%.......%%%
m %........%%%%...............................%%..........................................%%%%.............%%%%%.......%%%
m %.......%%%%%%......................................%.%%%.........%.........%.%..%.......%%%.............%%%%.......%%%%
m %.......%%%%%%.......................................%%%%%.......%%%%........%%%%.......%%%%.............%%%%%.......%%%
m %%......%%%%%.......................................%%%%%.......%%%%%........%%%%.......%%%%.............%%%%........%%%
m %%......%%%%%.......................................%%%%%.......%%%%%........%%%%........%%%.............%%%%%.....1%%%%
m %........%%%%.......%%%.%%............%%.............%%%%.......%%%%%%.......%%%%.......%%%%%%%%%%%%%%%%%%%%%%.......%%%
m %.......%%%%%%.......%%%%.............%%............%%.%%%.......%%%%........%%%%.......%%%%%%%%%%%%%%%%%%%%%%.......%%%
m %........%%%%%.......%%%%%.......................................%%%%%......%%%%%%0.....%%%%%.............%%%........%%%
m %........%%%%%.......%%%%%.......................................%%%%%......%%%%%........%%%%.............%%%%.......%%%
m %........%%%%.......%%%%%.......................................%%%%%%.......%%%%.......%%%%%.............%%%%.......%%%
m .%.........%.........%%%.%......................................%%%%%%.......%%%%%.......%%%%.............%%%.......%..%
m ................................%%...............................%%%%........%%%%.......%%%%%.............%%%%..........
m ................................%%..............................%%%%%%.......%%%%.......%%%%%.............%%%%..........
m ..............................................%%..%%.%%.%.......%%%%%%%%%%%.%%%%%.......%%%%%........%%%..%%%...........
m ..............................................%%%%%%%%%%%%......%%%%%%%%%%%%%%%%%........%%%%........%%%%%%%%...........
m ...............................................%%%%%%%%%%%.......%%%%%%%%%%%%%%%%%.......%%%%.......%%%%%%%%%%..........
m ...............................................%%%%%%%%%%........%%%%%%%%%%%%%%%%%......%%%%%.......%%%%%%%%%%..........
m .%...%%.%%%.%%...........%%%..................%%%%%%%%%%%%......%%%%%%%%%%%%%%%%%%.......%%%%........%%%%%%%%%........%%
m %%%%%%%%%%%%%%.......%%%%%%%..................%%%%%%%%%%%.......%.%%%.%..%%%.%.%.%......%..%.............%%%%%.......%%%
m %%%%%%%%%%%%%%.......%%%%%%%......%.%%.%.......%%%%%%%%%%%................................................%%%%.......%%%
m %%%%%%%%%%%%%.......%%%%%%%........%%%%%......%%%%%%%%%%%%................................................%%%%......%%%%
m %%%%%%%%%%%%%........%%%%%%.......%%%%%.......%%%%%%%%%%%%................................................%%%........%%%
m %%%.%..%%.%.%........%%%%%%.......%%%%%%.......%%%%%%%%%%%................................................%%%%......%%%%
m %...................%%%%%%%.......%%%%%%......%%%%%%%%%%%%................................................%%%%.......%%%
m %%..................%%..%..........%...%.......%%.%.%%%%%.................................................%%%......2%%%%
m %%..................................................................%%......%%%.%.......%.%.%.......%.%.%%%%%.......%%%%
m %%..............................................................%%%%%.......%%%%%%......%%%%%%.......%%%%%%%%%.......%%%
m %%..............................................................%%%%%........%%%%%......%%%%%%.......%%%%%%%%.......%%%%
m %...............................................................%%%%%.......%%%%%%......%%%%%%......%%%%%%%%%........%%%
m %%........%%..%%................................................%%%%%%......%%%%%%......%%%%%%......%%%%%%%%%........%%%
m %........%%%%%%%..................................................%%.........%...%......%...%%......%.%%%.%%%.......%%%%
m %%.......%%%%%%..........%%%........%%%...%%.%%%..%%.......%%%%...........................................%%%%......%%%%
m %%......%%%%%%%.......%%%%%%.......%%%%%%%%%%%%%%%%........%%%%...........................................%%%%......%%%%
m %%......%%%%%%%%.......%%%%.......%%%%%%%%%%%%%%%%%%.......%%%%%..........................................%%%%......%%%%
m ........%%%%%%%%......%%%%%%.......%%%%%%%%%%%%%%%%%.......%%%%%...........................................%.%.......%%.
m ........%%%%%%%........%%%%%.......%%%%%%%%%%%%%%%%%......%%%%%.........................................................
m ........%%%%%.........%%%%%%..........%.%%%%.%%%%%%.......%...%.........................................................
m ......................%%%%%...................%%%%%%..................%%.........%......%.%%.%.......%%.................
m .......................%%%%%..................%%%%%...................%%%%%%%%%%%.......%%%%%.......%%%%................
m .......................%%%%%..................%%%%%....................%%%%%%%%%%.......%%%%%.......%%%%................
m ......................%%%%%...................%%%%%%...................%%%%%%%%%%%......%%%%%........%%%................
m ..%%...................%%%%...................%%%%%%...................%%%%%%%%%%........%%%%.......%%%%.%.%........%..%
m %%%%..................%%%%%....................%%%%%...................%%%%%%%%%%.........%.........%%%%%%%%%%......%%%%
m %%%........%%%.%.%%%%.%%%%%%......%.....%%....%%%%%.......%%.%%........%%%%%%%%%%.........................%%%........%%%
m %%%........%%%%%%%%%%%%%%%%........%%%%%%%%%%%%%%%%%......%%%%%%.......%%%%%%%%%%%........................%%%%.......%%%
m %%%%.......%%%%%%%%%%%%%%%%%......%%%%%%%%%%%%%%%%%.......%%%%%........%%%%%%%%%%%........................%%%.......%%%%
m %%%.......%%%%%%%%%%%%%%%%%%.......%%%%%%%%%%%%%%%%%.......%%%%........%%%%%%%%%%.........................%%%%......%%%%
m %%%.......%%%%%%%%%%%%%%%%%........%%%%%%%%%%%%%%%%.......%%%%%........%%%%%%%%%%.........................%%%.......%%%%
m ..%%.......%%%%..%.%%.%.%.........%.....%..%....%%%%.......%%%%%......%..%...%%...........................%%%%......%%%%
m ....................1...................2.................................................................%%%...........
m ..........................................................................................................%%%%..........
m ..........................................................................................................%%%...........
m ..........................................................................................................%%%%..........
m ..........................................................................................................%%%%%%........
