# map type: blank
# random seed: -510699797
# hill distance  22, 52  16, 63  39,  1  57, 70   4, 87  15, 93  46, 64  45, 94
#        22, 52       0      73     138     129     129     114     114     115 
#        16, 63      73       0     115     114     114      59      59      60 
#        39,  1     138     115       0     129     129     114     114      73 
#        57, 70     129     114     129       0     138     115      73     114 
#         4, 87     129     114     129     138       0      73     115     114 
#        15, 93     114      59     114     115      73       0      60      59 
#        46, 64     114      59     114      73     115      60       0      59 
#        45, 94     115      60      73     114     114      59      59       0 
players 4
rows 104
cols 104
m .%..%%%%.%%..%.%%%%......%%%.............%%%....%%%......%%%....%%%%....%%%%%.%.%.%%....%%%.......%%%%..
m %%%%%%%%%%%%%%%%%%%.....%%%.............%%%.....%%%%.....%%%.....%%......%%%%%%%%%%%.....%%%....%%%%%%%%
m %%%%%%%%%%%%%%%%%%%.....%%%%%%%%..%%.....%%%.....%%.....%%%%.....%%.....%%%%%%%%%%%%....%%%%.....%%%%%%%
m %.%.%.%.%%.%..%..........%%%%%%%%%%%....%%%......%%%.....%%%.....%........%.%.%.%%%%......%......%%%....
m .........................%%%%%%%%%%%....%%%.....%%%......%%%....................%%%%...3.........%%.....
m .........................%%%%%%%..%.....%%%......%%%.....%%%.....................%%..............%%%....
m ........................%%%.............%%%......%%.....%%%%.....................%%.............%%%%....
m ........................%%%..............%%%.....%%.....%%%%....................%%%..............%%%....
m ...%..%.%..%%%.%...%....%%%.............%%%%....%%%......%%%.%.....%......%%.....%%%.%.%..%%..%%%%%%..%%
m %%%%%%%%%%%%%%%%%%%%....%%%.............%%%.....%%%......%%%%%%%%%%%.....%%.....%%%%%%%%%%%%%%%%%%%%%%%%
m %%%%%%%%%%%%%%%%%%%%....%%%......%....%.%%%%....%%%%.%%%%%%%%%%%%%%.....%%%.....%%%%%%%%%%%%%%%%%%%%%%%%
m %%%%%%%%%%%%%%%%%%%%....%%%%.....%%%%%%%%%%.....%%%%%%%%%%%%%%%%%%%.....%.%%....%%...%%.......%.%%%%%%%%
m ..................%.....%%%%....%%%%%%%%%%%%.....%%%%%%%%%%%%%%%%%%%............................%%%%%...
m ..................%.....%%%......%..%...%%%%.....%....%.%%%%%...%%%%.............................%%%%%..
m ..................%.....%%%%............%%%.............%%%.....%%%%.............................%%%%...
m ..................%......%%.............%%%%............%%%%....%%%%.........................3...%%%%...
m .....%%...%%%%....%%....%%%.............%%%%.............%%....0%%%%%...%%%%%%%.%.%......%%.%%%%%%%%%...
m ..%%%%%%%%%%%.....%%.....%%%.............%%%.............%%.....%%%%%%%%%%%%%%%%%%%%....%%%%%%%%%%%%%...
m ...%%%%%%%%%%%....%%....%%%%%%.%%%.%....%%%%.%.%.%%.....%%%......%%%%%%%%%%%%%%%%%%%.....%%%%%%%%%%%%...
m .....%%.%%...%....%%.....%%%%%%%%%%%....%%%%%%%%%%%%....%%%.....%%%%%%%%%%%%%..%%.%.....%%%%%%%%%%..%%..
m ..................%%....%%%%%%%%%%%.....%%%%%%%%%%%......%%.....%%%%%%%%%%%..............%%%%%..........
m ..................%%....%..%%.%.%%%%.....%%..%.%%.%......%%......%.%.%%.%%%.............%%%%%...........
m ..................%%............%%%%................0...%%%.............%%%.............%%%%%...........
m ..................%%............%%%......................%%%.............%%..............%%%%...........
m ...%.%.%.%%%......%%.............%%.....................%%%%.............%%%......%%...%%%%%%%....%%....
m ...%%%%%%%%%%.....%%............%%%......................%%..............%%%....%%%%%%%%%%%%%%.....%%...
m ..%%%%%%%%%%%......%%%%%%..%....%%%%.....%%.....%%%%%...%%%......%%.....%%%%....%%%%%%%%%%%%%%....%%%%..
m ...%%%%%%%..%.....%..%%%%%%%....%%%......%%%....%%%%%%%%%%%.....%%%%....%%%%.....%%%%%....%%%%....%..%..
m ..%%%%....................%%....%%%%.....%%......%%%%%%%%%%%.....%%......%%%..............%%%%..........
m ...%%.....................%.....%.%......%.%....%%%%%..%.%%%....%%%%.....%%................%%%..........
m ..%%%%....................%%.....................%%..............%%%.......................%%%..........
m ...%%.....................%%....................%%%%............%%%.......................%%%...........
m .%%%%%....%.%......%.%.....%.....................%%.............%%%................%%.....%%%%....%%%.%.
m %%%%%......%%.....%%%%....%%....................%%%%............%%%%..............%%%......%%.....%%%%%%
m %%%%%%....%%%......%%%....%%%%%%%..%.....%..%%%%%%%.....%..%....%%%%....%%%%%.....%%%%....%%%%.....%%%%%
m .%%%%%.....%%.....%%%%....%..%%%%%%......%%%%%%%%%%%....%%%%....%%%%%%%%%%%%%%....%%%%.....%%......%%%..
m ...................%%%............%%.....%%%%%%%%%%......%%.....%%%%%%%%%%%%%%....%%%..............%%...
m ...................%%.............%%......%%%.%.%.%.......%%....%%%%%%%...%%......%%%.............%%%%..
m ...................%%%............%%.............................%%%%..............%%.............%%%...
m .1................%%%%............%%.............................%%%%%.............%%%.............%%%..
m ...%.%%.%..%%.....%%%%.%.%%..%....%%.............................%%%%%.............%%%.%%.%.%......%%...
m ...%%%%%%%%%%%.....%%%%%%%%%%%....%%............................%%%%%..............%%%%%%%%%%%.....%%...
m ..%%%%%%%%%%%%....%%%%%%%%%%%.....%%....%...%%.%%.......%%..%%%%%%%%%%.....%.%%..%%%%%%%%%%%%%.....%%%..
m ...%%.%.%.%%%%....%.%%%.%%%%%%....%%....%%%%%%%%%%%......%%%%%%%%%%%%.....%%%%%%%%%%%%%%%%%%%......%%%..
m ..........%%%.............%%%.....%%.....%%%%%%%%%%%.....%%%%%%%%%%%%%....%%%%%%%%%%%%%%%%%%%%.....%%...
m ..........%%%%.............%%%....%%....%%%%...%%........%%%%%%%%%.%%......%.%.%%%%%%%...%%%%%1....%%...
m ..........%%%%.............%%......%.....................%%%%...2.........................%%%%....%%%%..
m ...........%%%............%%%%.....%.....................%%%%.............................%%%%.....%%%..
m ....%.....%%%%...%..%......%%%.....%....................%%%%%.............................%%%%...%%%%%.%
m %%%%%.....%%%%%%%%%%%%....%%%%.....%.....................%%%%%............................%%%%%%%%%%%%%%
m %%%%%%.....%%%%%%%%%%.....%%%%....%%%%%%%%%%%%%%%%%%%%%%%%%%%%.%.......%%...%%....%%.%.....%%%%%%%%%%%%%
m %.%%%%....%%%%.%....%......%%%....%%%%%%%%%%%%%%%%%%%%%%%%%%%%%%%%%%%%%%%%%%%%.....%%%.....%%%%%%%%%%%%%
m ...%%%.....%%%.............%%%....%%%%%%%%%%%%%%%%%%%%%%%%%%%%%%%%%%%%%%%%%%%%.....%%.....%%%%%%%%%%%...
m ...%%%....%%%%.............%%%....%...%.%%%..%.%..%...%%..%%%%%%..%%..%.%.%%%.....%%......%.....%.%%%...
m ...%%.....%%%..............%%%............................%%%..............%%%....................%%%%..
m ...%%......%%%.............%%%............................%%%%.............%%.....................%%%%..
m ..%%%......%%%.....%..%%%%%%%.............................%%%..............%%.....................%%%...
m ...%%%.....%%%....%%%%%%%%%%%..............................%%.........2...%%%%....................%%%...
m ..%%%......%%%....%%%%%%%%%%%..........%..%.%%.%.%.%.%....%%%......%......%%%%.%.%.%........%.....%%%...
m ...%%.....%%%.....%%..%%%%%%%%.....%%%%%%%%%%%%%%%%%%%%%%%%%%.....%%%%....%%%%%%%%%%%%.....%%.....%%%%..
m ..%%%%.....%%%.............%%%.....%%%%%%%%%%%%%%%%%%%%%%%%%%%....%%%.....%%%%%%%%%%%......%%.....%%%...
m ...%%%....%%%.............%%%......%%%%.%..%%.%%%%..%...%%%%.......%%%....%%.%.%.%%%%%....%%%%....%%%...
m ..%%%%.....%%.............%%%......%%%............................%%%%............%%%.....%%%%....%%%%..
m ...%%%.....%%%............%%%%....%%%%.............................%%.............%%%%.....%%.....%%%...
m ..%%%.....%%%%.%..%%%.....%%%.....%%%.............................%%%%............%%%.....%%%.....%%%%..
m ..%%%%....%%%%%%%%%%%%....%%%%....%%%%.............................%%.............%%%%....%%%.....%%%...
m ...%%%....%%%%%%%%%%%......%%.....%%%%.....%%%..%.%....%%.%.%%.%%%%%%......%.%.....%%%.....%%%....%%%...
m ..%%%......%.%.%%%%%%.....%%%.....%%%.....%%%%%%%%%%%%%%%%%%%%%%%%%%%%....%%%......%%%.....%%%....%%%%..
m ...%%.............%%%%....%%%%.....%%......%%%%%%%%%%%%%%%%%%%%%%%%%%%....%%%%....%%%......%%%....%%%%..
m ...%%%............%%%......%%.....%.......%%%%%..%.%%%%.%%%%%%%%%.%%%.....................%%.%....%%%%..
m ..%%%..............%%.....%%%..............%%..............%%.....................................%%%...
m ...%%%............%%%......%%%............%%%%............%%%.....................................%%%%..
m ...%%%%%.%%.......%%%.....%%%.............%%%..............%%.....................................%%%...
m ...%%%%%%%%%%.....%%%......%%.............%%%..............%%%....................................%%%...
m ...%%%%%%%%%%......%%%....%%%%......%%%.%%%%%%....%%%......%%.....%%.%%...%.%.....%.%%%%%%%%%%%%%%%%%...
m .......%%%%%.%.....%%%.....%%.....%%%%%%%%%%%%....%%%%.....%%......%%%%%%%%%%%.....%%%%%%%%%%%....%%%%..
m ...........................%%.....%%%%%%%%%%%%.....%%.....%%%%....%%%%%%%%%%%......%....................
m ............................%.....%%.....%..%......%%.......%.....%%%%%%.%%%%%....%%....................
m ..................................................%%%%............%%%.............%%....................
m ..................................................%%%%.............%%%............%%....................
m ...%%..%.%..%..%..%...............................%%%%............%%%.............%%....%%.%.%.%%%%%%%%%
m %%%%%%%%%%%%%%%%%%%%%%............................%%%%............%%%%............%......%%%%%%%%%%%%%%%
m %%%%%%%%%%%%%%%%%%%%%.....%%.......%.%.%.%%.%%%%%.%%%%.....%%.%..%%%%%....%%%.%%%%%......%%%%%%%%%%%%%%%
m %%%%.%%%%%.%%.%.%.%.......%%.....%%%%%%%%%%%%%%%%%%%%%%%%%%%%%%%%%%%%......%%%%%.%%%....%%%%%..%.%%.....
m %%%%............................%%%%%%%%%%%%%%%%%%%%%%%%%%%%%%%%%%%%%......%............%%%%............
m %%%%...............................%..%..%..%.%..%%...%%%%%%%%%.%.%.%%....%%.............%%%............
m %%%%......................................................................%%............%%%.............
m %%%%......................................................................%%.............%%%............
m .%%......%..%.....%%.....%................................................%%....%%%%%.%%%%%%.....%......
m .%%.....%%%%%%%%%%%%.....%%...............................................%......%%%%%%%%%%%....%%%%....
m %%%%....%%%%%%%%%%%%.....%%.....%%%.....%.%%%%%.........%%%%....%%%%%%%%%%%.....%%%%%%%%%%%......%%.....
m .%%%....%%%%%%.%%%......%%%%....%%%......%%%%%%%%%%......%%%%%%%%%%%%%%%%%.%.....%.%...%%.%%.....%%.....
m .........%%%.............%%......%%%.....%%%%%%%%%%......%%%....................................%%%.....
m .........%%%.............%%%.....%%%.......%%.%%%%%......%%%.....................................%%.....
m ........%%%%............%%%......%%%............%%%.....%%%%.....................................%%%....
m .........%%..............%%%.....%%..............%%%.....%%%.....................................%%.....
m %%%.%..%%%%%.......%.....%%......%%%............%%%.....%%%%....%.%%.....................%%%.%%%%%%%%%.%
m %%%%%%%%%%%......%%.....%%%%....%%%%.............%%.....%%%%....%%%......%%%....%%%%....%%%%%%%%%%%%%%%%
m %%%%%%%%%%%%.....%%%.....%%%.....%%%%%%.%.%......%%%....%%%%....%%%.....%%%......%%%....%%%%%%%%%%%%%%%%
m ...%.%..%%%.....%%%%.....%%......%%%%%%%%%%%....%%%......%%%....%%%.....%%%.....%.%......%%%%%%.%%.%.%%.
m ................%%%%....%%%%....%%%%%%%%%%%%....%%%%.....%%%.....%%%....%%%%.............%%.............
m .................%%%.....%%%.....%%%..%.%%%%.....%%%....%%%%.....%%%.....%%%............%%%%............
m ................%%%%....%%%%............%%%.....%%%......%%%.....%%.....%%%%.............%%.............
m ................%%%......%%%.............%%.....%%%%....%%%%....%%%%.....%%%............%%%%............
