# map type: blank
# random seed: 1462026872
# hill distance  58, 20   6, 29  82, 17   3, 53  16, 56  55,  7
#        58, 20       0      61      37      98     106      50 
#         6, 29      61       0      24      37      45      69 
#        82, 17      37      24       0      61      69      45 
#         3, 53      98      37      61       0      50     106 
#        16, 56     106      45      69      50       0      78 
#        55,  7      50      69      45     106      78       0 
players 2
rows 88
cols 88
m %%%%%%%%.................%%%%.....%%%%%%%%%%%%%%%%%%%%%%%%%%%%%%%%%%%%%%%%%%%%%%%%%%%%%%
m %%%%%%%%..................%%%....%%%%%%%%%%%%%%%%%%%%%%%%%%%%%%%%%%%%%%%%%%%%%%%%%%%%%%%
m %%%%%%%%%................%.%%....%%%%%%%%..%....%%%%...%%%%%%%..%%..%..%%........%%.%...
m .%%%.........%%%%%.%..............%%%................0...%%%%...........................
m .%%%%........%%%%%%%%.............%%%....................%%%%...........................
m ..%%%.........%%%%%%.............%%%......................%%............................
m .%%%...........%%%%%%........0....%%.....................%%%%...........................
m .%%%.............%%%%....%.%......%%%......%.%%..%..%....%%%%....%.%.....%%..%.%....%...
m ..%%.............%%%%.....%%%....%%%.....%%%%%%%%%%%%%%%%%%%%....%%%%%%%%%%%%%%%%%%%%...
m .%%%..............%%%.....%%%.....%%.....%%%%%%%%%%%%%%%%%%%%....%%%%%%%%%%%%%%%%%%%%...
m .%%................%%....%%%%.....%.%.....%%%.%%..%%%%.%%%%%.....%%%%%%%....%...%%%%....
m ..........................%%%.............%%.............%%%.....%%%..............%%....
m ..........................%%%.............%%.............%%%......%%..............%%....
m ..........................%%%.............%%%............%%%......%%..............%%....
m ..........................%%%............%%%%............%%%%....%%%..............%%....
m ...%%................%...%%%.....%........%%%.............%%.....%%%%....%%.%.....%%%...
m .%%%%................%%%%%%%%....%%%%....%%%.....%%%%...1%%%.....%%%.....%%%......%%....
m .%%%.................%%%%%%%......%%......%%.....%%%.....%%%......%%%.....%%.....%%%%...
m ..%%.................%%%%%%%.....%%%%.....%.......%%%.....%%......%%%.....%%.....%.%....
m ..%%%..%%.........%%.%%%%%%%%.....%%%............%%%......%%%.....%%%...................
m .%%%%%%%%.....%%%%%%%%%%%%%%%....%%%.............%%%%....%%%%.....%%%...................
m ..%%%%%%.....%%%%%%%%%%%%%%%%.....%%.............%%%......%%......%%....................
m .%.%..%%.....%%.%%.%%%%%%%%%......%%..............%%......%%%....%%%%...................
m %....................%%%.....%.%.%%%%....%....%%%%%%%.....%%%.....%%%%%.%........%.%%%..
m ......................%%.....%%%%%%%%%%%%%%%%%%%%%%%......%%%.....%%%%%%%%%%%.....%%%%%%
m ......................%%%....%%%%%%%%%%%%%%%%%%%%%%%%....%%%%....%%%%%%%%%%%.....%%%%%%%
m %.....................%%%....%%%%%%%%%%%..%.%%%..%%%%....%%%........%%.%.%%%%.....%%%%%%
m %.....%.%.....%%%....%%%%....%%%%%%%..............%%%....%%%.............%%%......%%%%%%
m %....%%%%%%%%%%%......%%......%%%%%%%............%%%%.....%%.............%%%%.....%%%%%%
m ......%%%%%%%%%%.....%%%.....%%%%%%%.............%%%%.....%%%............%%%%....%%%%%%%
m %....%%......%%%.....%%%%....%%.%%%%%.............%%%....%%%.............%%%......%...%.
m .............%%%......%%%............%.%..%.%.....%%%.....%%%%.%%...%.....%%%.%%........
m ..............%%%.....%%.............%%%%%%%......%%%.....%%%%%%%%%%%.....%%%%%%%.......
m ..............%%......%%%............%%%%%%%......%%%....%%%%%%%%%%%%....%%%%%%%%.......
m ..............%%%.....%%.............%%%%.%.%.....%......%.%.%...%.%.....%%%%%%%........
m ........%....%%%......%%%.....%%%....%%%%................................%%%%%%%%.%%.%.%
m .....%%%......%%......%%......%%.....%%%%.................................%%%%%%%%%%%%%%
m .....%%%%.....%%%.....%%%.....%%......%%%.................................%%%%%%%%%%%%%%
m .......%%.....%%%.....%%%....%%%%.....%..................................%..%%%..%%%%%%%
m %.............%%.....%%%%....%%%%............%%%.%%%%.%..%%%%....%%%%.................%%
m .............%%%.....%%%%....%%%%............%%%%%%%%%%%%%%%.....%%%%................%%%
m %............%%%......%%.....%%%%............%%%%%%%%%%%%%%%%.....%%..................%%
m %............%%%......%%%....%%%.............%%%%%%%%%.%%...%.....%%.................%%%
m %%.%%%%.%....%%%.....%%%......%%%.%%.%%......%%%%%%%..............%%%..%%.....%%%....%%%
m %%%%%%%%%%%%%%%%%.....%%%....%%%%%%%%%%%......%%%%%%%.............%%%%%%%....%%%......%%
m %%%%%%%%%%%%%%%%......%%%.....%%%%%%%%%%%.....%%%%%%%.............%%%%%%%.....%%......%%
m .%.....%%%..%%%%%....%%%%.....%%%...%%.......%%%.%%%%............%.....%%....%%%......%.
m .....................%%%.................................%%%%%%%%.............%%%.......
m ......................%%%................................%%%%%%%%.............%%%.......
m ......................%%..................................%%%%%%%.............%%........
m .....................%%%..................................%%%%%%%............%%%%.......
m %%.%%....%....%%%%.%%%%%%..%%%..%.%.%%.%.......%%.....%%%%%%%%%%%....%%.%.....%%%.%...%%
m %%%%%%%%%%%%%%%%%%%%%%%%%%%%%%%%%%%%%%%%......%%%....%%%%%%%%%%%%.....%%%....%%%%%%%%%%%
m %%%%%%%%%%%%%%%%%%%%%%%%%%%%%%%%%%%%%%%%......%%......%%%%%%%%%%%.....%%%.....%%%%%%%%%%
m ...%..%%.%%%%%%%%%.%%%%%%.%%.....%%.%.%%.....%%%%.....%%%%%%%..%%.....%%%....%%..%..%%%.
m .......0.....%%%.....%%%%....................%%%.....%%%%%%%%........%%%................
m .............%%%.....%%%%....................%%%......%%%%%%%........%%%................
m ..............%%......%%%.....................%%%.....%%%%%%%.........%%%...............
m .............%%%....1.%%.....................%%%%.......%..%.........%%%................
m %..%.%.%.....%%%%.....%%.....%%%%%.....%......%%%%%.%............%%%.%%%%.....%%%%%%%%%.
m %%%%%%%%.....%%%.....%%%%....%%%%%%%%%%%%.....%%%%%%.............%%%%%%%%.....%%%%%%%%%%
m %%%%%%%%.....%%%.....%%%%....%%%%%%%%%%%%....%%%%%%%%............%%%%%%%%....%%%%%%%%%%%
m %.%%%.%%......%%%....%%%%.....%%.%%..%%%.....%%%%%%%%............%%%%%%%%.........%%.%%%
m %.............%%.....%%%..............%%%....%%%%%%%%%%..%.%%.....%%%%%%..............%%
m %............%%%......%%%............%%%%.....%%%%%%%%%%%%%%%....%%%%%%%%.............%%
m %............%%%%.....%%.............%%%.....%%%%%%%%%%%%%%%.....%%%%%%%%............%%%
m ..............%%%.....%%%.............%%%....%%.%%%..%.%%%.......%..%%%%%............%%%
m ........%%%..%%%......%%%%.%.%.%.....%%%%..%%................................%..%....%%%
m ......%%%%%%%%%%%....%%%%%%%%%%%.....%%%%%%%%.................................%%......%%
m .....%%%%%%%%%%%......%%%%%%%%%%%....%%%%%%%.................................%%%%....%%%
m %......%.%....%%......%%%....%%%......%%%%%%..................................%%......%%
m .....................%%%.................%%%%%.%%.%%..............%.......%%%%%%......%%
m .....................%%%.................%%%%%%%%%%%%....%%%%.....%%......%%%%%%%....%%%
m .....................%%%.................%%%%%%%%%%%.....%%%......%%%....%%%%%%%.....%%%
m .....................%%%%.................%%%.%%.%%%......%%%....%%%%......%%%%%%....%%%
m %...%%.%.....%..%..%%%%%..........%.%.............%%.....%%%%....%%%.............%.%.%%%
m %%%%%%%%......%%%%%%%%%%......%%%%%%..............%%......%%......%%%............%%%%%%%
m %%%%%%%%.....%%%%%%%%%%%.....%%%%%%%%............%%%.....%%%%.....%%%............%%%%%%%
m %..%.%.%%......%..%..%%.%.....%%%%%%.............%%%%....%%%......%%.............%%%%%%%
m .............................%%%%%%%......%.......%%%.....%%%....%%%%.%%%%..%....%%%%%%%
m %.............................%%%%%%.....%%%%....%%%%.....%%.....%%%%%%%%%%%%.....%%%%%%
m ..............................%%%%%%.....%%%.....%%%%.....%%.....%%%%%%%%%%%%....%%%%%%%
m %................1...........%..%.%......%%%%.....%%%.....%%%......%.%%%%%.......%%.%%%%
m ..%%%..%.%%%%%%%.....%%%%.%...............%%..............%%%...........................
m .%%%%%%%%%%%%%%%%....%%%%%%%..............%%%............%%%%...........................
m .%%%%%%%%%%%%%%%......%%%%%%%.............%%.............%%%............................
m .%%%%%%%%....%..%....%.%.%%%..............%%%.............%%............................
m .%%%%%%%..................%%%....%...%...%%%%%.%.%%%..%%%%%%%..%.%%%.%.%%%%.%.%.%%..%%%.
