# map type: blank
# random seed: 2061560831
# hill distance  43,103  17,  6  32, 77  32,  6   6, 88  17, 77  43, 88   6,103
#        43,103       0      63      63      34      86      92      35      79 
#        17,  6      63       0      86      35      63      79      92      34 
#        32, 77      63      86       0      79      63      35      34      92 
#        32,  6      34      35      79       0      92      86      63      63 
#         6, 88      86      63      63      92       0      34      79      35 
#        17, 77      92      79      35      86      34       0      63      63 
#        43, 88      35      92      34      63      79      63       0      86 
#         6,103      79      34      92      63      35      63      86       0 
players 8
rows 108
cols 108
m ........%...................%%........................%%...................%..............%%........%%......
m ........%....................%........................%....................%.............%%%........%%%.....
m ........%....................%%......................%%....................%.............%%..........%%.....
m .......%%%...%%%......%..%%.%%%.....%...%..%...%.....%%%.%%..%......%%%...%%%............%%..........%%.....
m %.......%%%%%%%%%%%...%%%%%%%%%...%%%...%%%%...%%%...%%%%%%%%%...%%%%%%%%%%%.......%%%...%%..........%%...%%
m %........%...%.%.%%...%%%%%.%......%....%%%%....%......%.%%%%%...%%.%.%...%........%%....%%%........%%%....%
m ...................................%.....%%.....%...................................%...7.%..........%.4...%
m ..................................%%....%%%%....%%..................................%%...%%..........%%...%%
m ...................................%%....%%....%%...................................%....%%%........%%%....%
m %%.%............................%..................%............................%.%%%%.%.%%..........%%.%.%%
m %%%............................%%..................%%............................%%%%%%%%%%..........%%%%%%%
m %%%%...........................%%..................%%...........................%%%%%%%%%%............%%%%%%
m %%%%...%%....%.....%..%%.......%%%%%............%%%%%.......%%..%.....%....%%...%%%%%......................%
m %%%%%%%%%....%%%....%%%%%%%%....%%%%%%%......%%%%%%%....%%%%%%%%....%%%....%%%%%%%%%%......................%
m .%%%.%..%.....%....%%%.%%.%%...%.%....%%....%%....%.%...%%.%%.%%%....%.....%..%.%%%.........................
m .%%.................%..........................................%.................%%.........................
m .%%%................%%........................................%%................%%%.........................
m .%%...3............%%%........................................%%%............2...%%.........................
m .%%%%%.%%%%%...%...%%%.....%..%%%....%%%....%%%....%%%..%.....%%%...%...%%%%%.%%%%%..........%....%.........
m ..%%%%%%%%%%%%%%...%%.....%%%%%%%.....%......%.....%%%%%%%.....%%...%%%%%%%%%%%%%%...........%....%.........
m ....%..%...%%.%...........%%....%%...%.%....%.%...%%....%%...........%.%%...%..%.............%....%.........
m ............................................................................................%%....%%........
m .........................................................................................%%%%%....%%%%%.....
m ............................................................................................................
m ...............................................................................................%%...........
m ...............................................................................................%%...........
m ............................................................................................................
m .........................................................................................%%%%%....%%%%%.....
m ............................................................................................%%....%%........
m ....%..%...%%.%...........%%....%%...%.%....%.%...%%....%%...........%.%%...%..%.............%....%.........
m ..%%%%%%%%%%%%%%...%%.....%%%%%%%.....%......%.....%%%%%%%.....%%...%%%%%%%%%%%%%%...........%....%.........
m .%%%%%.%%%%%...%...%%%.....%..%%%....%%%....%%%....%%%..%.....%%%...%...%%%%%.%%%%%..........%....%.........
m .%%...1............%%%........................................%%%............0...%%.........................
m .%%%................%%........................................%%................%%%.........................
m .%%.................%..........................................%.................%%.........................
m .%%%.%..%.....%....%%%.%%.%%...%.%....%%....%%....%.%...%%.%%.%%%....%.....%..%.%%%.........................
m %%%%%%%%%....%%%....%%%%%%%%....%%%%%%%......%%%%%%%....%%%%%%%%....%%%....%%%%%%%%%%......................%
m %%%%...%%....%.....%..%%.......%%%%%............%%%%%.......%%..%.....%....%%...%%%%%......................%
m %%%%...........................%%..................%%...........................%%%%%%%%%%............%%%%%%
m %%%............................%%..................%%............................%%%%%%%%%%..........%%%%%%%
m %%.%............................%..................%............................%.%%%%.%.%%..........%%.%.%%
m ...................................%%....%%....%%...................................%....%%%........%%%....%
m ..................................%%....%%%%....%%..................................%%...%%..........%%...%%
m ...................................%.....%%.....%...................................%...5.%..........%.6...%
m %........%...%.%.%%...%%%%%.%......%....%%%%....%......%.%%%%%...%%.%.%...%........%%....%%%........%%%....%
m %.......%%%%%%%%%%%...%%%%%%%%%...%%%...%%%%...%%%...%%%%%%%%%...%%%%%%%%%%%.......%%%...%%..........%%...%%
m .......%%%...%%%......%..%%.%%%.....%...%..%...%.....%%%.%%..%......%%%...%%%............%%..........%%.....
m ........%....................%%......................%%....................%.............%%..........%%.....
m ........%....................%........................%....................%.............%%%........%%%.....
m ........%...................%%........................%%...................%..............%%........%%......
m %......%%%...%%%..%....%%...%%%%%%.%%...%%%%...%%.%%%%%%...%%....%..%%%...%%%......%%.....%..........%.....%
m ........%%...%%%%%%...%%%....%%%%%%%%....%%....%%%%%%%%....%%%...%%%%%%...%%........%%....%%........%%....%%
m .......%%%...%%%%%%....%%....%%%.%%%%...%%%%...%%%%.%%%....%%....%%%%%%...%%%.......%....%%..........%%....%
m ........%.....%%%%%...%%..........%%%....%%....%%%..........%%...%%%%%.....%................................
m .......%%.....%%%%.....%%.........%%%....%%....%%%.........%%.....%%%%.....%%...............................
m .......%%....%%%%.%...%%%..........%.....%%.....%..........%%%...%.%%%%....%%...............................
m %.....................%%....%.....%%%...%%%%...%%%.....%....%%.....................%.%..%%%..........%%%..%.
m ....................%%%%.....%....%%%...%%%%...%%%....%.....%%%%....................%%%%%%%..........%%%%%%%
m ....................%%%%%...%%%....%%....%%....%%....%%%...%%%%%....................%%.%%%............%%%.%%
m %......%%%....%.%.%%%%%%%....%%....%....%%%%....%....%%....%%%%%%%.%.%....%%%......%%......................%
m %......%%....%%%%%%%%%%%%....%....%%.....%%.....%%....%....%%%%%%%%%%%%....%%......%%%....................%%
m .......%%....%%%.%%..%%%%....%%....%%...%%%%...%%....%%....%%%%..%%.%%%....%%.......%%....................%%
m .......%%%...............%.%%%%....%.....%%.....%....%%%%.%...............%%%.......%......................%
m .......%%%................%%%%%...%%.....%%.....%%...%%%%%................%%%.......%%....%%........%%....%%
m ........%................%%%%%%....%............%....%%%%%%................%........%%...%%%........%%%...%%
m .......%%%..%%.....%.%...%%%%%%......................%%%%%%...%.%.....%%..%%%.............%..........%......
m ........%%%%%%%%....%%%%%%%%%%%......................%%%%%%%%%%%....%%%%%%%%..............%..........%......
m ........%%%..%%%.....%%.%%%%%%........................%%%%%%.%%.....%%%..%%%.............%%..........%%.....
m %%%..........%%%...................%%...%..%...%%...................%%%..........%%%.%...%%..........%%...%.
m %%%%.........%%...................%%....%%%%....%%...................%%.........%%%%%....%%%........%%%....%
m %............%%%...................%....%%%%....%...................%%%............%%%.....%........%.....%%
m %....%..%.....%%%%.%%..%..%.....%.%%%...%%%%...%%%.%.....%..%..%%.%%%%.....%..%....%%......................%
m %...%%%%%....%%%%%%%%%%%%%%%...%%%%%.....%%.....%%%%%...%%%%%%%%%%%%%%%....%%%%%...%%......................%
m ....%...%%...%%%%%.%%%..%......%..%......%%......%..%......%..%%%.%%%%%...%%...%....%......................%
m .....................................%%%%%%%%%%.....................................%....%.%........%.%....%
m .....................................%%%%%%%%%%.....................................%%...%%..........%%...%%
m .....................................%%%%%%%%%%......................................%...%.%........%.%...%.
m .....%.%%%...%.%...%%.%.%......%%%%..%%%%%%%%%%..%%%%......%.%.%%...%.%...%%%.%.............................
m ....%%%%%....%%%%%%%%%%%%%%.....%%%%%%%%%%%%%%%%%%%%.....%%%%%%%%%%%%%%....%%%%%............................
m ....%%%%%....%%%%%%%%%%%%%%.....%%%%%%%%%%%%%%%%%%%%.....%%%%%%%%%%%%%%....%%%%%............................
m .....%.%%%...%.%...%%.%.%......%%%%..%%%%%%%%%%..%%%%......%.%.%%...%.%...%%%.%.............................
m .....................................%%%%%%%%%%......................................%...%.%........%.%...%.
m .....................................%%%%%%%%%%.....................................%%...%%..........%%...%%
m .....................................%%%%%%%%%%.....................................%....%.%........%.%....%
m ....%...%%...%%%%%.%%%..%......%..%......%%......%..%......%..%%%.%%%%%...%%...%....%......................%
m %...%%%%%....%%%%%%%%%%%%%%%...%%%%%.....%%.....%%%%%...%%%%%%%%%%%%%%%....%%%%%...%%......................%
m %....%..%.....%%%%.%%..%..%.....%.%%%...%%%%...%%%.%.....%..%..%%.%%%%.....%..%....%%......................%
m %............%%%...................%....%%%%....%...................%%%............%%%.....%........%.....%%
m %%%%.........%%...................%%....%%%%....%%...................%%.........%%%%%....%%%........%%%....%
m %%%..........%%%...................%%...%..%...%%...................%%%..........%%%.%...%%..........%%...%.
m ........%%%..%%%.....%%.%%%%%%........................%%%%%%.%%.....%%%..%%%.............%%..........%%.....
m ........%%%%%%%%....%%%%%%%%%%%......................%%%%%%%%%%%....%%%%%%%%..............%..........%......
m .......%%%..%%.....%.%...%%%%%%......................%%%%%%...%.%.....%%..%%%.............%..........%......
m ........%................%%%%%%....%............%....%%%%%%................%........%%...%%%........%%%...%%
m .......%%%................%%%%%...%%.....%%.....%%...%%%%%................%%%.......%%....%%........%%....%%
m .......%%%...............%.%%%%....%.....%%.....%....%%%%.%...............%%%.......%......................%
m .......%%....%%%.%%..%%%%....%%....%%...%%%%...%%....%%....%%%%..%%.%%%....%%.......%%....................%%
m %......%%....%%%%%%%%%%%%....%....%%.....%%.....%%....%....%%%%%%%%%%%%....%%......%%%....................%%
m %......%%%....%.%.%%%%%%%....%%....%....%%%%....%....%%....%%%%%%%.%.%....%%%......%%......................%
m ....................%%%%%...%%%....%%....%%....%%....%%%...%%%%%....................%%.%%%............%%%.%%
m ....................%%%%.....%....%%%...%%%%...%%%....%.....%%%%....................%%%%%%%..........%%%%%%%
m %.....................%%....%.....%%%...%%%%...%%%.....%....%%.....................%.%..%%%..........%%%..%.
m .......%%....%%%%.%...%%%..........%.....%%.....%..........%%%...%.%%%%....%%...............................
m .......%%.....%%%%.....%%.........%%%....%%....%%%.........%%.....%%%%.....%%...............................
m ........%.....%%%%%...%%..........%%%....%%....%%%..........%%...%%%%%.....%................................
m .......%%%...%%%%%%....%%....%%%.%%%%...%%%%...%%%%.%%%....%%....%%%%%%...%%%.......%....%%..........%%....%
m ........%%...%%%%%%...%%%....%%%%%%%%....%%....%%%%%%%%....%%%...%%%%%%...%%........%%....%%........%%....%%
m %......%%%...%%%..%....%%...%%%%%%.%%...%%%%...%%.%%%%%%...%%....%..%%%...%%%......%%.....%..........%.....%
