# map type: blank
# random seed: -262170099
# hill distance  15, 86  63, 74  63, 51   0, 51  88, 26  48, 86  88, 99  76,114   0, 74  76, 11 111, 99 111, 26 123, 11 123,114  48, 39  15, 39
#        15, 86       0      60      83      76     135      43     114     117      43     122      97     122     117     112      80      75 
#        63, 74      60       0      37      86      79      43      54      97      71     114      79     100     135     122      76      83 
#        63, 51      83      37       0      71      54      76      79     114      86      97     100      79     122     135      43      60 
#         0, 51      76      86      71       0      79      83     100     135      37     122      79      54      97     114      60      43 
#        88, 26     135      79      54      79       0     122      71      60     100      43      86      37      76      83      97     114 
#        48, 86      43      43      76      83     122       0      97     112      60     117     114     135     122     117      75      80 
#        88, 99     114      54      79     100      71      97       0      43      79      60      37      86      83      76     122     135 
#        76,114     117      97     114     135      60     112      43       0     122      43      76      83      80      75     117     122 
#         0, 74      43      71      86      37     100      60      79     122       0     135      54      79     114      97      83      76 
#        76, 11     122     114      97     122      43     117      60      43     135       0      83      76      75      80     112     117 
#       111, 99      97      79     100      79      86     114      37      76      54      83       0      71      60      43     135     122 
#       111, 26     122     100      79      54      37     135      86      83      79      76      71       0      43      60     114      97 
#       123, 11     117     135     122      97      76     122      83      80     114      75      60      43       0      43     117     112 
#       123,114     112     122     135     114      83     117      76      75      97      80      43      60      43       0     122     117 
#        48, 39      80      76      43      60      97      75     122     117      83     112     135     114     117     122       0      43 
#        15, 39      75      83      60      43     114      80     135     122      76     117     122      97     112     117      43       0 
players 8
rows 136
cols 136
m %%%%%%%%%%%%%%%......%%%%%%%............%%%%.......3....%%%........%%%....2.......%%%%............%%%%%%%......%%%%%%%%%%%%%%%%%......%%
m %%%%%%%%%%%%%%%......%%%%%%.............%%%.............%%%........%%%.............%%%.............%%%%%%......%%%%%%%%%%%%%%%%%......%%
m .%.%%%%%%%.%..%......%%%%%%..............%%..............%%........%%..............%%..............%%%%%%......%..%.%%%%%%%.%.%%......%%
m .....................%%%%%%%.%%.%%%.....%%%......%%%.....%%........%%.....%%%......%%%.....%%%.%%.%%%%%%%.....................%%......%%
m .....................%%%%%%%%%%%%%%.....%%%......%%......%%%......%%%......%%......%%%.....%%%%%%%%%%%%%%......................%......%.
m .....................%%%%%%%%%%%%%%%....%%%......%%.....%%%%......%%%%.....%%......%%%....%%%%%%%%%%%%%%%.....................%%......%%
m ....................%......%.%%%%.%......%%%....%%%%......%........%......%%%%....%%%......%.%%%%.%......%.....................%......%.
m ......%........%..%%....................%%%%....%%%%......................%%%%....%%%%....................%%..%........%......%%......%%
m ....%%%%.....%%%%%%%.....................%%%.....%%........................%%.....%%%.....................%%%%%%%.....%%%%....%%......%%
m ....%%%%....%%%%%%%......................%%%.....%%........................%%.....%%%......................%%%%%%%....%%%%.....%......%.
m ....%%%%.....%%%%%%......................%%%.....%%%......................%%%.....%%%......................%%%%%%.....%%%%..............
m .....%%......%%%%%%%............%%......%%%%....%%%%%%....%%......%%....%%%%%%....%%%%......%%............%%%%%%%......%%...............
m ....%%%.....%%%%%%%.....%%%%....%%%%%%%%%%%......%%%%%%%%%%%......%%%%%%%%%%%......%%%%%%%%%%%....%%%%.....%%%%%%%.....%%%..............
m .....%%.....%%%%%%%......%%......%%%%%%%%%%.....%%%%%%%%%%%........%%%%%%%%%%%.....%%%%%%%%%%......%%......%%%%%%%.....%%...............
m .....%%%.....%%..%.......%%......%%%%%..%%%......%%..%%%%%%........%%%%%%..%%......%%%..%%%%%......%%.......%..%%.....%%%...............
m ........................%%%......%%....7%%%%............%%%........%%%............%%%%4....%%......%%%..................................
m .........................%%.....%%%%....%%%.............%%%%......%%%%.............%%%....%%%%.....%%.............................%%....
m ........................%%%......%%.....%%%%.............%%%......%%%.............%%%%.....%%......%%%............................%%....
m ........................%%%.....%%%.....%%%..............%%........%%..............%%%.....%%%.....%%%..................................
m .%.%...%....%...%%%.....%%%%%...%%%%....%%%%.....%%.....%%%........%%%.....%%.....%%%%....%%%%...%%%%%.....%%%...%....%...%.%.....%%....
m %%%%%%%.....%%%%%%%%....%%%%%%%%%%%%.....%%......%%......%%........%%......%%......%%.....%%%%%%%%%%%%....%%%%%%%%.....%%%%%%%....%%....
m .%%%%%%.....%%%%%%%.....%%%%%%%%%%%%.....%%......%%%.....%%%......%%%.....%%%......%%.....%%%%%%%%%%%%.....%%%%%%%.....%%%%%%.....%%....
m %%%%%%%.......%.%%%.....%%%%..%%%.%%....%..%.....%%%....%%%........%%%....%%%.....%..%....%%.%%%..%%%%.....%%%.%.......%%%%%%%..........
m .%%%%%%%................%%%%....................%%%.....%%%........%%%.....%%%....................%%%%................%%%%%%%...........
m %%%%%%%..................%%%....................%%%.....%%%%......%%%%.....%%%....................%%%..................%%%%%%%..........
m .%%%%%%%................%%%%....................%%%.....%%%........%%%.....%%%....................%%%%................%%%%%%%...........
m %.%.%.%..................%%......................%%%....%%%........%%%....%%%......................%%..................%.%.%.%..........
m ..................%%.%.%%%%......%%%...%.%.%....%%%%%..%%%%........%%%%..%%%%%....%.%.%...%%%......%%%%.%.%%............................
m .................%%%%%%%%%%......%%%%%%%%%%%.....%%%%%%%%%%........%%%%%%%%%%.....%%%%%%%%%%%......%%%%%%%%%%...........................
m ................................%%%........................................................%%%..........................................
m .................................%%........................................................%%...........................................
m .....%%%.%%......................%%........................................................%%......................%%.%%%.........%%....
m .....%%%.%%......................%%........................................................%%......................%%.%%%.........%%....
m .................................%%........................................................%%...........................................
m ................................%%%........................................................%%%..........................................
m .................%%%%%%%%%%......%%%%%%%%%%%.....%%%%%%%%%%........%%%%%%%%%%.....%%%%%%%%%%%......%%%%%%%%%%...........................
m ..................%%.%.%%%%......%%%...%.%.%....%%%%%..%%%%........%%%%..%%%%%....%.%.%...%%%......%%%%.%.%%............................
m %.%.%.%..................%%......................%%%....%%%........%%%....%%%......................%%..................%.%.%.%..........
m .%%%%%%%................%%%%....................%%%.....%%%........%%%.....%%%....................%%%%................%%%%%%%...........
m %%%%%%%..................%%%....................%%%.....%%%%......%%%%.....%%%....................%%%..................%%%%%%%..........
m .%%%%%%%................%%%%....................%%%.....%%%........%%%.....%%%....................%%%%................%%%%%%%...........
m %%%%%%%.......%.%%%.....%%%%..%%%.%%....%..%.....%%%....%%%........%%%....%%%.....%..%....%%.%%%..%%%%.....%%%.%.......%%%%%%%..........
m .%%%%%%.....%%%%%%%.....%%%%%%%%%%%%.....%%......%%%.....%%%......%%%.....%%%......%%.....%%%%%%%%%%%%.....%%%%%%%.....%%%%%%.....%%....
m %%%%%%%.....%%%%%%%%....%%%%%%%%%%%%.....%%......%%......%%........%%......%%......%%.....%%%%%%%%%%%%....%%%%%%%%.....%%%%%%%....%%....
m .%.%...%....%...%%%.....%%%%%...%%%%....%%%%.....%%.....%%%........%%%.....%%.....%%%%....%%%%...%%%%%.....%%%...%....%...%.%.....%%....
m ........................%%%.....%%%.....%%%..............%%........%%..............%%%.....%%%.....%%%..................................
m ........................%%%......%%.....%%%%.............%%%......%%%.............%%%%.....%%......%%%............................%%....
m .........................%%.....%%%%....%%%.............%%%%......%%%%.............%%%....%%%%.....%%.............................%%....
m ........................%%%......%%....5%%%%............%%%........%%%............%%%%6....%%......%%%..................................
m .....%%%.....%%..%.......%%......%%%%%..%%%......%%..%%%%%%........%%%%%%..%%......%%%..%%%%%......%%.......%..%%.....%%%...............
m .....%%.....%%%%%%%......%%......%%%%%%%%%%.....%%%%%%%%%%%........%%%%%%%%%%%.....%%%%%%%%%%......%%......%%%%%%%.....%%...............
m ....%%%.....%%%%%%%.....%%%%....%%%%%%%%%%%......%%%%%%%%%%%......%%%%%%%%%%%......%%%%%%%%%%%....%%%%.....%%%%%%%.....%%%..............
m .....%%......%%%%%%%............%%......%%%%....%%%%%%....%%......%%....%%%%%%....%%%%......%%............%%%%%%%......%%...............
m ....%%%%.....%%%%%%......................%%%.....%%%......................%%%.....%%%......................%%%%%%.....%%%%..............
m ....%%%%....%%%%%%%......................%%%.....%%........................%%.....%%%......................%%%%%%%....%%%%.....%......%.
m ....%%%%.....%%%%%%%.....................%%%.....%%........................%%.....%%%.....................%%%%%%%.....%%%%....%%......%%
m ......%........%..%%....................%%%%....%%%%......................%%%%....%%%%....................%%..%........%......%%......%%
m ....................%......%.%%%%.%......%%%....%%%%......%........%......%%%%....%%%......%.%%%%.%......%.....................%......%.
m .....................%%%%%%%%%%%%%%%....%%%......%%.....%%%%......%%%%.....%%......%%%....%%%%%%%%%%%%%%%.....................%%......%%
m .....................%%%%%%%%%%%%%%.....%%%......%%......%%%......%%%......%%......%%%.....%%%%%%%%%%%%%%......................%......%.
m .....................%%%%%%%.%%.%%%.....%%%......%%%.....%%........%%.....%%%......%%%.....%%%.%%.%%%%%%%.....................%%......%%
m .%.%%%%%%%.%..%......%%%%%%..............%%..............%%........%%..............%%..............%%%%%%......%..%.%%%%%%%.%.%%......%%
m %%%%%%%%%%%%%%%......%%%%%%.............%%%.............%%%........%%%.............%%%.............%%%%%%......%%%%%%%%%%%%%%%%%......%%
m %%%%%%%%%%%%%%%......%%%%%%%............%%%%.......1....%%%........%%%....0.......%%%%............%%%%%%%......%%%%%%%%%%%%%%%%%......%%
m .%%%%%%%......%.....%%%%..%..............%%%............%%%%......%%%%............%%%..............%..%%%%.....%......%%%%%%%...........
m .....%%%.............%%.....%%%%.%.%....%%%%%.%%%%.......%%%......%%%.......%%%%.%%%%%....%.%.%%%%.....%%.............%%%...............
m .....%%.............%%%%....%%%%%%%.....%%%%%%%%%%%%.....%%........%%.....%%%%%%%%%%%%.....%%%%%%%....%%%%.............%%...............
m ....%%%.............%%%%....%%%%%%%%....%%%%%%%%%%%.....%%%%......%%%%.....%%%%%%%%%%%....%%%%%%%%....%%%%.............%%%..............
m ....%%%.............%%%.....%%%%%%%.....%..%..%%%........%%........%%........%%%..%..%.....%%%%%%%.....%%%.............%%%..............
m ....%%%%%.%...%%....%%%%.....%%%%%%......................%%%......%%%......................%%%%%%.....%%%%....%%...%.%%%%%......%....%..
m .....%%%%%%%%%%%.....%%%....%%%%%%%%....................%%%%......%%%%....................%%%%%%%%....%%%.....%%%%%%%%%%%.....%%%%%%%%%%
m ....%%%%%%%%%%%.....%%%%.....%%%%%%%.....................%%........%%.....................%%%%%%%.....%%%%.....%%%%%%%%%%%....%%%%%%%%%%
m ....%%%%..%.%%%......%......%.%..%%%....................%%%........%%%....................%%%..%.%......%......%%%.%..%%%%....%%......%%
m ............%%%......................................%%.....%%%%%%.....%%......................................%%%.............%......%.
m ............%%%......................................%%%.....%%%%.....%%%......................................%%%.............%......%.
m .............%%......................................%%......%%%%......%%......................................%%..............%......%.
m ...........3.%%.....................................%%%.....%%%%%%.....%%%.....................................%%.2...........%%......%%
m ....%..%%%%%%%%%...%.%%%.%%.%%%%........%%.%%%%%....%%%......%%%%......%%%....%%%%%.%%........%%%%.%%.%%%.%...%%%%%%%%%..%.....%......%.
m .....%%%%%%%%%%%%%%%%%%%%%%%%%%.........%%%%%%%%.....%%.....%%%%%%.....%%.....%%%%%%%%.........%%%%%%%%%%%%%%%%%%%%%%%%%%.....%%......%%
m .....%%%%%%%%%%%%%%%%%%%%%%%%%%..........%%%%%%%.....%%%....%%%%%%....%%%.....%%%%%%%..........%%%%%%%%%%%%%%%%%%%%%%%%%%......%......%.
m ....%..%.%.%...%%%%%%.....%%%%%%........%%%%%%%.....%.%%.....%%%%.....%%.%.....%%%%%%%........%%%%%%.....%%%%%%...%.%.%..%....%%......%%
m ............................%%%.........%%%%%%%%............%%%%%%............%%%%%%%%.........%%%......................................
m .............................%%.........%%%%%%%%............%%%%%%............%%%%%%%%.........%%.......................................
m ............................%%%%........%%%%%%%%............%%%%%%............%%%%%%%%........%%%%......................................
m ............................%%%%........%%%.%%%%.............%%%%.............%%%%.%%%........%%%%......................................
m .%%%.........%.%...%%.......%%%%................%%%..%%%....%%%%%%....%%%..%%%................%%%%.......%%...%.%.........%%%.%........%
m %%%%%%%%....%%%%%%%%%%%%....%%%.................%%%%%%%%.....%%%%.....%%%%%%%%.................%%%....%%%%%%%%%%%%....%%%%%%%%%%......%%
m %%%%%%%%....%%%%%%%%%%%%.....%%.................%%%%%%%%.....%%%%.....%%%%%%%%.................%%.....%%%%%%%%%%%%....%%%%%%%%%%......%%
m %...%%.......%%%%..%%..%..6..%...................%%%%%%%....%%%%%%....%%%%%%%...................%..5..%..%%..%%%%.......%%...%%%......%%
m .............%%%.......................%%..%.....%%%%%%%.....%%%%.....%%%%%%%.....%..%%.......................%%%.............%%......%%
m ............%%%%....................%%%%%%%.....%%%%%%%.....%%%%%%.....%%%%%%%.....%%%%%%%....................%%%%.............%......%.
m ............%%%.....................%%%%%%%%....%%%%%%%.....%%%%%%.....%%%%%%%....%%%%%%%%.....................%%%.............%......%.
m ............%%%......................%....%%....%%%%%.......%%%%%%.......%%%%%....%%....%......................%%%............%%......%%
m %%%%%..%..%%%%%......%...%%%..%..%.%....................%.%.%%%%%%.%.%....................%.%..%..%%%...%......%%%%%..%..%%%%%%%......%%
m %%%%%%%%%%%%%%%......%%%%%%%%%%%%%%%.....................%%%%%%%%%%%%.....................%%%%%%%%%%%%%%%......%%%%%%%%%%%%%%%%%......%%
m %%%%%%%%%%%%%%%%....%%%%%%%%%%%%%%%%....................%%%%%%%%%%%%%%....................%%%%%%%%%%%%%%%%....%%%%%%%%%%%%%%%%%%......%%
m ..%..%...%%...%%.....%%....%%.%.%%.......................%%%%%%%%%%%%.......................%%.%.%%....%%.....%%...%%...%..%............
m ....................................%..%.%%.%%%.%..%.%%%%%%%%%%%%%%%%%%%%.%..%.%%%.%%.%..%..............................................
m ....................................%%%%%%%%%%%%%%%%%%%%%%%%%%%%%%%%%%%%%%%%%%%%%%%%%%%%%%..............................................
m ....................................%%%%%%%%%%%%%%%%%%%%%%%%%%%%%%%%%%%%%%%%%%%%%%%%%%%%%%..............................................
m ....................................%%%%%%%%%%%%%%%%%%%%%%%%%%%%%%%%%%%%%%%%%%%%%%%%%%%%%%..............................................
m ....................................%%%%%%%%%%%%%%%%%%%%%%%%%%%%%%%%%%%%%%%%%%%%%%%%%%%%%%..............................................
m ....................................%..%.%%.%%%.%..%.%%%%%%%%%%%%%%%%%%%%.%..%.%%%.%%.%..%..............................................
m ..%..%...%%...%%.....%%....%%.%.%%.......................%%%%%%%%%%%%.......................%%.%.%%....%%.....%%...%%...%..%............
m %%%%%%%%%%%%%%%%....%%%%%%%%%%%%%%%%....................%%%%%%%%%%%%%%....................%%%%%%%%%%%%%%%%....%%%%%%%%%%%%%%%%%%......%%
m %%%%%%%%%%%%%%%......%%%%%%%%%%%%%%%.....................%%%%%%%%%%%%.....................%%%%%%%%%%%%%%%......%%%%%%%%%%%%%%%%%......%%
m %%%%%..%..%%%%%......%...%%%..%..%.%....................%.%.%%%%%%.%.%....................%.%..%..%%%...%......%%%%%..%..%%%%%%%......%%
m ............%%%......................%....%%....%%%%%.......%%%%%%.......%%%%%....%%....%......................%%%............%%......%%
m ............%%%.....................%%%%%%%%....%%%%%%%.....%%%%%%.....%%%%%%%....%%%%%%%%.....................%%%.............%......%.
m ............%%%%....................%%%%%%%.....%%%%%%%.....%%%%%%.....%%%%%%%.....%%%%%%%....................%%%%.............%......%.
m .............%%%.......................%%..%.....%%%%%%%.....%%%%.....%%%%%%%.....%..%%.......................%%%.............%%......%%
m %...%%.......%%%%..%%..%..4..%...................%%%%%%%....%%%%%%....%%%%%%%...................%..7..%..%%..%%%%.......%%...%%%......%%
m %%%%%%%%....%%%%%%%%%%%%.....%%.................%%%%%%%%.....%%%%.....%%%%%%%%.................%%.....%%%%%%%%%%%%....%%%%%%%%%%......%%
m %%%%%%%%....%%%%%%%%%%%%....%%%.................%%%%%%%%.....%%%%.....%%%%%%%%.................%%%....%%%%%%%%%%%%....%%%%%%%%%%......%%
m .%%%.........%.%...%%.......%%%%................%%%..%%%....%%%%%%....%%%..%%%................%%%%.......%%...%.%.........%%%.%........%
m ............................%%%%........%%%.%%%%.............%%%%.............%%%%.%%%........%%%%......................................
m ............................%%%%........%%%%%%%%............%%%%%%............%%%%%%%%........%%%%......................................
m .............................%%.........%%%%%%%%............%%%%%%............%%%%%%%%.........%%.......................................
m ............................%%%.........%%%%%%%%............%%%%%%............%%%%%%%%.........%%%......................................
m ....%..%.%.%...%%%%%%.....%%%%%%........%%%%%%%.....%.%%.....%%%%.....%%.%.....%%%%%%%........%%%%%%.....%%%%%%...%.%.%..%....%%......%%
m .....%%%%%%%%%%%%%%%%%%%%%%%%%%..........%%%%%%%.....%%%....%%%%%%....%%%.....%%%%%%%..........%%%%%%%%%%%%%%%%%%%%%%%%%%......%......%.
m .....%%%%%%%%%%%%%%%%%%%%%%%%%%.........%%%%%%%%.....%%.....%%%%%%.....%%.....%%%%%%%%.........%%%%%%%%%%%%%%%%%%%%%%%%%%.....%%......%%
m ....%..%%%%%%%%%...%.%%%.%%.%%%%........%%.%%%%%....%%%......%%%%......%%%....%%%%%.%%........%%%%.%%.%%%.%...%%%%%%%%%..%.....%......%.
m ...........1.%%.....................................%%%.....%%%%%%.....%%%.....................................%%.0...........%%......%%
m .............%%......................................%%......%%%%......%%......................................%%..............%......%.
m ............%%%......................................%%%.....%%%%.....%%%......................................%%%.............%......%.
m ............%%%......................................%%.....%%%%%%.....%%......................................%%%.............%......%.
m ....%%%%..%.%%%......%......%.%..%%%....................%%%........%%%....................%%%..%.%......%......%%%.%..%%%%....%%......%%
m ....%%%%%%%%%%%.....%%%%.....%%%%%%%.....................%%........%%.....................%%%%%%%.....%%%%.....%%%%%%%%%%%....%%%%%%%%%%
m .....%%%%%%%%%%%.....%%%....%%%%%%%%....................%%%%......%%%%....................%%%%%%%%....%%%.....%%%%%%%%%%%.....%%%%%%%%%%
m ....%%%%%.%...%%....%%%%.....%%%%%%......................%%%......%%%......................%%%%%%.....%%%%....%%...%.%%%%%......%....%..
m ....%%%.............%%%.....%%%%%%%.....%..%..%%%........%%........%%........%%%..%..%.....%%%%%%%.....%%%.............%%%..............
m ....%%%.............%%%%....%%%%%%%%....%%%%%%%%%%%.....%%%%......%%%%.....%%%%%%%%%%%....%%%%%%%%....%%%%.............%%%..............
m .....%%.............%%%%....%%%%%%%.....%%%%%%%%%%%%.....%%........%%.....%%%%%%%%%%%%.....%%%%%%%....%%%%.............%%...............
m .....%%%.............%%.....%%%%.%.%....%%%%%.%%%%.......%%%......%%%.......%%%%.%%%%%....%.%.%%%%.....%%.............%%%...............
m .%%%%%%%......%.....%%%%..%..............%%%............%%%%......%%%%............%%%..............%..%%%%.....%......%%%%%%%...........
