# map type: blank
# random seed: 1137165815
# hill distance  31, 14   5, 48
#        31, 14       0      60 
#         5, 48      60       0 
players 2
rows 52
cols 68
m %%%%%%%%%%%%%%....%%%..%.....................................%%%....
m %%%%%%%%%%%%%.....%%%%%%....................................%%%%%...
m %%%%%%%%%%%%%%....%%%%%%....................................%%%%....
m %%%%%%%%%%%%%%%.%.%%%%%%........%%......%%..................%%%%....
m .%%%%%%%%%%%%%%%%...%%%.................%...................%%......
m .%%%%%%%%%%%%%%%%%%.%%..................%%......0...%%..............
m ..%%%%%%%%%%%%%%%%%%%%...............%%%%%%%........%%..............
m ..%%%%%%%%%%%%%%%%%%%%%%%............%%%%%%%%.%%.....%.........%%...
m ..%%%......%%%%%%%%%%%%%%.......%%...%.%%%%%%.%%%....%.%%.....%%%...
m .%%%......%%%%%%%%%%%%%%%........%%....%%%%...%%........%.....%%....
m ..........%%..%%%%%%%%..................%%%...............%.........
m ...............%%%%%%....................%%..........%....%.........
m .....%%........%%%%%%..%......%.........%%...........%%.............
m ..................%%...%.....%%.........%%%..........%..............
m %%...................%%%%...%%....................................%%
m %.....%................%%.......................................%%%%
m %.....%................%%............%%..%%%.%%%................%%%%
m %%.%......%%............%%%...........%..%%%.%%%%%%%.........%%.%%%%
m %%%%....%%%%.............%%%..........%.%%%...%%%%%.....%%.....%%%%%
m %%%.....%%..............................%%%%.%%%%%%.............%%%%
m %%%.....%%.%..........................%%%%%%%%%%%%..............%%%%
m %%%........%...........................%%%%%%%...%.............%%%%%
m %.%......%%%%................%%.%...%%..%%%%.....%..............%%%%
m ..%.....%%%%%...................%......%%%%%.......%%..............%
m ..%....%%%%%%%.....................%%..%%%%%.......%%...............
m .........%%%.................%.....%..%%%%%%%%%....%%...............
m ...........................%%%....%%%%%%%%%%%%%%....%%%..%..........
m ..........................%%%%%...%%%%%%%%%%%%%.....%%%%%%..........
m ..........................%%%%....%%%%%%%%%%%%%%....%%%%%%..........
m ......%%..................%%%%....%%%%%%%%%%%%%%%.%.%%%%%%........%%
m ......%...................%%.......%%%%%%%%%%%%%%%%...%%%...........
m ......%%......1...%%...............%%%%%%%%%%%%%%%%%%.%%............
m ...%%%%%%%........%%................%%%%%%%%%%%%%%%%%%%%............
m ...%%%%%%%%.%%.....%.........%%.....%%%%%%%%%%%%%%%%%%%%%%%.........
m ...%.%%%%%%.%%%....%.%%.....%%%.....%%%......%%%%%%%%%%%%%%.......%%
m %....%%%%...%%........%.....%%.....%%%......%%%%%%%%%%%%%%%........%
m ......%%%...............%...................%%..%%%%%%%%............
m .......%%..........%....%........................%%%%%%.............
m ......%%...........%%..................%%........%%%%%%..%......%...
m ......%%%..........%................................%%...%.....%%...
m ................................%%%%...................%%%%...%%....
m ..............................%%%%%.....%................%%.........
m ...%%..%%%.%%%................%%%%%.....%................%%.........
m ....%..%%%.%%%%%%%.........%%.%%%%%%.%......%%............%%%.......
m ....%.%%%...%%%%%.....%%.....%%%%%%%%%....%%%%.............%%%......
m ......%%%%.%%%%%%.............%%%%%%%.....%%........................
m ....%%%%%%%%%%%%..............%%%%%%%.....%%.%......................
m .....%%%%%%%...%.............%%%%%%%%........%......................
m ..%%..%%%%.....%..............%%%%%.%......%%%%................%%.%.
m .....%%%%%.......%%..............%..%.....%%%%%...................%.
m .%%..%%%%%.......%%.................%....%%%%%%%....................
m .%..%%%%%%%%%....%%........................%%%.................%....
