# map type: blank
# random seed: -592451805
# hill distance   0, 33  72, 91 108,  4  36, 62
#         0, 33       0     130      65      65 
#        72, 91     130       0      65      65 
#       108,  4      65      65       0     130 
#        36, 62      65      65     130       0 
players 4
rows 144
cols 116
m .................................1.....%%.....%.....%...%%%%%........%%%............%%%..%%.........................
m ..............................................%%.....%..%%%%.....%%..%%%.........%%%%%%.....................%%%.....
m .......%.....................................%%%.....%..%%.......%%%..............%%%%%.....................%%......
m .......%..........%...........................%%%...%....%........%..%%............%%%%.%%%.........................
m ...........%.....%%......%..............%%%...%%%...%.......................%%......%%%.%%..........................
m ...........%%............%%.............%....%%%....%......................%%%..%...%%%.............................
m ........................%%%%%...........%....%%%............................%%%.%.....%%%...........................
m .......................%%%%.....%%.....%%....%%%%.......................................%%..............%%%.....%...
m ........................%.%.%%%%%%.....%%%%%..%%..%.....................................................%%%.....%...
m ..%%........................%%%%.%.......%%%%..%%%%..............................%.....................%%%......%...
m ..%%......................%%%%.............%...%.%%.............................%%....................%%........%%..
m ...%.........................................%%...%....................................................%............
m ..........................%................%%%%........%%...........................................................
m ..........................%%%%.............%%%%........%%...........................................................
m ..........................%%................%%........%%%%..................................................%.....%.
m ......................................................%%%%%%..%............................................%%..%%%%.
m ................................................%.....%%%%%%%%%................%...............................%%%..
m ................................................%%%.....%%%%%%%...............%%%...................................
m ................................................%%%..%%....%%.................%........%%...........................
m ..................................%......%%......%...%%.........................%%......%...........................
m ..................................%..%%..%%..%%%..%%.%%.....%%...................%......%........%%.................
m ..................................%%%%%......%%%%.%..%.......%.........................%%.......%...................
m ..................................%%%%%....%%%%%%..............................................%%%..................
m ...................................%%%....%%%%%%%................................................%..................
m ...................................%%......%%%%%%%%%%...............................................................
m .......%%..........................%%......%%%%%%%%%%.........................................................%%....
m ....................................%......%%.%%%%%...........................................................%%....
m ............................................%.......................................................................
m ........%%..........................%%%%.............................................%%.............................
m .........%.........................................................................%%%%%...................%........
m ...........................................%%%%......................................%....................%%........
m ..........................................%%..............................................................%%%.......
m ...........%..............................%%..............................................................%%%.......
m ...........%.%%%......................................................................%%..................%.........
m .%................................................................%.%............%....%%%..........%..............%%
m .%%%..............................................................%.%%...........%.%%%%%%%........%%%.............%%
m ..%%..........................................................2.....%%.....%.....%...%%%%%........%%%............%%%
m .....................%%%...................................................%%.....%..%%%%.....%%..%%%.........%%%%%%
m .....................%%.............%.....................................%%%.....%..%%.......%%%..............%%%%%
m .%%%................................%..........%...........................%%%...%....%........%..%%............%%%%
m .%%.....................................%.....%%......%..............%%%...%%%...%.......................%%......%%%
m ........................................%%............%%.............%....%%%....%......................%%%..%...%%%
m %%...................................................%%%%%...........%....%%%............................%%%.%.....%
m .%%..............%%%.....%..........................%%%%.....%%.....%%....%%%%......................................
m .................%%%.....%...........................%.%.%%%%%%.....%%%%%..%%..%....................................
m ................%%%......%.....%%........................%%%%.%.......%%%%..%%%%..............................%.....
m ...............%%........%%....%%......................%%%%.............%...%.%%.............................%%.....
m ................%...............%.........................................%%...%....................................
m .......................................................%................%%%%........%%..............................
m .......................................................%%%%.............%%%%........%%..............................
m .....................%.....%...........................%%................%%........%%%%.............................
m ....................%%..%%%%.......................................................%%%%%%..%........................
m ........................%%%..................................................%.....%%%%%%%%%................%.......
m .............................................................................%%%.....%%%%%%%...............%%%......
m %%...........................................................................%%%..%%....%%.................%........
m .%.............................................................%......%%......%...%%.........................%%.....
m .%........%%...................................................%..%%..%%..%%%..%%.%%.....%%...................%.....
m %%.......%.....................................................%%%%%......%%%%.%..%.......%.........................
m ........%%%....................................................%%%%%....%%%%%%......................................
m ..........%.....................................................%%%....%%%%%%%......................................
m ................................................................%%......%%%%%%%%%%..................................
m .......................%%...........%%..........................%%......%%%%%%%%%%..................................
m .......................%%........................................%......%%.%%%%%....................................
m .........................................................................%..........................................
m .....................................%%..........................%%%%.............................................%%
m %...................%.................%.........................................................................%%%%
m ...................%%...................................................%%%%......................................%.
m ...................%%%.................................................%%...........................................
m ...................%%%..................%..............................%%...........................................
m %..................%....................%.%%%......................................................................%
m %%..........%..............%%.%................................................................%.%............%....%
m %%%........%%%.............%%.%%%..............................................................%.%%...........%.%%%%
m %%%........%%%............%%%..%%..........................................................3.....%%.....%.....%...%%
m %%.....%%..%%%.........%%%%%%.....................%%%...................................................%%.....%..%%
m .......%%%..............%%%%%.....................%%.............%.....................................%%%.....%..%%
m ........%..%%............%%%%.%%%................................%..........%...........................%%%...%....%
m ..................%%......%%%.%%.....................................%.....%%......%..............%%%...%%%...%.....
m .................%%%..%...%%%........................................%%............%%.............%....%%%....%.....
m ..................%%%.%.....%%%...................................................%%%%%...........%....%%%..........
m ..............................%%..............%%%.....%..........................%%%%.....%%.....%%....%%%%.........
m ..............................................%%%.....%...........................%.%.%%%%%%.....%%%%%..%%..%.......
m .......................%.....................%%%......%.....%%........................%%%%.%.......%%%%..%%%%.......
m ......................%%....................%%........%%....%%......................%%%%.............%...%.%%.......
m .............................................%...............%.........................................%%...%.......
m ....................................................................................%................%%%%........%%.
m ....................................................................................%%%%.............%%%%........%%.
m ..................................................%.....%...........................%%................%%........%%%%
m %%..%............................................%%..%%%%.......................................................%%%%
m %%%%%................%...............................%%%..................................................%.....%%%%
m %%%%%...............%%%...................................................................................%%%.....%%
m .%%.................%........%%...........................................................................%%%..%%...
m ......................%%......%.............................................................%......%%......%...%%...
m ..%%...................%......%........%%...................................................%..%%..%%..%%%..%%.%%...
m ...%.........................%%.......%.....................................................%%%%%......%%%%.%..%....
m .....................................%%%....................................................%%%%%....%%%%%%.........
m .......................................%.....................................................%%%....%%%%%%%.........
m .............................................................................................%%......%%%%%%%%%%.....
m ....................................................%%...........%%..........................%%......%%%%%%%%%%.....
m ....................................................%%........................................%......%%.%%%%%.......
m ......................................................................................................%.............
m ...........................%%.....................................%%..........................%%%%..................
m .........................%%%%%...................%.................%................................................
m ...........................%....................%%...................................................%%%%...........
m ................................................%%%.................................................%%..............
m ................................................%%%..................%..............................%%..............
m ............................%%..................%....................%.%%%..........................................
m ........%.%............%....%%%..........%..............%%.%........................................................
m ........%.%%...........%.%%%%%%%........%%%.............%%.%%%......................................................
m ....0.....%%.....%.....%...%%%%%........%%%............%%%..%%......................................................
m .................%%.....%..%%%%.....%%..%%%.........%%%%%%.....................%%%..................................
m ................%%%.....%..%%.......%%%..............%%%%%.....................%%.............%.....................
m .................%%%...%....%........%..%%............%%%%.%%%................................%..........%..........
m ...........%%%...%%%...%.......................%%......%%%.%%.....................................%.....%%......%...
m ...........%....%%%....%......................%%%..%...%%%........................................%%............%%..
m ...........%....%%%............................%%%.%.....%%%...................................................%%%%%
m ...%%.....%%....%%%%.......................................%%..............%%%.....%..........................%%%%..
m %%%%%.....%%%%%..%%..%.....................................................%%%.....%...........................%.%.%
m %%%.%.......%%%%..%%%%..............................%.....................%%%......%.....%%........................%
m %.............%...%.%%.............................%%....................%%........%%....%%......................%%%
m ................%%...%....................................................%...............%.........................
m ..............%%%%........%%.....................................................................................%..
m %.............%%%%........%%.....................................................................................%%%
m ...............%%........%%%%..................................................%.....%...........................%%.
m .........................%%%%%%..%............................................%%..%%%%..............................
m ...................%.....%%%%%%%%%................%...............................%%%...............................
m ...................%%%.....%%%%%%%...............%%%................................................................
m ...................%%%..%%....%%.................%........%%........................................................
m .....%......%%......%...%%.........................%%......%........................................................
m .....%..%%..%%..%%%..%%.%%.....%%...................%......%........%%..............................................
m .....%%%%%......%%%%.%..%.......%.........................%%.......%................................................
m .....%%%%%....%%%%%%..............................................%%%...............................................
m ......%%%....%%%%%%%................................................%...............................................
m ......%%......%%%%%%%%%%............................................................................................
m ......%%......%%%%%%%%%%.........................................................%%...........%%....................
m .......%......%%.%%%%%...........................................................%%.................................
m ...............%....................................................................................................
m .......%%%%.............................................%%.....................................%%...................
m ......................................................%%%%%...................%.................%...................
m ..............%%%%......................................%....................%%.....................................
m .............%%..............................................................%%%....................................
m .............%%..............................................................%%%..................%.................
m .........................................................%%..................%....................%.%%%.............
m .....................................%.%............%....%%%..........%..............%%.%...........................
m .....................................%.%%...........%.%%%%%%%........%%%.............%%.%%%.........................
