# map type: blank
# random seed: -2093274227
# hill distance  16, 35  51, 76
#        16, 35       0      76 
#        51, 76      76       0 
players 2
rows 70
cols 82
m ......%%%%%...............................................................%%%%%...
m ......................%.....................................................%%%...
m .....%.%%..%%%........%.......................................%%.%..........%%%%..
m .....%.%%%.%...........%.....................................%%%.%%.........%%%...
m ........%..............%%%.......................................%%%........%%....
m ........%.............%%%%%%......................................%%.......%%%....
m ......................%%%%%%......................................%%..%%..........
m .......................%%%.....%%.................................%.%%%%..........
m .......................%%%...........................................%%%..........
m .........................%%%..........................................%...........
m ..........................%...........................................%...........
m ..................................................................................
m ..................................................................................
m ....................................................................%.............
m ...................................................................%%.............
m ...................................................................%%%%...........
m .%%.....%%..............%%.........0................................%%%...........
m .....................................................................%%%%.........
m ......%.............................................................%%%%%.........
m .....%%..............................................................%%%%.........
m .....................................................................%%%%.........
m .......................................................................%%.........
m ..................................................................................
m ....%....................%%.......................................................
m ...%%.....................%.......................................................
m .................%%................................%..............................
m ..............................%...........%.......%%..............................
m .............................%%...........%.......%...............................
m ........................%.%..........%....%%......................................
m .........%.............%%%%..........%%%..%%%.....................................
m .........%.............%%%%%%......%%%%%%...%%%..%................................
m ........................%..%.......%%%%%....%%%%%%%......%..........%.............
m ...........................%%.....%%%%%%.....%%%%%%......%%%....%...%%.%%%........
m ..................................%%%.%%....%%...%%%.....%%%%...%%%.%%%%%%%.......
m ................................%%%%........%...%%%%............%%%.%%%...........
m .................................%%%%%.........%%%%%..............................
m ...................................%%%.........................%..................
m .....................%%.%..........%%%%.......%.%%..%%%........%..................
m ....................%%%.%%.........%%%........%.%%%.%...........%.................
m ........................%%%........%%............%..............%%%...............
m .........................%%.......%%%............%.............%%%%%%.............
m .........................%%..%%................................%%%%%%.............
m .........................%.%%%%.................................%%%.....%%........
m ............................%%%.................................%%%...............
m .............................%....................................%%%.............
m .............................%.....................................%..............
m ..................................................................................
m ..................................................................................
m ...........................%......................................................
m ..........................%%......................................................
m ..........................%%%%....................................................
m ...........................%%%............%%.....%%..............%%.........1.....
m ............................%%%%..................................................
m ...........................%%%%%...............%..................................
m ............................%%%%..............%%..................................
m ............................%%%%..................................................
m ..............................%%..................................................
m ..................................................................................
m .............................................%....................%%..............
m ............................................%%.....................%..............
m ..........%...............................................%%......................
m .%.......%%............................................................%..........
m .%.......%............................................................%%..........
m .%%..............................................................%.%..........%...
m .%%%..............................................%.............%%%%..........%%%.
m ...%%%..%.........................................%.............%%%%%%......%%%%%%
m ...%%%%%%%......%..........%.....................................%..%.......%%%%%.
m ....%%%%%%......%%%....%...%%.%%%...................................%%.....%%%%%%.
m ...%%...%%%.....%%%%...%%%.%%%%%%%.........................................%%%.%%.
m ...%...%%%%............%%%.%%%...........................................%%%%.....
