# map type: blank
# random seed: 761589943
# hill distance  29, 49  63, 34  46, 94  97, 19 114, 64  12,  4  80, 79
#        29, 49       0      51      62      85      51      62      85 
#        63, 34      51       0      62      51      85      85      62 
#        46, 94      62      62       0      85      85      51      51 
#        97, 19      85      51      85       0      62      51      62 
#       114, 64      51      85      85      62       0      62      51 
#        12,  4      62      85      51      51      62       0      85 
#        80, 79      85      62      51      62      51      85       0 
players 7
rows 119
cols 105
m %.........%%%%%%%%%%%%%%..%%..%..........................................................................
m ..........%%%%%%%%%%%%%%............%%............................................................%......
m ...........%%%%%%%%%%%%.......%.....%%............................................................%......
m ............%%%%%%%%%%.....%%.%%...%%%%.............................................................%....
m ............%..%....%%%.......%%%%%%%%.............................................................%%....
m .%%...............%.%.%.......%%%%.............................................................%%...%%...
m ....%%.........%%%%...%..................................................%%....................%.........
m ....%.........%%%%%...%........................................................%%%................%..%%..
m ...%%........%%%%..........................................................%...%%%...............%%%%%%..
m ...%%%%...%%%%.%%........................%.%..........%....%%..............%...%%%...............%%%%....
m .%%%%......%%....................%%...%..%.%%.........%....%%%........%%%%....%%%%%.................%....
m ............%....%%................%%%%%%%%%%%%.....%%%...%%%%......%%%%%%....%%%%%..............%%......
m ....4...............................%%%%%%%..........%%%%%%%%%%%....%%%%.........%%%.............%%%.....
m .......................................%....%%%%%%...%%%%%%%%%%%...%%%%%.........%%.%%...................
m ............................................%%%%%%...%%%%%%%%%%....%%%%%.%%%......%......................
m ...........................................%%%%%%%...%%%%%%%%%%%%.%%%%%%..%%.............................
m ............................................%%%%%......%%%%%%%%%%%%%%%%%%.%%...%%........................
m .............................................%.........%%%%%%%%%%%%%%..%%..%.............................
m ......................................%................%%%%%%%%%%%%%%............%%......................
m ......................................%.................%%%%%%%%%%%%.......%.....%%......................
m ........................................%................%%%%%%%%%%.....%%.%%...%%%%.....................
m .......................................%%................%..%....%%%.......%%%%%%%%......................
m ...................................%%...%%....%%...............%.%.%.......%%%%..........................
m .............%%....................%.............%%.........%%%%...%.....................................
m ...................%%%................%..%%......%.........%%%%%...%.....................................
m ...............%...%%%...............%%%%%%.....%%........%%%%...........................................
m %..............%...%%%...............%%%%.......%%%%...%%%%.%%........................%.%..........%....%
m %%........%%%%....%%%%%.................%.....%%%%......%%....................%%...%..%.%%.........%....%
m %%......%%%%%%....%%%%%..............%%..................%....%%................%%%%%%%%%%%%.....%%%...%%
m %%%%....%%%%.........%%%.............%%%.........3...............................%%%%%%%..........%%%%%%%
m %%%%...%%%%%.........%%.%%..........................................................%....%%%%%%...%%%%%%%
m %%%....%%%%%.%%%......%..................................................................%%%%%%...%%%%%%%
m %%%%%.%%%%%%..%%........................................................................%%%%%%%...%%%%%%%
m %%%%%%%%%%%%%.%%...%%....................................................................%%%%%......%%%%%
m %%%%%%%%%..%%..%..........................................................................%.........%%%%%
m %%%%%%%%%............%%............................................................%................%%%%%
m %%%%%%%%.......%.....%%............................................................%.................%%%%
m %%%%%%%.....%%.%%...%%%%.............................................................%................%%%
m %....%%%.......%%%%%%%%.............................................................%%................%..
m ...%.%.%.......%%%%.............................................................%%...%%....%%............
m %%%%...%..................................................%%....................%.............%%.........
m %%%%...%........................................................%%%................%..%%......%.........%
m %%..........................................................%...%%%...............%%%%%%.....%%........%%
m %%........................%.%..........%....%%..............%...%%%...............%%%%.......%%%%...%%%%.
m ..................%%...%..%.%%.........%....%%%........%%%%....%%%%%.................%.....%%%%......%%..
m ..%%................%%%%%%%%%%%%.....%%%...%%%%......%%%%%%....%%%%%..............%%..................%..
m .....................%%%%%%%..........%%%%%%%%%%%....%%%%.........%%%.............%%%.........2..........
m ........................%....%%%%%%...%%%%%%%%%%%...%%%%%.........%%.%%..................................
m .............................%%%%%%...%%%%%%%%%%....%%%%%.%%%......%.....................................
m ............................%%%%%%%...%%%%%%%%%%%%.%%%%%%..%%............................................
m .............................%%%%%......%%%%%%%%%%%%%%%%%%.%%...%%.......................................
m ..............................%.........%%%%%%%%%%%%%%..%%..%............................................
m .......................%................%%%%%%%%%%%%%%............%%.....................................
m .......................%.................%%%%%%%%%%%%.......%.....%%.....................................
m .........................%................%%%%%%%%%%.....%%.%%...%%%%....................................
m ........................%%................%..%....%%%.......%%%%%%%%.....................................
m ....................%%...%%....%%...............%.%.%.......%%%%.........................................
m ....................%.............%%.........%%%%...%..................................................%%
m ....%%%................%..%%......%.........%%%%%...%....................................................
m %...%%%...............%%%%%%.....%%........%%%%..........................................................
m %...%%%...............%%%%.......%%%%...%%%%.%%........................%.%..........%....%%..............
m ...%%%%%.................%.....%%%%......%%....................%%...%..%.%%.........%....%%%........%%%%.
m ...%%%%%..............%%..................%....%%................%%%%%%%%%%%%.....%%%...%%%%......%%%%%%.
m ......%%%.............%%%.........1...............................%%%%%%%..........%%%%%%%%%%%....%%%%...
m ......%%.%%..........................................................%....%%%%%%...%%%%%%%%%%%...%%%%%...
m %......%..................................................................%%%%%%...%%%%%%%%%%....%%%%%.%%
m %........................................................................%%%%%%%...%%%%%%%%%%%%.%%%%%%..%
m %...%%....................................................................%%%%%......%%%%%%%%%%%%%%%%%%.%
m %..........................................................................%.........%%%%%%%%%%%%%%..%%..
m ......%%............................................................%................%%%%%%%%%%%%%%......
m %.....%%............................................................%.................%%%%%%%%%%%%.......
m %%...%%%%.............................................................%................%%%%%%%%%%.....%%.
m %%%%%%%%.............................................................%%................%..%....%%%.......
m %%%%.............................................................%%...%%....%%...............%.%.%.......
m ...........................................%%....................%.............%%.........%%%%...%.......
m .................................................%%%................%..%%......%.........%%%%%...%.......
m .............................................%...%%%...............%%%%%%.....%%........%%%%.............
m ...........%.%..........%....%%..............%...%%%...............%%%%.......%%%%...%%%%.%%.............
m ...%%...%..%.%%.........%....%%%........%%%%....%%%%%.................%.....%%%%......%%.................
m .....%%%%%%%%%%%%.....%%%...%%%%......%%%%%%....%%%%%..............%%..................%....%%...........
m ......%%%%%%%..........%%%%%%%%%%%....%%%%.........%%%.............%%%.........0.........................
m .........%....%%%%%%...%%%%%%%%%%%...%%%%%.........%%.%%.................................................
m ..............%%%%%%...%%%%%%%%%%....%%%%%.%%%......%....................................................
m .............%%%%%%%...%%%%%%%%%%%%.%%%%%%..%%...........................................................
m ..............%%%%%......%%%%%%%%%%%%%%%%%%.%%...%%......................................................
m ...............%.........%%%%%%%%%%%%%%..%%..%...........................................................
m ........%................%%%%%%%%%%%%%%............%%....................................................
m ........%.................%%%%%%%%%%%%.......%.....%%....................................................
m ..........%................%%%%%%%%%%.....%%.%%...%%%%...................................................
m .........%%................%..%....%%%.......%%%%%%%%....................................................
m .....%%...%%....%%...............%.%.%.......%%%%........................................................
m .....%.............%%.........%%%%...%..................................................%%...............
m ........%..%%......%.........%%%%%...%........................................................%%%........
m .......%%%%%%.....%%........%%%%..........................................................%...%%%........
m .......%%%%.......%%%%...%%%%.%%........................%.%..........%....%%..............%...%%%........
m ..........%.....%%%%......%%....................%%...%..%.%%.........%....%%%........%%%%....%%%%%.......
m .......%%..................%....%%................%%%%%%%%%%%%.....%%%...%%%%......%%%%%%....%%%%%.......
m .......%%%.........6...............................%%%%%%%..........%%%%%%%%%%%....%%%%.........%%%......
m ......................................................%....%%%%%%...%%%%%%%%%%%...%%%%%.........%%.%%....
m ...........................................................%%%%%%...%%%%%%%%%%....%%%%%.%%%......%.......
m ..........................................................%%%%%%%...%%%%%%%%%%%%.%%%%%%..%%..............
m ...........................................................%%%%%......%%%%%%%%%%%%%%%%%%.%%...%%.........
m ............................................................%.........%%%%%%%%%%%%%%..%%..%..............
m .....................................................%................%%%%%%%%%%%%%%............%%.......
m .....................................................%.................%%%%%%%%%%%%.......%.....%%.......
m .......................................................%................%%%%%%%%%%.....%%.%%...%%%%......
m ......................................................%%................%..%....%%%.......%%%%%%%%.......
m ..................................................%%...%%....%%...............%.%.%.......%%%%...........
m ............................%%....................%.............%%.........%%%%...%......................
m ..................................%%%................%..%%......%.........%%%%%...%......................
m ..............................%...%%%...............%%%%%%.....%%........%%%%............................
m .........%....%%..............%...%%%...............%%%%.......%%%%...%%%%.%%........................%.%.
m .........%....%%%........%%%%....%%%%%.................%.....%%%%......%%....................%%...%..%.%%
m %%.....%%%...%%%%......%%%%%%....%%%%%..............%%..................%....%%................%%%%%%%%%%
m ........%%%%%%%%%%%....%%%%.........%%%.............%%%.........5...............................%%%%%%%..
m %%%%%...%%%%%%%%%%%...%%%%%.........%%.%%..........................................................%....%
m %%%%%...%%%%%%%%%%....%%%%%.%%%......%..................................................................%
m %%%%%...%%%%%%%%%%%%.%%%%%%..%%........................................................................%%
m %%%%......%%%%%%%%%%%%%%%%%%.%%...%%....................................................................%
