# map type: blank
# random seed: -1203126772
# hill distance   4, 15  37,109  70, 62
#         4, 15       0      80      80 
#        37,109      80       0      80 
#        70, 62      80      80       0 
players 3
rows 99
cols 141
m .......................%....%...%%%%%%............................................%%%%%......................................................
m ....%%......................%...%%%%%%............................................%%.........................................................
m ................%....%%..%......%%%%%%%......................................................%%.%............................................
m ................%....%%%%%........%%%.......................................................%%%.%............................................
m ...............2%.....%%%%%..................................%...........%....................%..............................................
m ......................%%%%%%.................................%...........%..%%...............................................................
m .................%.%%........................................%.............%%%%..........................................................%...
m ....%%%........%%%.%......................................................%%%%...........................................................%%..
m ...%%%..%........%.........%..............................................%%%%............................................................%..
m .......%%%%.......%........%.............................................%%%%.........%...............................%%.....................
m ........%%%....%%.%........%.............................................%%%..........%%........%%..........%................................
m ...%....%%.....%%.%.......%%..............................................%..........%%%%%....%%%%%%.......%%................................
m %%%%....%%........%.......%..........................................................%%%%....%%%%%%%................%%%.................%%...
m .%%%%.................%...%........................................%%.................%%%%%..%.......................%%.................%%%..
m .%%%%%...............%%...%.........................................%................%%%%%..%.........................%%...............%%%%%.
m .%%%..%%%................%%................................%.......................%%%......%..........................%......%........%..%%%
m .%.....%%..................................................%.......................%.....................................%....%..............
m %%.....................................................................................%%................................%%%.%%%%.........%..
m %%%%%................................................................................%%%...........................%%.....%%%%%%%.........%%%
m %%%%%................................................................................%%............................%%%.......%%%%%........%%%
m %%%%%%...............................................................................%%.............................%..........%%%..........%
m .%..%%%%....................%..............................................................................................%%..%.............
m ....%%.....................%%.....%%%%................................................................................%..%%%%...............%
m %%%..............................%%%%%%...............................................................................%%%%%%........%.......%
m %%%...............................%%%%%%%...............................................................................%%%.......%%%........
m .....%..........................%.%%%%%%........................%%.......%........................................................%%%........
m ...%%%........................%%%%%%%%%%.........................%.......%%...................................................%%.%%%%........
m ....%%.........%................%%%%%%%%..................................%............................................%%........%%%%........
m ....%..........%..................%%%%%%.....%%...........................%..........................................%%%%%....%%%%%%%%.......
m .................................%%%%%%.......%.....................................................................%%%.%......%%%%%%%.......
m ...................................%%%%%%%%................................................................................%....%%%%%%.......
m ...................................%%%%%%...............................................%.................................%%%%...............
m .............%%....................%%%%%%.....%%........................................%............................%....%%%%..%%%..........
m ...................................%%%%%.............................................................................%....%...%%%%%%.........
m ...................................%%.............................................................%%......................%...%%%%%%.........
m ..............................................%%.%............................................................%....%%..%......%%%%%%%........
m .............................................%%%.%............................................................%....%%%%%........%%%..........
m ..............%...........%....................%.............................................................0%.....%%%%%....................
m ..............%...........%..%%.....................................................................................%%%%%%...................
m ..............%.............%%%%..........................................................%....................%.%%..........................
m ...........................%%%%...........................................................%%......%%%........%%%.%...........................
m ...........................%%%%............................................................%.....%%%..%........%.........%...................
m ..........................%%%%.........%...............................%%............................%%%%.......%........%...................
m ..........................%%%..........%%........%%..........%........................................%%%....%%.%........%...................
m ...........................%..........%%%%%....%%%%%%.......%%...................................%....%%.....%%.%.......%%...................
m ......................................%%%%....%%%%%%%................%%%.................%%...%%%%....%%........%.......%....................
m ....................%%.................%%%%%..%.......................%%.................%%%...%%%%.................%...%....................
m .....................%................%%%%%..%.........................%%...............%%%%%..%%%%%...............%%...%....................
m ............%.......................%%%......%..........................%......%........%..%%%.%%%..%%%................%%....................
m ............%.......................%.....................................%....%...............%.....%%......................................
m ........................................%%................................%%%.%%%%.........%..%%.............................................
m ......................................%%%...........................%%.....%%%%%%%.........%%%%%%%%..........................................
m ......................................%%............................%%%.......%%%%%........%%%%%%%%..........................................
m ......................................%%.............................%..........%%%..........%%%%%%%.........................................
m ............................................................................%%..%..............%..%%%%....................%..................
m .......................................................................%..%%%%...............%....%%.....................%%.....%%%%.........
m .......................................................................%%%%%%........%.......%%%%..............................%%%%%%........
m .........................................................................%%%.......%%%........%%%...............................%%%%%%%......
m .................%%.......%........................................................%%%.............%..........................%.%%%%%%.......
m ..................%.......%%...................................................%%.%%%%...........%%%........................%%%%%%%%%%.......
m ...........................%............................................%%........%%%%............%%.........%................%%%%%%%%.......
m ...........................%..........................................%%%%%....%%%%%%%%...........%..........%..................%%%%%%.....%%
m .....................................................................%%%.%......%%%%%%%........................................%%%%%%.......%
m ............................................................................%....%%%%%%..........................................%%%%%%%%....
m .........................................%.................................%%%%..................................................%%%%%%......
m %........................................%............................%....%%%%..%%%.......................%%....................%%%%%%.....%
m ......................................................................%....%...%%%%%%............................................%%%%%.......
m ...................................................%%......................%...%%%%%%............................................%%..........
m %.%............................................................%....%%..%......%%%%%%%......................................................%
m %.%............................................................%....%%%%%........%%%.......................................................%%
m %.............................................................1%.....%%%%%..................................%...........%....................
m .....................................................................%%%%%%.................................%...........%..%%................
m ...........................................%....................%.%%........................................%.............%%%%...............
m ...........................................%%......%%%........%%%.%......................................................%%%%................
m ............................................%.....%%%..%........%.........%..............................................%%%%................
m ........................%%............................%%%%.......%........%.............................................%%%%.........%.......
m ..%%..........%........................................%%%....%%.%........%.............................................%%%..........%%......
m %%%%%%.......%%...................................%....%%.....%%.%.......%%..............................................%..........%%%%%....
m %%%%%%................%%%.................%%...%%%%....%%........%.......%..........................................................%%%%....%
m .......................%%.................%%%...%%%%.................%...%........................................%%.................%%%%%..%
m ........................%%...............%%%%%..%%%%%...............%%...%.........................................%................%%%%%..%.
m .........................%......%........%..%%%.%%%..%%%................%%................................%.......................%%%......%.
m ...........................%....%...............%.....%%..................................................%.......................%..........
m ...........................%%%.%%%%.........%..%%.....................................................................................%%.....
m .....................%%.....%%%%%%%.........%%%%%%%%................................................................................%%%......
m .....................%%%.......%%%%%........%%%%%%%%................................................................................%%.......
m ......................%..........%%%..........%%%%%%%...............................................................................%%.......
m .............................%%..%..............%..%%%%....................%.................................................................
m ........................%..%%%%...............%....%%.....................%%.....%%%%........................................................
m ........................%%%%%%........%.......%%%%..............................%%%%%%.......................................................
m ..........................%%%.......%%%........%%%...............................%%%%%%%.....................................................
m ....................................%%%.............%..........................%.%%%%%%........................%%.......%....................
m ................................%%.%%%%...........%%%........................%%%%%%%%%%.........................%.......%%...................
m .........................%%........%%%%............%%.........%................%%%%%%%%..................................%...................
m .......................%%%%%....%%%%%%%%...........%..........%..................%%%%%%.....%%...........................%...................
m ......................%%%.%......%%%%%%%........................................%%%%%%.......%...............................................
m .............................%....%%%%%%..........................................%%%%%%%%...................................................
m ............................%%%%..................................................%%%%%%...............................................%.....
m .......................%....%%%%..%%%.......................%%....................%%%%%%.....%%........................................%.....
