# map type: blank
# random seed: 2030014090
# hill distance  15, 14  52, 55  89, 96
#        15, 14       0      78      78 
#        52, 55      78       0      78 
#        89, 96      78      78       0 
players 3
rows 111
cols 123
m .%%%%..........................................................%%%%...%%%%%%.%%%%%%%%%.......%.%%.................%....%...
m .%..%.........................................................%%%%.....%%%%%.%%%%%%%%%%%....%%%%.........%.%...............
m ........%%%%.....................%%%.........................%%%%%.....%%.%..%%%%%%%%%.%%%...%%%........%%%%%..............
m ........%%%.........%%%%%%.......%.................%...%....%%%%%%..........%%%%%%%%.....%%.............%%%%%......%%......
m ........%%%%.%%......%%%......%%%%...............%%%..%%%.....%.%%.%%%.....%%...%........%%..%%........%%%%%%%...%.%....%%.
m ..........%..%...........%%%...%%................%%...%%%........%.%%%%%%%%.%.............%.............%%%%%%...%.%.....%%
m %........................%%%%..%......................%%%%%.........%%%%%%................%.............%%%%%%...%.%.....%%
m ........................%%%%%%%%%%%%%%.....%%%......%%%%%...........%%%%%.................................%.........%%%%%%.
m ........................%%%..%%%%%%%%%.....%%%........%%...........%%%%%%%................................%.........%%%%%..
m ..........................%.......%%......%%%........................%%%%%%.......................................%%%%%%%%.
m ..........................%%......%..................%.................%..%.....................%%................%%%%%%%%.
m %.........%%..............%..........................%%.........%....%%%.......................%%%.................%%%%%%%%
m %.........................%.............%%%%%%..............%%..%.....%%.....................%%%%%%...............%%%%%%%%%
m ......................................%%%%%%%%..............%%%.......%.....................%%%%%.................%%.%%%%%%
m ......................................%%%%%%%%....%.%%....%%%%%%%.....%.%...................%%%%%.......................%%%
m ..............2........................%%%%%%%...%%.%%....%%%%%.........%..........%%.......%%%%%........................%.
m .....%.%%..............................%%%%%%%.%%.%........%%%..............%.................%%........................%%%
m ....%%....%%%.%........%%%%............%%%%%%%....%%%.......%%............%.%..........................%......%.........%..
m ..........%%%%%%.......%%%%%%%.........%%%%%%%...............%%...........%.%%.................%.......%......%.........%..
m .........%%%%.%%....%%%%%%%%.............%%%%.................%%...............................%.......%................%..
m ..%%%..%.%%%.........%%%%................%%%%.................................................%%.....%%.................%%.
m ..%%...%.%%.........%%%%%%%...........%%....%................%.............................%%%%%.%%%..................%%%%.
m .........%...........%%%%%%..................................%..............................%%%%%%%..................%%%%%.
m ........%%%..........%%%%%%...............................................%...%%..........%%%%%%%%%....%..%.............%..
m .....................%%%%................................%%%..............%%..%%%.....%%.%%%%%%%%%%..%.%..%................
m .......%%.......%..%%%%.............%.........%%%........%%%..........%.%.%%..%%.......%%%%%%%%%%%%%%%.....................
m ......%%%%......%%%%%%..............%..%%....%%%..........%..........%%.%%%%.............%%%%%%%%%%%%%.....%...............
m %..%...%%%......%%%%%%...............%%%%%...%%%........................%%%%............%%%%%%%%%%%%%....%%%...............
m %%%%...%%........%%%%................%%%%%%..%%.........................%%..............%%%%%%%%%%%%%%%%%%...%..%%%........
m %%%.....%%..........%.......%.......%%%%%%%%.%%.........................................%%%%%%%%%%%%%%%%%....%...%%..%%....
m .........%%.................%%........%%%%%%.%...........................................%%%%%%%%%%%%%%%%...............%%.
m ..........%................%........%%%%%%%%%%...............................%%...........%%%%%%%%%%%%%.................%%%
m ..........%%...............%%.........%%%%%%%%...............................%............%%%%%%%%%%%%%....................
m %%.......%%%..............%%.........%%%%%%%%%.......%......................................%%%%%%%%%%%....................
m %%.%.....%................%%.........%%%%%%%%........%%......................................%%%%%%%%%.................%%%%
m %%%%%.........%%.........%%%%%..%%..%%%%%%%%%.....................%..%%......................%%%%%%%%.%%..............%%%%%
m %%%%%...........................%...%%%%%%%%%.....................%..............................%.........%.....%.....%%%%
m %%%%.......%.%%.................%....%....%%%%..........................................................%%%%...%%%%%%.%%%%%
m %%%%%%....%%%%.........%.%................%..%.........................................................%%%%.....%%%%%.%%%%%
m %%%%.%%%...%%%........%%%%%......................%%%%.....................%%%.........................%%%%%.....%%.%..%%%%%
m %%.....%%.............%%%%%......%%..............%%%.........%%%%%%.......%.................%...%....%%%%%%..........%%%%%%
m .......%%..%%........%%%%%%%...%.%....%%.........%%%%.%%......%%%......%%%%...............%%%..%%%.....%.%%.%%%.....%%...%.
m ........%.............%%%%%%...%.%.....%%..........%..%...........%%%...%%................%%...%%%........%.%%%%%%%%.%.....
m ........%.............%%%%%%...%.%.....%%%........................%%%%..%......................%%%%%.........%%%%%%........
m ........................%.........%%%%%%.........................%%%%%%%%%%%%%%.....%%%......%%%%%...........%%%%%.........
m ........................%.........%%%%%..........................%%%..%%%%%%%%%.....%%%........%%...........%%%%%%%........
m ................................%%%%%%%%...........................%.......%%......%%%........................%%%%%%.......
m ..............%%................%%%%%%%%...........................%%......%..................%.................%..%.......
m .............%%%.................%%%%%%%%%.........%%..............%..........................%%.........%....%%%..........
m ...........%%%%%%...............%%%%%%%%%%.........................%.............%%%%%%..............%%..%.....%%..........
m ..........%%%%%.................%%.%%%%%%......................................%%%%%%%%..............%%%.......%...........
m ..........%%%%%.......................%%%......................................%%%%%%%%....%.%%....%%%%%%%.....%.%.........
m .%%.......%%%%%........................%...............0........................%%%%%%%...%%.%%....%%%%%.........%.........
m ............%%........................%%%.....%.%%..............................%%%%%%%.%%.%........%%%..............%.....
m .....................%......%.........%......%%....%%%.%........%%%%............%%%%%%%....%%%.......%%............%.%.....
m .............%.......%......%.........%............%%%%%%.......%%%%%%%.........%%%%%%%...............%%...........%.%%....
m .............%.......%................%...........%%%%.%%....%%%%%%%%.............%%%%.................%%..................
m ............%%.....%%.................%%...%%%..%.%%%.........%%%%................%%%%.....................................
m .........%%%%%.%%%..................%%%%...%%...%.%%.........%%%%%%%...........%%....%................%....................
m ..........%%%%%%%..................%%%%%..........%...........%%%%%%..................................%....................
m ........%%%%%%%%%....%..%.............%..........%%%..........%%%%%%...............................................%...%%..
m ....%%.%%%%%%%%%%..%.%..%.....................................%%%%................................%%%..............%%..%%%.
m .....%%%%%%%%%%%%%%%............................%%.......%..%%%%.............%.........%%%........%%%..........%.%.%%..%%..
m .......%%%%%%%%%%%%%.....%.....................%%%%......%%%%%%..............%..%%....%%%..........%..........%%.%%%%......
m ......%%%%%%%%%%%%%....%%%...............%..%...%%%......%%%%%%...............%%%%%...%%%........................%%%%......
m ......%%%%%%%%%%%%%%%%%%...%..%%%........%%%%...%%........%%%%................%%%%%%..%%.........................%%........
m ......%%%%%%%%%%%%%%%%%....%...%%..%%....%%%.....%%..........%.......%.......%%%%%%%%.%%...................................
m .......%%%%%%%%%%%%%%%%...............%%..........%%.................%%........%%%%%%.%....................................
m ........%%%%%%%%%%%%%.................%%%..........%................%........%%%%%%%%%%...............................%%...
m ........%%%%%%%%%%%%%..............................%%...............%%.........%%%%%%%%...............................%....
m ..........%%%%%%%%%%%....................%%.......%%%..............%%.........%%%%%%%%%.......%............................
m ...........%%%%%%%%%.................%%%%%%.%.....%................%%.........%%%%%%%%........%%...........................
m ...........%%%%%%%%.%%..............%%%%%%%%%%.........%%.........%%%%%..%%..%%%%%%%%%.....................%..%%...........
m ...............%.........%.....%.....%%%%%%%%%...........................%...%%%%%%%%%.....................%...............
m ......................%%%%...%%%%%%.%%%%%%%%%.......%.%%.................%....%....%%%%....................................
m .....................%%%%.....%%%%%.%%%%%%%%%%%....%%%%.........%.%................%..%....................................
m ....................%%%%%.....%%.%..%%%%%%%%%.%%%...%%%........%%%%%......................%%%%.....................%%%.....
m ..........%...%....%%%%%%..........%%%%%%%%.....%%.............%%%%%......%%..............%%%.........%%%%%%.......%.......
m ........%%%..%%%.....%.%%.%%%.....%%...%........%%..%%........%%%%%%%...%.%....%%.........%%%%.%%......%%%......%%%%.......
m ........%%...%%%........%.%%%%%%%%.%.............%.............%%%%%%...%.%.....%%..........%..%...........%%%...%%........
m .............%%%%%.........%%%%%%................%.............%%%%%%...%.%.....%%%........................%%%%..%.........
m ..%%%......%%%%%...........%%%%%.................................%.........%%%%%%.........................%%%%%%%%%%%%%%...
m ..%%%........%%...........%%%%%%%................................%.........%%%%%..........................%%%..%%%%%%%%%...
m .%%%........................%%%%%%.......................................%%%%%%%%...........................%.......%%.....
m ............%.................%..%.....................%%................%%%%%%%%...........................%%......%......
m ............%%.........%....%%%.......................%%%.................%%%%%%%%%.........%%..............%..............
m %%%%%..............%%..%.....%%.....................%%%%%%...............%%%%%%%%%%.........................%.............%
m %%%%%..............%%%.......%.....................%%%%%.................%%.%%%%%%......................................%%%
m %%%%%....%.%%....%%%%%%%.....%.%...................%%%%%.......................%%%......................................%%%
m %%%%%...%%.%%....%%%%%.........%..........%%.......%%%%%........................%...............1........................%%
m %%%%%.%%.%........%%%..............%.................%%........................%%%.....%.%%..............................%%
m %%%%%....%%%.......%%............%.%..........................%......%.........%......%%....%%%.%........%%%%............%%
m %%%%%...............%%...........%.%%.................%.......%......%.........%............%%%%%%.......%%%%%%%.........%%
m %%%%.................%%...............................%.......%................%...........%%%%.%%....%%%%%%%%.............
m %%%%.................................................%%.....%%.................%%...%%%..%.%%%.........%%%%................
m ...%................%.............................%%%%%.%%%..................%%%%...%%...%.%%.........%%%%%%%...........%%.
m ....................%..............................%%%%%%%..................%%%%%..........%...........%%%%%%..............
m .................................%...%%..........%%%%%%%%%....%..%.............%..........%%%..........%%%%%%..............
m ................%%%..............%%..%%%.....%%.%%%%%%%%%%..%.%..%.....................................%%%%................
m .....%%%........%%%..........%.%.%%..%%.......%%%%%%%%%%%%%%%............................%%.......%..%%%%.............%....
m ....%%%..........%..........%%.%%%%.............%%%%%%%%%%%%%.....%.....................%%%%......%%%%%%..............%..%%
m %...%%%........................%%%%............%%%%%%%%%%%%%....%%%...............%..%...%%%......%%%%%%...............%%%%
m %%..%%.........................%%..............%%%%%%%%%%%%%%%%%%...%..%%%........%%%%...%%........%%%%................%%%%
m %%%.%%.........................................%%%%%%%%%%%%%%%%%....%...%%..%%....%%%.....%%..........%.......%.......%%%%%
m %%%.%...........................................%%%%%%%%%%%%%%%%...............%%..........%%.................%%........%%%
m %%%%%...............................%%...........%%%%%%%%%%%%%.................%%%..........%................%........%%%%%
m %%%%%...............................%............%%%%%%%%%%%%%..............................%%...............%%.........%%%
m %%%%%.......%......................................%%%%%%%%%%%....................%%.......%%%..............%%.........%%%%
m %%%%........%%......................................%%%%%%%%%.................%%%%%%.%.....%................%%.........%%%%
m %%%%.....................%..%%......................%%%%%%%%.%%..............%%%%%%%%%%.........%%.........%%%%%..%%..%%%%%
m %%%%.....................%..............................%.........%.....%.....%%%%%%%%%...........................%...%%%%%
