# map type: blank
# random seed: 1729610196
# hill distance  79,108 119,  8  39, 58
#        79,108       0      92      92 
#       119,  8      92       0      92 
#        39, 58      92      92       0 
players 3
rows 120
cols 150
m ...................%%%%%%..............%%.%%..............................................%%....%%....................................................
m ............%......%%%%%.................%%%........................................%%.%%%%%.........................................%%%%.............
m ...........%%%%%%%%%%%%%...................%.......................%...................%%%%.....................%%......%%%%........%%%...%%..........
m ............%.%%%%%%%%%%%................%........................%%..%%...............%.......................%%......%%%%..........%....%%..........
m ..............%%%%%%%%%%%................%%..........................%%%%......................................%%%..%%%%%%%%..........................
m .............%%%%%%%%%%%..................%............................%%%................................%......%%%%%%%%%%%....%%....................
m .............%%%%%%%%%%%...............................................%%%.............%%............%...%%%.......%%%%%%%%%%%%%.............%%.......
m .............%%%%%%%%%%%%%..................%............................%............%%.............%%%%%%%.........%%%%%%%%%%%.%%........%%%........
m ......%......%%%%%%%%%%.....................%................................................%%......%%%%%%...........%%%%%%%%%%...........%%.........
m ......%%%...%%%%%%%%%%.................................%%...............................%....%%........%%%%.............%%.%..%%.........%%%%.%.......
m .....%%%%...%%%%%%%...................................%%%...............................%.............%%......%......%............%%.....%%...%.......
m .....%%%%%.%%%%%%%...................................%%%%...........%%....................%%........%%%%......%......%.......%%%.........%%%..........
m .......%%%..%%.......................................%%%%.%...........%.............................%%%......%%%.............%%%...........%%%........
m .........%%.%%...........%.%%%.......................%%%%%%....%%%...%%.........%..................%%%%........%.............%%%%.....................
m .......................%%%%%%...........%..............%.....%%%%%....%.........%%................%%%%......................%%%%%.....................
m .......................%%%%%%.........%%%%.............%..%%%%%%%%%.............%%%.................%%..........%.........%%%%%.......................
m ......................%%%%%%..........%%.%...........%%...%%%%%%%%%%............%%%................%%%..........%%........%%%%.....%%%%...............
m .....................%%%%%%%.........................%%%%%%%%%%%%%%%................................%%............%%......%%......%%%%........%.......
m ..................%%%%%%%%..........................%%%%%%%%%%%%%%%................................%%%.....................%.%%%%%%%%.........%.......
m ..%..................%%%%%.........................%%%%%%%%%%%%..%%.............%%%...............%%%..............%..........%..%%%%.........%%%%....
m .%%........%%......%%%%%%%%%%%%....%%.................%%%.....%...................................%%%...%%........%%.............%.%..........%%%%....
m .%%%...%...%..%%%...%%%%%%%%%%%..............%.........%%..%%...............................%%%.%%%%%...%%.........%.........................%%%%.....
m %%%%...%%.%%..%.%%%%%%%%%%%%%%%%............%%%.............%................................%..%%%%%...%%%...................................%%%%....
m %%%%...%%%%%%...%%%%%%%%%%%%%%%%...........%%%..............%....................................%%%....%%%.......................................%%%%
m .......%%%%%%%%%%%%%%%%%%%%%%%%%...........%%....%%.........%%...................................%%%..%%%%%%......................................%%%%
m .......%%%%%%%%%%%%%%%%%%%%%%%.............%%...............%%..................................%%%%%%%%%%%%.....................................%%%%%
m ..........%%%%%%%%%%%%%%%%%%%%..............................%%.................................%%%%%%%%%%%%%%%..%.....................................
m ..........%%%%%%%%%%%%%%%%%%%%%.............%...............%%.......%%%..%%%%..%%..............%.%%%%%%%%%%....%...%..............%%..%%%%.%%%.......
m .......%%%%%%%%%%%%%%%%%%%%%%%%...........%%%%%.............%%........%%..%...........%...........%%%%%%............%..............%%%%%%%%%.%........
m .......%%%%%%%%%%%%%%%%%%%%%%%%.........%%%%%%%............%%%...............%%......%%%..........%%%%%%...........................%%%%%%%%%..........
m ......%%%%%%%%%%%%%%%%%%%%%%%%%%........%%%%%..............%%................%%%%........%%.......................%................%%%%%%%%%%.........
m ........%%%%%%%%%%%%%%%%%%%%%%%%%.......%%%%...%....%....%%%%................%%%........%%%%......................%%...............%%%%%%%%%%.........
m ........%%%....%%%%%%%%%%%%%%%%%%%%.....%%....%%%...%....%%%%..........................%%%%%....................%%%................%%%%%%%%%%%........
m ....%%%.%%.....%%%%%%%%%%%%%%%%%%%%....%...........%%....%%%%..........................%%%%%....................%%%%%%%.............%%%%%%%%%%........
m ...%%%%%%%.%%..%%%....%.%%%%%%%%%%%...%%...........%%...%%%%%.........................%%%%%........................%%%........%..........%%%..........
m ...%%%%%%..%%..%%%.........%%%%%%%.........................%%............%%...........%%%%%..............%%....%%..%%%.......%%%.........%%%..........
m ....%%%%.......%.............%%%%%.........................%%%.%......................%%%%%.%............%%%...%%..%%........%%%%.....%%..%%..........
m ......%........%.........%%%..%%%%%...%%.....................%.%%%%..................%%%%%%.%........%%%%%%%........%%.................%..%...........
m .........................%%...%%%%%.............................%%%%..............%%...%%%%.........%%%%................%%.............%..............
m ..............................%%%.%.......................1...........%%................%%..%%......%..%.....................................%%....%..
m .....................................................................%%%%%%..............%%.%%..............................................%%....%%..
m .................................%%%%.........................%......%%%%%.................%%%........................................%%.%%%%%........
m ............%%......%%%%........%%%...%%.....................%%%%%%%%%%%%%...................%.......................%...................%%%%.........
m ...........%%......%%%%..........%....%%......................%.%%%%%%%%%%%................%........................%%..%%...............%............
m ...........%%%..%%%%%%%%........................................%%%%%%%%%%%................%%..........................%%%%...........................
m ......%......%%%%%%%%%%%....%%.................................%%%%%%%%%%%..................%............................%%%..........................
m .%...%%%.......%%%%%%%%%%%%%.............%%....................%%%%%%%%%%%...............................................%%%.............%%...........
m .%%%%%%%.........%%%%%%%%%%%.%%........%%%.....................%%%%%%%%%%%%%..................%............................%............%%............
m .%%%%%%...........%%%%%%%%%%...........%%...............%......%%%%%%%%%%.....................%................................................%%.....
m ...%%%%.............%%.%..%%.........%%%%.%.............%%%...%%%%%%%%%%.................................%%...............................%....%%.....
m ..%%......%......%............%%.....%%...%............%%%%...%%%%%%%...................................%%%...............................%...........
m %%%%......%......%.......%%%.........%%%...............%%%%%.%%%%%%%...................................%%%%...........%%....................%%........
m %%%......%%%.............%%%...........%%%...............%%%..%%.......................................%%%%.%...........%.............................
m %%%........%.............%%%%..............................%%.%%...........%.%%%.......................%%%%%%....%%%...%%.........%..................%
m %%......................%%%%%............................................%%%%%%...........%..............%.....%%%%%....%.........%%................%%
m %%..........%.........%%%%%..............................................%%%%%%.........%%%%.............%..%%%%%%%%%.............%%%.................
m %%..........%%........%%%%.....%%%%.....................................%%%%%%..........%%.%...........%%...%%%%%%%%%%............%%%................%
m %%............%%......%%......%%%%........%............................%%%%%%%.........................%%%%%%%%%%%%%%%................................
m %%.....................%.%%%%%%%%.........%.........................%%%%%%%%..........................%%%%%%%%%%%%%%%................................%
m %..............%..........%..%%%%.........%%%%......%..................%%%%%.........................%%%%%%%%%%%%..%%.............%%%...............%%
m %...%%........%%.............%.%..........%%%%.....%%........%%......%%%%%%%%%%%%....%%.................%%%.....%...................................%%
m %...%%.........%.........................%%%%......%%%...%...%..%%%...%%%%%%%%%%%..............%.........%%..%%...............................%%%.%%%%
m %...%%%...................................%%%%....%%%%...%%.%%..%.%%%%%%%%%%%%%%%%............%%%.............%................................%..%%%%
m ....%%%.......................................%%%%%%%%...%%%%%%...%%%%%%%%%%%%%%%%...........%%%..............%....................................%%%
m ..%%%%%%......................................%%%%.......%%%%%%%%%%%%%%%%%%%%%%%%%...........%%....%%.........%%...................................%%%
m %%%%%%%%.....................................%%%%%.......%%%%%%%%%%%%%%%%%%%%%%%.............%%...............%%..................................%%%%
m %%%%%%%%%%..%...............................................%%%%%%%%%%%%%%%%%%%%..............................%%.................................%%%%%
m %%%%%%%%....%...%..............%%..%%%%.%%%.................%%%%%%%%%%%%%%%%%%%%%.............%...............%%.......%%%..%%%%..%%..............%.%%
m %%%%............%..............%%%%%%%%%.%...............%%%%%%%%%%%%%%%%%%%%%%%%...........%%%%%.............%%........%%..%...........%...........%%
m %%%%...........................%%%%%%%%%.................%%%%%%%%%%%%%%%%%%%%%%%%.........%%%%%%%............%%%...............%%......%%%..........%%
m ..............%................%%%%%%%%%%...............%%%%%%%%%%%%%%%%%%%%%%%%%%........%%%%%..............%%................%%%%........%%.........
m ..............%%...............%%%%%%%%%%.................%%%%%%%%%%%%%%%%%%%%%%%%%.......%%%%...%....%....%%%%................%%%........%%%%........
m ............%%%................%%%%%%%%%%%................%%%....%%%%%%%%%%%%%%%%%%%%.....%%....%%%...%....%%%%..........................%%%%%........
m ............%%%%%%%.............%%%%%%%%%%............%%%.%%.....%%%%%%%%%%%%%%%%%%%%....%...........%%....%%%%..........................%%%%%........
m ...............%%%........%..........%%%.............%%%%%%%.%%..%%%....%.%%%%%%%%%%%...%%...........%%...%%%%%.........................%%%%%.........
m .....%%....%%..%%%.......%%%.........%%%.............%%%%%%..%%..%%%.........%%%%%%%.........................%%............%%...........%%%%%.........
m .....%%%...%%..%%........%%%%.....%%..%%..............%%%%.......%.............%%%%%.........................%%%.%......................%%%%%.%.......
m .%%%%%%%........%%.................%..%.................%........%.........%%%..%%%%%...%%.....................%.%%%%..................%%%%%%.%.......
m %%%%................%%.............%.......................................%%...%%%%%.............................%%%%..............%%...%%%%.........
m %..%.....................................%%....%................................%%%.%.......................0...........%%................%%..%%......
m ........................................%%....%%.......................................................................%%%%%%..............%%.%%......
m ..................................%%.%%%%%.........................................%%%%.........................%......%%%%%.................%%%......
m .................%...................%%%%.....................%%......%%%%........%%%...%%.....................%%%%%%%%%%%%%...................%......
m ................%%..%%...............%.......................%%......%%%%..........%....%%......................%.%%%%%%%%%%%................%........
m ...................%%%%......................................%%%..%%%%%%%%........................................%%%%%%%%%%%................%%.......
m .....................%%%................................%......%%%%%%%%%%%....%%.................................%%%%%%%%%%%..................%.......
m .....................%%%.............%%............%...%%%.......%%%%%%%%%%%%%.............%%....................%%%%%%%%%%%..........................
m .......................%............%%.............%%%%%%%.........%%%%%%%%%%%.%%........%%%.....................%%%%%%%%%%%%%..................%.....
m ...........................................%%......%%%%%%...........%%%%%%%%%%...........%%...............%......%%%%%%%%%%.....................%.....
m .....%%...............................%....%%........%%%%.............%%.%..%%.........%%%%.%.............%%%...%%%%%%%%%%............................
m ....%%%...............................%.............%%......%......%............%%.....%%...%............%%%%...%%%%%%%...............................
m ...%%%%...........%%....................%%........%%%%......%......%.......%%%.........%%%...............%%%%%.%%%%%%%................................
m ...%%%%.%...........%.............................%%%......%%%.............%%%...........%%%...............%%%..%%....................................
m ...%%%%%%....%%%...%%.........%..................%%%%........%.............%%%%..............................%%.%%...........%.%%%....................
m .....%.....%%%%%....%.........%%................%%%%......................%%%%%............................................%%%%%%...........%.........
m .....%..%%%%%%%%%.............%%%.................%%..........%.........%%%%%..............................................%%%%%%.........%%%%........
m ...%%...%%%%%%%%%%............%%%................%%%..........%%........%%%%.....%%%%.....................................%%%%%%..........%%.%........
m ...%%%%%%%%%%%%%%%................................%%............%%......%%......%%%%........%............................%%%%%%%......................
m ..%%%%%%%%%%%%%%%................................%%%.....................%.%%%%%%%%.........%.........................%%%%%%%%........................
m .%%%%%%%%%%%%..%%.............%%%...............%%%..............%..........%..%%%%.........%%%%......%..................%%%%%........................
m ....%%%.....%...................................%%%...%%........%%.............%.%..........%%%%.....%%........%%......%%%%%%%%%%%%....%%.............
m .....%%..%%...............................%%%.%%%%%...%%.........%.........................%%%%......%%%...%...%..%%%...%%%%%%%%%%%..............%....
m ..........%................................%..%%%%%...%%%...................................%%%%....%%%%...%%.%%..%.%%%%%%%%%%%%%%%%............%%%...
m ..........%....................................%%%....%%%.......................................%%%%%%%%...%%%%%%...%%%%%%%%%%%%%%%%...........%%%....
m %.........%%...................................%%%..%%%%%%......................................%%%%.......%%%%%%%%%%%%%%%%%%%%%%%%%...........%%....%
m ..........%%..................................%%%%%%%%%%%%.....................................%%%%%.......%%%%%%%%%%%%%%%%%%%%%%%.............%%.....
m ..........%%.................................%%%%%%%%%%%%%%%..%...............................................%%%%%%%%%%%%%%%%%%%%....................
m ..........%%.......%%%..%%%%..%%..............%.%%%%%%%%%%....%...%..............%%..%%%%.%%%.................%%%%%%%%%%%%%%%%%%%%%.............%.....
m ..........%%........%%..%...........%...........%%%%%%............%..............%%%%%%%%%.%...............%%%%%%%%%%%%%%%%%%%%%%%%...........%%%%%...
m .........%%%...............%%......%%%..........%%%%%%...........................%%%%%%%%%.................%%%%%%%%%%%%%%%%%%%%%%%%.........%%%%%%%...
m .........%%................%%%%........%%.......................%................%%%%%%%%%%...............%%%%%%%%%%%%%%%%%%%%%%%%%%........%%%%%.....
m ..%....%%%%................%%%........%%%%......................%%...............%%%%%%%%%%.................%%%%%%%%%%%%%%%%%%%%%%%%%.......%%%%...%..
m ..%....%%%%..........................%%%%%....................%%%................%%%%%%%%%%%................%%%....%%%%%%%%%%%%%%%%%%%%.....%%....%%%.
m .%%....%%%%..........................%%%%%....................%%%%%%%.............%%%%%%%%%%............%%%.%%.....%%%%%%%%%%%%%%%%%%%%....%..........
m .%%...%%%%%.........................%%%%%........................%%%........%..........%%%.............%%%%%%%.%%..%%%....%.%%%%%%%%%%%...%%..........
m .........%%............%%...........%%%%%..............%%....%%..%%%.......%%%.........%%%.............%%%%%%..%%..%%%.........%%%%%%%................
m .........%%%.%......................%%%%%.%............%%%...%%..%%........%%%%.....%%..%%..............%%%%.......%.............%%%%%................
m ...........%.%%%%..................%%%%%%.%........%%%%%%%........%%.................%..%.................%........%.........%%%..%%%%%...%%..........
m ..............%%%%..............%%...%%%%.........%%%%................%%.............%.......................................%%...%%%%%...............
m ........2...........%%................%%..%%......%..%.....................................%%....%................................%%%.%...............
