# map type: blank
# random seed: -808923603
# hill distance  35, 90  74, 42
#        35, 90       0      87 
#        74, 42      87       0 
players 2
rows 78
cols 96
m ..............%%%%%..............................%%.............................................
m .%%%%..........%%%%%.%.....%%....................%%%............................................
m %%.%%.........%%%%%%%%......%..............%%...................................................
m %....%%%%.....%%%%%%%%..%%.................%%.................................................%%
m .%%..%%%%.%%%%%%%%%%%%..%%..............%%%...................................................%.
m .%%..%%%%%%%%%%%%%%%%%..%%................%...................................................%.
m .%...%%%%%%%%%%%%%%%%%%.%...................................................................%%%.
m ......%%%%%%%%%%%%%%%%%.%%..................%............................................%%%%%%.
m ..%%%.%%%%%%%%%%%%%%%%...%..................%%%%.........................................%%%....
m ..%.%..%...%%.%%%%%%%%%.....................%%%...........................................%%....
m .......%.%.%%..%%%%%%%%%%...................%%%%%%%%............................................
m .........%.%...%%%%%%%%%%..................%%.%%%%.......................................%......
m ...............%%%%%%%%%...................%....%%...................................%...%%.....
m ................%%%%%%%%%................%..........................................%%..........
m .................%%%%%%%%................%%.........................................%%%.........
m .................%%%%%%%%%................%.%%.%....................................%%..........
m ...........%........%%%%....................%%%%..%..............................%%.............
m ..........%%...%%%..%%%%...................%%%%%%%%...........................%..%%.....%..%....
m ...........%%..%%%%%%%%%%..................%%%%%%%%%..........................%.........%..%....
m ..........%%%......%%%%%%%.................%%%%%%%%%.......................................%....
m ...........%%%%....%..%%...................%%%%%%%%%....%........................%.........%....
m ......%%...%%%........%%%..................%%%%........%%..%%...%...............%%.........%....
m ........................%...................%%%%%......%%..%%%.%%.........%%%..............%....
m .......................%%%.................%%%%%%%.....%%.....%%%..........................%....
m ......................%%%%.................%%%%%%%....%%%.....%%%%%.............................
m ......................%%%%...................%%%....%%%%%%.....%%%%.............................
m ......................%%%%...................%%%%....%%%%.%....%%.....%%........................
m ....%%...................................%%%%%%%%.........%.....%...............................
m .........................................%%%%%%%%...............................................
m ..........................................%%%%%%%.......................................%%......
m ..........................................%%%%%%%....................................%.%%.......
m ............................................%%%.....................................%%..........
m ............................................%%%......................................%..........
m ..........................................%%%%%.................................................
m ...........................%%..%..........%%%...........%%......................................
m .............................%%%%.........%%%.....%.....%%.%..............................1.....
m ..................................................%........%%...%%%%%...........%...............
m ............................................%%....%.............%%%%............%...............
m ..%..............................................%%............%%%%%............................
m .%%...........................................................%%%%%.............................
m .%%%.............................................%%%%..........%%%%%.%.....%%...................
m ................................................%%.%%.........%%%%%%%%......%..............%%...
m ..............................................%%%....%%%%.....%%%%%%%%..%%.................%%...
m ..............................................%..%%..%%%%.%%%%%%%%%%%%..%%..............%%%.....
m ..............................................%..%%..%%%%%%%%%%%%%%%%%..%%................%.....
m ............................................%%%..%...%%%%%%%%%%%%%%%%%%.%.......................
m .........................................%%%%%%.......%%%%%%%%%%%%%%%%%.%%..................%...
m .........................................%%%......%%%.%%%%%%%%%%%%%%%%...%..................%%%%
m ..........................................%%......%.%..%...%%.%%%%%%%%%.....................%%%.
m %%%%...................................................%.%.%%..%%%%%%%%%%...................%%%%
m %%.......................................%...............%.%...%%%%%%%%%%..................%%.%%
m %%...................................%...%%....................%%%%%%%%%...................%....
m ....................................%%..........................%%%%%%%%%................%......
m ....................................%%%..........................%%%%%%%%................%%.....
m ....................................%%...........................%%%%%%%%%................%.%%.%
m ..%..............................%%........................%........%%%%....................%%%%
m %%%...........................%..%%.....%..%..............%%...%%%..%%%%...................%%%%%
m %%%%..........................%.........%..%...............%%..%%%%%%%%%%..................%%%%%
m %%%%.......................................%..............%%%......%%%%%%%.................%%%%%
m %%%%....%........................%.........%...............%%%%....%..%%...................%%%%%
m .......%%..%%...%...............%%.........%..........%%...%%%........%%%..................%%%%.
m %......%%..%%%.%%.........%%%..............%............................%...................%%%%
m %%.....%%.....%%%..........................%...........................%%%.................%%%%%
m %%....%%%.....%%%%%...................................................%%%%.................%%%%%
m ....%%%%%%.....%%%%...................................................%%%%...................%%%
m %....%%%%.%....%%.....%%..............................................%%%%...................%%%
m %.........%.....%...................................%%...................................%%%%%%%
m %........................................................................................%%%%%%%
m %.......................................%%................................................%%%%%%
m %....................................%.%%.................................................%%%%%%
m ....................................%%......................................................%%%.
m .....................................%......................................................%%%.
m ..........................................................................................%%%%%.
m ........%%.................................................................%%..%..........%%%...
m ..%.....%%.%..............................0..................................%%%%.........%%%...
m ..%........%%...%%%%%...........%...............................................................
m ..%.............%%%%............%...........................................................%%..
m .%%............%%%%%..............................%.............................................
