# map type: blank
# random seed: -1169171413
# hill distance  48, 75   3,115  93, 35
#        48, 75       0      85      85 
#         3,115      85       0      85 
#        93, 35      85      85       0 
players 3
rows 135
cols 120
m .........................................................%%%%%.......................%....................%%............
m .........................................................%%%%%.........................................%..%%%...........
m .........................%%%%..%%..................%..%%%%%%%%.........................%%..........%...%................
m ...........................%.......................%%..%%%%%...............................%....%%%%...............0....
m .......................................................%%%%%%.............................%%....%%%%%...................
m ................................................%%%%.%%%%%%%%.%.................................%%%%........%%..........
m ...............................................%%%%....%%%%%%%%..............................%%.%%%..........%..........
m ..............%...............................%%%%%..%.%%%%%%%%%%.............................%.%%%.....................
m ..............%%...%............................%%%..%..%%%%%%%%%......%%.......................%%%%..................%.
m %............%%%%..%%............................%%%%%.%%%%%%%%%%.......%....................%%%%...................%.%.
m %%%%........%%%%%%%%%..............................%....%%%%%%%%%..............................%...%%...%..........%%.%%
m %%%%......%%%%%%%%%%%....%..............................%%%%%%%%%......................................%%%%%..........%%
m %%%%......%%%%%%%%%%%%%..%..............................%%%%%%%%%......................................%%............%%%
m %%%%%........%%%%%..%%%%.%..............................%%%%%%%%%...................................................%%%%
m %%%%%........%%..%......................................%%%%%%%........................................%%...........%%%%
m %%%%%........%..........................................%...%..........................................%..%..%....%.%%%%
m ...............%%..................................................%%.......................%......%......%%%%...%%%%%..
m %.%%..........%%%...................%%...................%%.......%%.......................%%......%.......%%%.%%%%%....
m %.%%...........%....................%%%................%....................%...............................%%%%%%%%....
m %.%%........................%........%%...............%%...................%%..................................%%.%%...%
m %%%.........................%........%%...................................%%%%.......................................%%%
m %%%...................%%...%%...............................................%%.%%%.................................%%%%%
m %%........%.......%.%%%%%.......................................%..................................................%%%%%
m %%%%%.....%%%%%...%%%%%%%%%%................%...................%............................%%%..................%%%%%%
m %%%%%.....%%%%%.....%%%%%%%%................%%.................................%..%%..........%%......%%%.........%%%%%%
m %%%%%.%%%.%%%%%%....%%%%%%%%%%.................................................%%%%%..........%.....%%%%%.........%%%%%%
m %%....%...%%%%%%%%..%%%%%%%%%%%................................................%%%%........%%....%%%%%%%%....%.......%%%
m %%..%%%....%..%%%%%%%%%%%%%%%%%.................................................%...%%....%%%%.%%%%%%%%%%%...%%......%%%
m .....%%%%%....%%%%%%%%%%%%%%%%%%................................................%..%%.....%%%%%%%%%%%%%%%...............
m ........%.........%%%%%%%%%%%%%%..............................................%%......%%%%%%.%%%%%%%%.%%%....%..........
m ..................%%%%%%%%%%%%..........%...%...................................%.%%%%%%%%%.....%%%%%........%.....%....
m ..................%%%%%%%%%%............%%..%....................%%%%...%.......%.%%%%%%%%%%....%%%%%.............%%....
m ...................%%%%%%%%%.............%..............................%......%%%%%%%%%%%%%...%%%%%%....%%%......%%....
m ....................%%%%%%%%%.....................................................%%%%%%%%%%...%%%%%%%...%..............
m ...................%%...%%%%%%%%%..................................................%%%%%%%%%%..%%%%%%%..%...............
m .....%.............%%....%%%%%%%%..........................................%......%%%%%%%..%%....%%.....%...............
m .....%........%%%%%%%%...%%%%%%%...........................................%%.....................%.....%...............
m ....%%...........%%%%....%%%%%%%%..........................................%%.....................%.....%%..%...........
m %%%%%%%%%........%%%%%.....%%%%%%%%%%..................................................................%%%%%%...........
m %%%%%%%%%..%%......%%%.....%%%%%%%%%%..................................................................%%%%%............
m %%%%%%%%%...%%......%%........%..%%.%..................................................................%%%%%............
m %%%...%%%..%%%......%%...................................................................................%%%............
m ..%.................%%......%........................................................................................%%.
m .....................%%%....%..............%%%.....................................................%.%%%%.............%%
m ...................%...%%...................%%....................%................................%..%%................
m .................%%%%%.......................%....................%%....................................................
m .................%%%%%.........................................%..%%%...................................................
m ...........%..%%%%%%%%.........................%%..........%...%.........................................%%%%..%%.......
m ...........%%..%%%%%...............................%....%%%%...............2...............................%............
m ...............%%%%%%.............................%%....%%%%%...........................................................
m ........%%%%.%%%%%%%%.%.................................%%%%........%%..................................................
m .......%%%%....%%%%%%%%..............................%%.%%%..........%..................................................
m ......%%%%%..%.%%%%%%%%%%.............................%.%%%...................................%.........................
m ........%%%..%..%%%%%%%%%......%%.......................%%%%..................%...............%%...%....................
m .........%%%%%.%%%%%%%%%%.......%....................%%%%...................%.%.%............%%%%..%%...................
m ...........%....%%%%%%%%%..............................%...%%...%..........%%.%%%%%%........%%%%%%%%%...................
m ................%%%%%%%%%......................................%%%%%..........%%%%%%......%%%%%%%%%%%....%..............
m ................%%%%%%%%%......................................%%............%%%%%%%......%%%%%%%%%%%%%..%..............
m ................%%%%%%%%%...................................................%%%%%%%%%........%%%%%..%%%%.%..............
m ................%%%%%%%........................................%%...........%%%%%%%%%........%%..%......................
m ................%...%..........................................%..%..%....%.%%%%%%%%%........%..........................
m ...........................%%.......................%......%......%%%%...%%%%%.................%%.......................
m .................%%.......%%.......................%%......%.......%%%.%%%%%....%.%%..........%%%...................%%..
m ...............%....................%...............................%%%%%%%%....%.%%...........%....................%%%.
m ..............%%...................%%..................................%%.%%...%%.%%........................%........%%.
m ..................................%%%%.......................................%%%%%%.........................%........%%.
m ....................................%%.%%%.................................%%%%%%%%...................%%...%%...........
m ........................%..................................................%%%%%%%........%.......%.%%%%%...............
m ....%...................%............................%%%..................%%%%%%%%%%%.....%%%%%...%%%%%%%%%%............
m ....%%.................................%..%%..........%%......%%%.........%%%%%%%%%%%.....%%%%%.....%%%%%%%%............
m .......................................%%%%%..........%.....%%%%%.........%%%%%%%%%%%.%%%.%%%%%%....%%%%%%%%%%..........
m .......................................%%%%........%%....%%%%%%%%....%.......%%%%%....%...%%%%%%%%..%%%%%%%%%%%.........
m ........................................%...%%....%%%%.%%%%%%%%%%%...%%......%%%%%..%%%....%..%%%%%%%%%%%%%%%%%.........
m ........................................%..%%.....%%%%%%%%%%%%%%%....................%%%%%....%%%%%%%%%%%%%%%%%%........
m ......................................%%......%%%%%%.%%%%%%%%.%%%....%..................%.........%%%%%%%%%%%%%%........
m %...%...................................%.%%%%%%%%%.....%%%%%........%.....%......................%%%%%%%%%%%%..........
m %%..%....................%%%%...%.......%.%%%%%%%%%%....%%%%%.............%%......................%%%%%%%%%%............
m .%..............................%......%%%%%%%%%%%%%...%%%%%%....%%%......%%.......................%%%%%%%%%............
m ..........................................%%%%%%%%%%...%%%%%%%...%..................................%%%%%%%%%...........
m ...........................................%%%%%%%%%%..%%%%%%%..%..................................%%...%%%%%%%%%.......
m ...................................%......%%%%%%%..%%....%%.....%....................%.............%%....%%%%%%%%.......
m ...................................%%.....................%.....%....................%........%%%%%%%%...%%%%%%%........
m ...................................%%.....................%.....%%..%...............%%...........%%%%....%%%%%%%%.......
m ...............................................................%%%%%%...........%%%%%%%%%........%%%%%.....%%%%%%%%%%...
m ...............................................................%%%%%............%%%%%%%%%..%%......%%%.....%%%%%%%%%%...
m ...............................................................%%%%%............%%%%%%%%%...%%......%%........%..%%.%...
m .................................................................%%%............%%%...%%%..%%%......%%..................
m .............................................................................%%...%.................%%......%...........
m ...%%%.....................................................%.%%%%.............%%.....................%%%....%...........
m ....%%....................%................................%..%%...................................%...%%...............
m .....%....................%%.....................................................................%%%%%..................
m .......................%..%%%....................................................................%%%%%..................
m .......%%..........%...%.........................................%%%%..%%..................%..%%%%%%%%..................
m ...........%....%%%%...............1...............................%.......................%%..%%%%%....................
m ..........%%....%%%%%..........................................................................%%%%%%...................
m ................%%%%........%%..........................................................%%%%.%%%%%%%%.%.................
m .............%%.%%%..........%.........................................................%%%%....%%%%%%%%.................
m ..............%.%%%...................................%...............................%%%%%..%.%%%%%%%%%%...............
m ................%%%%..................%...............%%...%............................%%%..%..%%%%%%%%%......%%.......
m .............%%%%...................%.%.%............%%%%..%%............................%%%%%.%%%%%%%%%%.......%.......
m ...............%...%%...%..........%%.%%%%%%........%%%%%%%%%..............................%....%%%%%%%%%...............
m .......................%%%%%..........%%%%%%......%%%%%%%%%%%....%..............................%%%%%%%%%...............
m .......................%%............%%%%%%%......%%%%%%%%%%%%%..%..............................%%%%%%%%%...............
m ....................................%%%%%%%%%........%%%%%..%%%%.%..............................%%%%%%%%%...............
m .......................%%...........%%%%%%%%%........%%..%......................................%%%%%%%.................
m .......................%..%..%....%.%%%%%%%%%........%..........................................%...%...................
m ............%......%......%%%%...%%%%%.................%%..................................................%%...........
m ...........%%......%.......%%%.%%%%%....%.%%..........%%%...................%%...................%%.......%%............
m ............................%%%%%%%%....%.%%...........%....................%%%................%....................%...
m ...............................%%.%%...%%.%%........................%........%%...............%%...................%%...
m .....................................%%%%%%.........................%........%%...................................%%%%..
m %%.................................%%%%%%%%...................%%...%%...............................................%%.%
m ...................................%%%%%%%........%.......%.%%%%%.......................................%...............
m .............%%%..................%%%%%%%%%%%.....%%%%%...%%%%%%%%%%................%...................%...............
m ..%%..........%%......%%%.........%%%%%%%%%%%.....%%%%%.....%%%%%%%%................%%.................................%
m %%%%..........%.....%%%%%.........%%%%%%%%%%%.%%%.%%%%%%....%%%%%%%%%%.................................................%
m %%%........%%....%%%%%%%%....%.......%%%%%....%...%%%%%%%%..%%%%%%%%%%%................................................%
m %...%%....%%%%.%%%%%%%%%%%...%%......%%%%%..%%%....%..%%%%%%%%%%%%%%%%%.................................................
m %..%%.....%%%%%%%%%%%%%%%....................%%%%%....%%%%%%%%%%%%%%%%%%................................................
m ......%%%%%%.%%%%%%%%.%%%....%..................%.........%%%%%%%%%%%%%%..............................................%%
m %.%%%%%%%%%.....%%%%%........%.....%......................%%%%%%%%%%%%..........%...%...................................
m %.%%%%%%%%%%....%%%%%.............%%......................%%%%%%%%%%............%%..%....................%%%%...%.......
m %%%%%%%%%%%%...%%%%%%....%%%......%%.......................%%%%%%%%%.............%..............................%......%
m ..%%%%%%%%%%...%%%%%%%...%..................................%%%%%%%%%...................................................
m ...%%%%%%%%%%..%%%%%%%..%..................................%%...%%%%%%%%%...............................................
m ..%%%%%%%..%%....%%.....%....................%.............%%....%%%%%%%%..........................................%....
m ..................%.....%....................%........%%%%%%%%...%%%%%%%...........................................%%...
m ..................%.....%%..%...............%%...........%%%%....%%%%%%%%..........................................%%...
m .......................%%%%%%...........%%%%%%%%%........%%%%%.....%%%%%%%%%%...........................................
m .......................%%%%%............%%%%%%%%%..%%......%%%.....%%%%%%%%%%...........................................
m .......................%%%%%............%%%%%%%%%...%%......%%........%..%%.%...........................................
m .........................%%%............%%%...%%%..%%%......%%..........................................................
m .....................................%%...%.................%%......%...................................................
m ...................%.%%%%.............%%.....................%%%....%..............%%%..................................
m ...................%..%%...................................%...%%...................%%....................%.............
