# map type: blank
# random seed: 1532003244
# hill distance  50, 87   0, 40
#        50, 87       0      97 
#         0, 40      97       0 
players 2
rows 100
cols 94
m ........................................0.....................................................
m ..%%.............................%%...........................................................
m .....................%%...........%...........................................................
m ......................%........................................%..............................
m ...............................................................%%.............................
m ................................................................%%%...........................
m ................................................................%%%%%.........................
m ............%%..................................................%%%%..........................
m .......%.....%..............................%%..%...............%%%%..........................
m .......%.....................................%..%..............%%%%%.................%%.......
m ................................................%%.................%%%........................
m ................................................%%..%.............%%%..%%.....................
m ...................................................%%............%%.........................%.
m ..................................................%%%%...........%..........................%.
m .................................................%%%%.........................................
m ..........%%.....................................%%%..............%%%.........................
m ..........%%%%%%..............................................................................
m ............%%%...................................%%%.........................................
m .............%....%%%..............................%.......................................%%.
m .......%.........%%%%.........................%%%.............................................
m ......%%..%%.....%%%...........................%%.......................................%%....
m .......%.........%%%...........................%%........................................%....
m .................%%...........................................................................
m ...............%..............................................................................
m ...............%%%%...........................................................................
m .............%%%%%%............%..............................................................
m .............%%%%..............%................................................%.............
m ..............%............%%....%..............................................%.............
m ...........................%%%...%............................................................
m ..........%%%%%%%%%.%%.....%...........................................%%......%.%%%%.........
m ..........%%%%%%%%%%%%%....%..................................................%%.%%%%.........
m .........%%%%%%%%%...%%...%%%%.%%.%...........................................%%%%%%%.........
m .........%%%%%%%%%...%%%%.%%%%%%%%%...........................................%%%%%%%.........
m ....%......%%%%.......%...%%%.....%%............%%..%..........................%%%%%%%%.......
m ....%......%%%..%..........%%...................%%%%%..........................%%%%%%%%.......
m .............%%.%%%%.%%....%....................%%%%%..........................%%%%%%%%.......
m .....%...........%%%......%%%....................................................%%%%%........
m .....%........%%..%%%......%%%................................................%%...%%%........
m ............................%....%.................................................%%.........
m .%...............................%..........................................%......%%..%......
m .%............%..%..............%%......%..................................%%..........%%.....
m ..............%%%%.........%%....%%...%%%.................................%%%%................
m ..............%%%%..........%%.%.%%%%%%..................................%%%%%%%..............
m .............%%%%%%.........%%%%.%%%%%%%.................................%%%%%%%.......%......
m .............%%%%%%%%.........%%.%%%%%...................................%%%%%%%.......%......
m ................%%%%..%%............%%...................................%%%%%%%..............
m ...............%%%%%........................................................%%%%......%%%%....
m ..............%%%%%%.........................................................%%%%......%%.....
m ...............%%%%............................................................%.......%......
m ...............%%.............................................................................
m .......................................................................................1......
m .................................................%%.............................%%............
m ....................................................................%%...........%............
m ................%....................................................%........................
m ................%%............................................................................
m .................%%%..........................................................................
m .................%%%%%........................................................................
m .................%%%%......................................%%.................................
m .%...............%%%%.................................%.....%..............................%%.
m .%..............%%%%%.................%%..............%.....................................%.
m .%%.................%%%.......................................................................
m .%%..%.............%%%..%%....................................................................
m ....%%............%%.........................%................................................
m ...%%%%...........%..........................%................................................
m ..%%%%........................................................................................
m ..%%%..............%%%...................................%%...................................
m .........................................................%%%%%%...............................
m ...%%%.....................................................%%%................................
m ....%.......................................%%..............%....%%%..........................
m %%....................................................%.........%%%%.........................%
m %%.......................................%%..........%%..%%.....%%%...........................
m %%........................................%...........%.........%%%...........................
m ................................................................%%............................
m ..............................................................%...............................
m ..............................................................%%%%............................
m ............................................................%%%%%%............%...............
m .................................%..........................%%%%..............%...............
m .................................%...........................%............%%....%.............
m ..........................................................................%%%...%.............
m ........................%%......%.%%%%...................%%%%%%%%%.%%.....%...................
m ...............................%%.%%%%...................%%%%%%%%%%%%%....%...................
m ...............................%%%%%%%..................%%%%%%%%%...%%...%%%%.%%.%............
m ...............................%%%%%%%..................%%%%%%%%%...%%%%.%%%%%%%%%............
m .%%..%..........................%%%%%%%%...........%......%%%%.......%...%%%.....%%...........
m .%%%%%..........................%%%%%%%%...........%......%%%..%..........%%..................
m .%%%%%..........................%%%%%%%%....................%%.%%%%.%%....%...................
m ..................................%%%%%.............%...........%%%......%%%..................
m ...............................%%...%%%.............%........%%..%%%......%%%.................
m ....................................%%.....................................%....%.............
m .............................%......%%..%.......%...............................%.............
m ............................%%..........%%......%............%..%..............%%......%......
m ...........................%%%%..............................%%%%.........%%....%%...%%%......
m ..........................%%%%%%%............................%%%%..........%%.%.%%%%%%........
m ..........................%%%%%%%.......%...................%%%%%%.........%%%%.%%%%%%%.......
m ..........................%%%%%%%.......%...................%%%%%%%%.........%%.%%%%%.........
m ..........................%%%%%%%..............................%%%%..%%............%%.........
m .............................%%%%......%%%%...................%%%%%...........................
m ..............................%%%%......%%...................%%%%%%...........................
m ................................%.......%.....................%%%%............................
m ..............................................................%%..............................
