# map type: blank
# random seed: -1403916130
# hill distance  28, 42  96,  0  62, 84
#        28, 42       0      76      76 
#        96,  0      76       0      76 
#        62, 84      76      76       0 
players 3
rows 102
cols 126
m ......%%%%%%%%......%..%%%.....................%..........................%%%%%%%%%%%.........................................
m %%....%%%%%%%%..%%%.%%%%%................%%...%%...........................%%%%%%%%%%......%.................%%%.............%
m %%....%%%%%%%.....%.....%................%%.................................%..%%%%%%.....%%.................%%..........%%%%%
m .....%%%%%%%%%.%%.....%%%%%..............%%%%...................................%%%%......%................%..%.........%%%%%%
m ....%%%%%%%%%%%%.......%.................%......................................%%%%.......................%%..........%%%%%%%
m ....%%%%%%%%%%%%...............%.%%............................%%%..............%%.......................%%%%............%%%%%
m ....%%%%%%%%%%%%.............%%%%%%%...........................%%%........%%...........................%%....%...........%%%..
m ....%%%%%%%%%%%%..%............%%%%%%...........%%............%%%%...............................%%....%.....%..........%%%%..
m ..%%%%%%%%%%%%%..%%%............%%%%%............%...........%%%%%........................%%%...%%...........%..........%%%%%.
m %%%%%%%%%%%%%%%%%%%%%...........%%%%.........................%%%%%..................%......%%%.........................%%%%%%%
m %%%%%%%%%%%%%%%%%%%%..........%%%%%%%.......................%%%%%%................%%%......%%%%.................%%%...%%%%%%%%
m %%%%%%%%%%%%%%%%%.............%%%%%%......................%%%%%%%................%%%%%%...%%%%%%%%.......%.....%%%%%%%%%%%%%%%
m %%%%%%%%%%%%%%%%%...........%.%%%%%%.%%...................%%%%%..................%%%%%%%%%%%%%%%%....%%%.%%%%.%%%%%%%%%%%%%%%%
m %%%%%%%%%%%%%%%%%.....%%%%..%%%%%%%%...%........%..%..%..%%%%%...........%.......%%%%%%%%%%%%%%%%%...%%%%.%%%%%%%%%%%%%%%%%%%%
m %%%%%%%%%%%%%%%%%.%%.%%%%%.%%%%%%%%%...%........%%%%%%%.%%%%%%%.........%%...%%%%%%%%%%%%%%%%%%%%%.........%%%%%%%%%%%%%%%%%%%
m %%%%%%%%%%%%%%%%...%.%%%%%.%%%%%%%%%%%.........%%%%%%%...%%%%%%............%%%%%%%%%%%%%%%%%%%%%%%%%%.......%%%%%%%%%%%%%%%%%%
m %%%%%%%%%%%%%%%%......%%.....%...%%%...........%%..%%%.....%...%...........%%%%%%%%%%%%%%%%%%%%%%%%%%%......%%%%%%%%%%%%%%%%%%
m %%%%%%%%%%%%%%.........%%........%%%....%%.....%...........%...%.........%%%%%%%%%%%%%%%%%%%%%%%%%%%.%........%%%%%%%%%%%%%%%%
m ..%%%%%%%%%%....................%%%%%....%...............................%%%%%%%%%%%%%%%%%%%%%%%%%%%..........%%%%%%%%%%%%%%..
m ..%%%%%%%%......................%%%%.....%..............................%%%%%%%%%%%%%%%%%%%%%%%%%%%%............%%%%%%%%%%%%..
m ..%%%%%%%%.........................%%...%%%....%..%%%%....%%............%%%%%%%%%%%%%%%%%%%%%%%%%%%%.............%%%%%%%%%%%..
m %%%%%%%%%%...........................%%..%%...%%.%%%%%%%................%%%%%%%%%%%%%%.%%%%%%%%%%%................%%%%%%%%%%%.
m .%%%%%%%.............................%....%%...%.%%%%%%%..............%%%%%%%%%%%%%%%%..%%%%.%%%%%%............%%.%%%%%%%%%...
m ....%.%..%%%%%%................................%..%%%%%%%%%...........%%%%%%%%%%%%%%.%.......%%%%%........%..%%%%%%%%%%%......
m ...%%....%%%%%%...................................%%%%%%%%...........%%.%%%%%%%%%%%%.........%%%..........%.%%%%%%%%%.........
m ...%%.....%%%%........................%%.%%...........%%.............%....%%%%%%..%.........%%%.............%%%%%%%%%%........
m ..........%%%%%..%...............%%..%%%........%..........................%%%%%....%.%%.....%%.........%%%%%%%%%%%%%%%.......
m .......%%.%%%%%%%%...................%.%........%................%%.........%%%%...%%%%%.....%...........%%%.%%%%%%%%%%.......
m ........%...%.......................%.....1..................................%%....%%%%......%...............%%%%%%%%%%%%.....
m ........%%%.%.....%%................%.............................%%.........%.....%%%.%%%..................%%%%%.%%%%%%%%....
m %%%......%%......................%%%%.....%%............................................%................%.....%%...%%%%%%....
m .................................%................%%....................................................%%..........%%%%%%....
m .......%%.......................................%%%%................................................................%%%%%%%%%%
m ......%%%.....................................%%%%%%%%...........%%%................................................%%%%%%%%%%
m %...............................................%%%%%%%%......%..%%%.....................%..........................%%%%%%%%%%
m %......%.................%%%.............%%%....%%%%%%%%..%%%.%%%%%................%%...%%...........................%%%%%%%%%
m %.....%%.................%%..........%%%%%%%....%%%%%%%.....%.....%................%%.................................%..%%%%%
m ......%................%..%.........%%%%%%.....%%%%%%%%%.%%.....%%%%%..............%%%%...................................%%%%
m .......................%%..........%%%%%%%....%%%%%%%%%%%%.......%.................%......................................%%%%
m .....................%%%%............%%%%%....%%%%%%%%%%%%...............%.%%............................%%%..............%%..
m ...................%%....%...........%%%......%%%%%%%%%%%%.............%%%%%%%...........................%%%........%%........
m .............%%....%.....%..........%%%%......%%%%%%%%%%%%..%............%%%%%%...........%%............%%%%..................
m ......%%%...%%...........%..........%%%%%...%%%%%%%%%%%%%..%%%............%%%%%............%...........%%%%%..................
m %......%%%.........................%%%%%%%%%%%%%%%%%%%%%%%%%%%%...........%%%%.........................%%%%%..................
m %......%%%%.................%%%...%%%%%%%%%%%%%%%%%%%%%%%%%%%%..........%%%%%%%.......................%%%%%%................%%
m %%%...%%%%%%%%.......%.....%%%%%%%%%%%%%%%%%%%%%%%%%%%%%%%%.............%%%%%%......................%%%%%%%................%%%
m %%%%%%%%%%%%%....%%%.%%%%.%%%%%%%%%%%%%%%%%%%%%%%%%%%%%%%%%...........%.%%%%%%.%%...................%%%%%..................%%%
m %%%%%%%%%%%%%%...%%%%.%%%%%%%%%%%%%%%%%%%%%%%%%%%%%%%%%%%%%.....%%%%..%%%%%%%%...%........%..%..%..%%%%%...........%.......%%%
m %%%%%%%%%%%%%%.........%%%%%%%%%%%%%%%%%%%%%%%%%%%%%%%%%%%%.%%.%%%%%.%%%%%%%%%...%........%%%%%%%.%%%%%%%.........%%...%%%%%%%
m %%%%%%%%%%%%%%%%%.......%%%%%%%%%%%%%%%%%%%%%%%%%%%%%%%%%%...%.%%%%%.%%%%%%%%%%%.........%%%%%%%...%%%%%%............%%%%%%%%%
m %%%%%%%%%%%%%%%%%%......%%%%%%%%%%%%%%%%%%%%%%%%%%%%%%%%%%......%%.....%...%%%...........%%..%%%.....%...%...........%%%%%%%%%
m %%%%%%%%%%%%%%%%.%........%%%%%%%%%%%%%%%%%%%%%%%%%%%%%%.........%%........%%%....%%.....%...........%...%.........%%%%%%%%%%%
m %%%%%%%%%%%%%%%%..........%%%%%%%%%%%%%%....%%%%%%%%%%....................%%%%%....%...............................%%%%%%%%%%%
m %%%%%%%%%%%%%%%%............%%%%%%%%%%%%....%%%%%%%%......................%%%%.....%..............................%%%%%%%%%%%%
m %%%%%%%%%%%%%%%%.............%%%%%%%%%%%....%%%%%%%%.........................%%...%%%....%..%%%%....%%............%%%%%%%%%%%%
m %%.%%%%%%%%%%%................%%%%%%%%%%%.%%%%%%%%%%...........................%%..%%...%%.%%%%%%%................%%%%%%%%%%%%
m %%..%%%%.%%%%%%............%%.%%%%%%%%%....%%%%%%%.............................%....%%...%.%%%%%%%..............%%%%%%%%%%%%%%
m .%.......%%%%%........%..%%%%%%%%%%%..........%.%..%%%%%%................................%..%%%%%%%%%...........%%%%%%%%%%%%%%
m .........%%%..........%.%%%%%%%%%............%%....%%%%%%...................................%%%%%%%%...........%%.%%%%%%%%%%%%
m ........%%%.............%%%%%%%%%%...........%%.....%%%%........................%%.%%...........%%.............%....%%%%%%..%.
m %.%%.....%%.........%%%%%%%%%%%%%%%.................%%%%%..%...............%%..%%%........%..........................%%%%%....
m %%%%.....%...........%%%.%%%%%%%%%%..............%%.%%%%%%%%...................%.%........%................%%.........%%%%...%
m %%%......%...............%%%%%%%%%%%%.............%...%.......................%.....2..................................%%....%
m %%.%%%..................%%%%%.%%%%%%%%............%%%.%.....%%................%.............................%%.........%.....%
m ....%................%.....%%...%%%%%%....%%%......%%......................%%%%.....%%........................................
m ....................%%..........%%%%%%.....................................%................%%................................
m ................................%%%%%%%%%%.......%%.......................................%%%%................................
m ................................%%%%%%%%%%......%%%.....................................%%%%%%%%...........%%%................
m .....%..........................%%%%%%%%%%%...............................................%%%%%%%%......%..%%%................
m %...%%...........................%%%%%%%%%%......%.................%%%.............%%%....%%%%%%%%..%%%.%%%%%................%
m %.................................%..%%%%%%.....%%.................%%..........%%%%%%%....%%%%%%%.....%.....%................%
m %%%...................................%%%%......%................%..%.........%%%%%%.....%%%%%%%%%.%%.....%%%%%..............%
m ......................................%%%%.......................%%..........%%%%%%%....%%%%%%%%%%%%.......%.................%
m .....................%%%..............%%.......................%%%%............%%%%%....%%%%%%%%%%%%...............%.%%.......
m .....................%%%........%%...........................%%....%...........%%%......%%%%%%%%%%%%.............%%%%%%%......
m ......%%............%%%%...............................%%....%.....%..........%%%%......%%%%%%%%%%%%..%............%%%%%%.....
m .......%...........%%%%%........................%%%...%%...........%..........%%%%%...%%%%%%%%%%%%%..%%%............%%%%%.....
m ...................%%%%%..................%......%%%.........................%%%%%%%%%%%%%%%%%%%%%%%%%%%%...........%%%%......
m ..................%%%%%%................%%%......%%%%.................%%%...%%%%%%%%%%%%%%%%%%%%%%%%%%%%..........%%%%%%%.....
m ................%%%%%%%................%%%%%%...%%%%%%%%.......%.....%%%%%%%%%%%%%%%%%%%%%%%%%%%%%%%%.............%%%%%%......
m ................%%%%%..................%%%%%%%%%%%%%%%%....%%%.%%%%.%%%%%%%%%%%%%%%%%%%%%%%%%%%%%%%%%...........%.%%%%%%.%%...
m ......%..%..%..%%%%%...........%.......%%%%%%%%%%%%%%%%%...%%%%.%%%%%%%%%%%%%%%%%%%%%%%%%%%%%%%%%%%%%.....%%%%..%%%%%%%%...%..
m ......%%%%%%%.%%%%%%%.........%%...%%%%%%%%%%%%%%%%%%%%%.........%%%%%%%%%%%%%%%%%%%%%%%%%%%%%%%%%%%%.%%.%%%%%.%%%%%%%%%...%..
m .....%%%%%%%...%%%%%%............%%%%%%%%%%%%%%%%%%%%%%%%%%.......%%%%%%%%%%%%%%%%%%%%%%%%%%%%%%%%%%...%.%%%%%.%%%%%%%%%%%....
m .....%%..%%%.....%...%...........%%%%%%%%%%%%%%%%%%%%%%%%%%%......%%%%%%%%%%%%%%%%%%%%%%%%%%%%%%%%%%......%%.....%...%%%......
m .....%...........%...%.........%%%%%%%%%%%%%%%%%%%%%%%%%%%.%........%%%%%%%%%%%%%%%%%%%%%%%%%%%%%%.........%%........%%%....%%
m ...............................%%%%%%%%%%%%%%%%%%%%%%%%%%%..........%%%%%%%%%%%%%%....%%%%%%%%%%....................%%%%%....%
m ..............................%%%%%%%%%%%%%%%%%%%%%%%%%%%%............%%%%%%%%%%%%....%%%%%%%%......................%%%%.....%
m %....%..%%%%....%%............%%%%%%%%%%%%%%%%%%%%%%%%%%%%.............%%%%%%%%%%%....%%%%%%%%.........................%%...%%
m %...%%.%%%%%%%................%%%%%%%%%%%%%%.%%%%%%%%%%%................%%%%%%%%%%%.%%%%%%%%%%...........................%%..%
m %%...%.%%%%%%%..............%%%%%%%%%%%%%%%%..%%%%.%%%%%%............%%.%%%%%%%%%....%%%%%%%.............................%....
m .....%..%%%%%%%%%...........%%%%%%%%%%%%%%.%.......%%%%%........%..%%%%%%%%%%%..........%.%..%%%%%%...........................
m ........%%%%%%%%...........%%.%%%%%%%%%%%%.........%%%..........%.%%%%%%%%%............%%....%%%%%%...........................
m %...........%%.............%....%%%%%%..%.........%%%.............%%%%%%%%%%...........%%.....%%%%........................%%.%
m ......%..........................%%%%%....%.%%.....%%.........%%%%%%%%%%%%%%%.................%%%%%..%...............%%..%%%..
m ......%................%%.........%%%%...%%%%%.....%...........%%%.%%%%%%%%%%..............%%.%%%%%%%%...................%.%..
m 0..................................%%....%%%%......%...............%%%%%%%%%%%%.............%...%.......................%.....
m ........................%%.........%.....%%%.%%%..................%%%%%.%%%%%%%%............%%%.%.....%%................%.....
m %%............................................%................%.....%%...%%%%%%....%%%......%%......................%%%%.....
m ........%%....................................................%%..........%%%%%%.....................................%........
m ......%%%%................................................................%%%%%%%%%%.......%%.................................
m ....%%%%%%%%...........%%%................................................%%%%%%%%%%......%%%.................................
