# map type: blank
# random seed: -1198751084
# hill distance  15, 10  52, 56
#        15, 10       0      83 
#        52, 56      83       0 
players 2
rows 74
cols 92
m .......................................%%...................................................
m ............................................................................................
m ............................................................................................
m ............................................................................................
m ..............................................%%............................................
m ............................................................................................
m ......................................................%.....................................
m ......................................................%.....................................
m ............................................................................................
m ...........................................................%%.....%%%.......................
m ............................................................%%....%.........................
m ............................................................%%%%............................
m ..............................................................%%%...........................
m ........%%..................................................................................
m ........................................................%%..................................
m ..........1..............................................%..................................
m ...................%........................................................................
m ...................%..................%.....................................................
m .%%...................................%.....................................................
m ..........................%.................................................................
m ..........................%.................................................................
m ................................%..........................................%%...............
m ................................%%%%.%%.....%%.%......................%%%%%%................
m .................................%%...%........%......................%%%%%%................
m .......................%%%.......%%..................................%%%%%%.................
m .....................%%%.........%%%%%%%%............................%%%%%%%................
m .....................%%%%.....%%%%%%%%%%%%...............................%%%%...............
m .....................%%%%....%%%%%..%%%..................................%%.................
m ...........................%%%%%%.......%%%.................................................
m .......................%%..%...%%.......................................................%%..
m ...............................%%.%.........................................................
m ..................................%......................................%..................
m .........................................................................%..................
m .........................................................................%..................
m ....................%%......................................................................
m ...................................................................................%%.......
m .....................................................................................%%.....
m .....................................................................................%%.....
m ............................................................................................
m ............................................................................................
m ............................................................................................
m %%..........................................................................................
m ............................................................................................
m ........%...................................................................................
m ........%...................................................................................
m ............................................................................................
m .............%%.....%%%.....................................................................
m ..............%%....%.......................................................................
m ..............%%%%..........................................................................
m ................%%%.........................................................................
m ......................................................%%....................................
m ..........%%................................................................................
m ...........%............................................0...................................
m .................................................................%..........................
m .................................................................%..................%.......
m ...............................................%%...................................%.......
m ........................................................................%...................
m ........................................................................%...................
m .............................%%...............................................%.............
m .%......................%%%%%%................................................%%%%.%%.....%%
m .%......................%%%%%%.................................................%%...%.......
m .......................%%%%%%........................................%%%.......%%...........
m .......................%%%%%%%.....................................%%%.........%%%%%%%%.....
m ...........................%%%%....................................%%%%.....%%%%%%%%%%%%....
m ...........................%%......................................%%%%....%%%%%..%%%.......
m .........................................................................%%%%%%.......%%%...
m ..........................................%%.........................%%..%...%%.............
m .............................................................................%%.%...........
m ...........................%....................................................%...........
m ...........................%................................................................
m ...........................%................................................................
m ..................................................................%%........................
m .....................................%%.....................................................
m .......................................%%...................................................
