# map type: blank
# random seed: -267987394
# hill distance  10, 48  50, 86  90, 10
#        10, 48       0      78      78 
#        50, 86      78       0      78 
#        90, 10      78      78       0 
players 3
rows 120
cols 114
m %%%%%%%%%%%%%%.................%%%%%%%...%.................%%..%%%%..%%%%%..%%.....%%%%%%%............%%.%%.%%%%%%
m %%%%%..%%%%%%%................%%%%%%%....%........%%%%.....%%%%%%%%..%%%%...........%%%%%%%..........%%%....%%%%%%
m %.%%%..%%%.%%%%.........%%....%%%%%%%.............%%%%.......%%%%%%.....%%........%%%%%%%%..%......%%%%%%%%%%%%%..
m .........%..%%%%%.......%%%..%%%%%%%%%%.............%%%...%..%%%%%%%%%%.%%........%%%%%%%...%%%......%%%%%%%.%....
m .............%%%%.......%%%%%%%%%%%%%%%%.............%%...%..%%%%%%%%%%..%%.........%%%%%..%%%%......%%%%%%.......
m .............%..%...........%%%%%%%%%%%%%....................%%%%%%%%%%..%%.........%%%%%............%%%%%...%....
m .............%..%.........%%%%%%%%%%%%%%%%...............%....%%%%%%%%%%.......%%.%%%%%%...........%%%%%%%..%%%...
m ............................%..%..%%%%%%%...............%%..%%%%%%%%%%%%%.%%%.%%%.%%%%%..%........%%%%%%%....%....
m ..................................%%%%%%...%..............%%%%%%%%%%%%%%%%%%%%%%%.%%%%...%%......%%%%%%%..........
m ..........................%%%%%%%%%%%%%%..%%%%...............%%%%%%%%%%%%%%%%%%%%..%.%...........%%%%%%%%%%.......
m ......%....................%%..%%%%%%%%%..%%%%..0............%%%%%%%%%%%%%%%%%%%%..%..............%%%%..%.........
m %%%..%%%.%................%%....%....%%%.%%%....................%%%%%%%%%%%%%%%%%%................%%..............
m %%%..%%%%%%%.........................%..%%%%..........%%........%%%%%%%%%%.....%%.....%%%%....%%%.%%.............%
m %%%%%%%%%%%%%............................%%%..........%%.........%%%%%%.%%..%%.........%%......%%%%%%....%%.....%%
m %%%%%%%%%%%%%%%..........................%%%%.........%%....%%..%%%%%%...%%..%%.......%%%......%%%%%%.............
m %%%%%%%%%%%%%%%............%...............%%.........%%....%%%%%%%%%....%%%.%....%..%%......%%%%%%%%.............
m %%%%%%%%%%%%%%%%%%%.......%%................................%%%%%%%%..............%%%%........%%%%%%...........%%%
m %%%%%%%%%%%%%%%%%%..................%%%...%%........%......%%%%.....................%%..........%%%%..........%%%%
m .%%%%%%%%%%%%%%%%%...................%....%%.......%%......%%%%.......................%%.........................%
m .%%%%%%%%%%%%%%%%%%%......................%%..................%.............%%%%......%%%..........%%%............
m .%%%%%%%%%%%%%%%%...%%.......................%%.......................................%%%..........%%%%...........
m ......%%%%%%%%%%%%%..%......................%%%.................%.......................%...........%%............
m ......%%%%%%%%%%%%%.%%........................%%...............%%%%.................................%%............
m ......%%%%...%%%%%%...........................%...............%%......................%%.%%.....%%................
m .%%...%%%....%%%%%%%%%.%.......................................%.....%%................%.%........................
m .............%.%%%%%%%.%...................................%......................................................
m ......%%%...%%...%%%%%.%..................................%%....%.................................................
m ......%%%%%....%%%%%%%...................................%%%.%%%%..%.%.....%%.%.........................%%........
m ...%%%%%%%%%....%%%...................................%..%%%.%%%%..%%%.%....%%%%............%...........%%%%......
m ...%%%%%%%%%%....%..................................%%%.........%%...%%%.....%..............%.........%.......%...
m .%%%%%%%%%%%%%.%.........................%..........%%%..........%%..%%%.............................%%%%%%%.%%...
m ..%%%%%%%%%%%%%%.........................%.....%%%%%%%%..............%%%%............................%%%%%%%%%...%
m ..%%%%%%%%%%%%%%%%................%%............%%%%%%...............%%%%...........................%%%%%%%%%%...%
m ..%%%%%%%%%%%%%%%%..............................%%%%%%........%%......%%...........................%%%%%%%%%%%%...
m ...%%%%%%%%%%%%%%%......%................%.%%.%%%%%%%..............................................%%%%%%%%%%%%...
m %......%%%%%%%%%%%....%%%%...............%....%%%%%%..................%...............%%...........%%%%%%%%%%%%%%.
m %......%%%%%%%.......%%%%%.............%%%..%%%%%%%%%%..............%%%%..............%...........%%%%%%%%%%%%%%%%
m ........%%%%%%..%....%%%%%.............%%%..%%%%%%%%%...............%%%%.......................%%%%%%%%%.%%%%%%%%%
m %........%%%%%%.%.....%%%%............%%%%%%%%%%%%%%%.%%%............%%%%......................%%%%.%%%.....%%%%%%
m %.......%%%%%%......%%%.%....%%....%%%%%%%%%%%%%%%%...%%.............%%%%%..%%%...............%%............%%%%%.
m %%.....%%%%%%%............%%.%%.%%%%%%%%%%%%%%%%%%%%.................%%%%%%%...%.................%%..%%%%..%%%%%..
m ........%%%%%%%..........%%%....%%%%%%%%%%%..%%%%%%%................%%%%%%%....%........%%%%.....%%%%%%%%..%%%%...
m ......%%%%%%%%..%......%%%%%%%%%%%%%..%.%%%..%%%.%%%%.........%%....%%%%%%%.............%%%%.......%%%%%%.....%%..
m ......%%%%%%%...%%%......%%%%%%%.%.............%..%%%%%.......%%%..%%%%%%%%%%.............%%%...%..%%%%%%%%%%.%%..
m ........%%%%%..%%%%......%%%%%%....................%%%%.......%%%%%%%%%%%%%%%%.............%%...%..%%%%%%%%%%..%%.
m ........%%%%%............%%%%%...%.................%..%...........%%%%%%%%%%%%%....................%%%%%%%%%%..%%.
m ...%%.%%%%%%...........%%%%%%%..%%%................%..%.........%%%%%%%%%%%%%%%%...............%....%%%%%%%%%%....
m %.%%%.%%%%%..%........%%%%%%%....%................................%..%..%%%%%%%...............%%..%%%%%%%%%%%%%.%%
m %%%%%.%%%%...%%......%%%%%%%............................................%%%%%%...%..............%%%%%%%%%%%%%%%%%%
m %%%%%..%.%...........%%%%%%%%%%.................................%%%%%%%%%%%%%%..%%%%...............%%%%%%%%%%%%%%%
m %%%%%..%..............%%%%..%...............%....................%%..%%%%%%%%%..%%%%..1............%%%%%%%%%%%%%%%
m %%%%%%................%%..............%%%..%%%.%................%%....%....%%%.%%%....................%%%%%%%%%%%%
m ...%%.....%%%%....%%%.%%.............%%%%..%%%%%%%.........................%..%%%%..........%%........%%%%%%%%%%..
m %%.........%%......%%%%%%....%%.....%%%%%%%%%%%%%%%............................%%%..........%%.........%%%%%%.%%..
m .%%.......%%%......%%%%%%.............%%%%%%%%%%%%%%%..........................%%%%.........%%....%%..%%%%%%...%%.
m .%....%..%%......%%%%%%%%.............%%%%%%%%%%%%%%%............%...............%%.........%%....%%%%%%%%%....%%%
m ......%%%%........%%%%%%...........%%%%%%%%%%%%%%%%%%%%%%.......%%................................%%%%%%%%........
m ........%%..........%%%%..........%%%%%%%%%%%%%%%%%%%%%%..................%%%...%%........%......%%%%.............
m ..........%%.........................%.%%%%%%%%%%%%%%%%%...................%....%%.......%%......%%%%.............
m %%%%......%%%..........%%%.............%%%%%%%%%%%%%%%%%%%......................%%..................%.............
m ..........%%%..........%%%%............%%%%%%%%%%%%%%%%...%%.......................%%.............................
m ............%...........%%..................%%%%%%%%%%%%%..%......................%%%.................%...........
m ........................%%..................%%%%%%%%%%%%%.%%........................%%...............%%%%.........
m ..........%%.%%.....%%......................%%%%...%%%%%%...........................%...............%%............
m ...........%.%.........................%%...%%%....%%%%%%%%%.%.......................................%.....%%.....
m ...................................................%.%%%%%%%.%...................................%................
m ............................................%%%...%%...%%%%%.%..................................%%....%...........
m %.%.........................%%..............%%%%%....%%%%%%%...................................%%%.%%%%..%.%.....%
m %%%%............%...........%%%%.........%%%%%%%%%....%%%...................................%..%%%.%%%%..%%%.%....
m .%..............%.........%.......%......%%%%%%%%%%....%..................................%%%.........%%...%%%....
m .........................%%%%%%%.%%....%%%%%%%%%%%%%.%.........................%..........%%%..........%%..%%%....
m .........................%%%%%%%%%...%..%%%%%%%%%%%%%%.........................%.....%%%%%%%%..............%%%%...
m ........................%%%%%%%%%%...%..%%%%%%%%%%%%%%%%................%%............%%%%%%...............%%%%...
m .......................%%%%%%%%%%%%.....%%%%%%%%%%%%%%%%..............................%%%%%%........%%......%%....
m .......................%%%%%%%%%%%%......%%%%%%%%%%%%%%%......%................%.%%.%%%%%%%.......................
m ..........%%...........%%%%%%%%%%%%%%.%......%%%%%%%%%%%....%%%%...............%....%%%%%%..................%.....
m ..........%...........%%%%%%%%%%%%%%%%%......%%%%%%%.......%%%%%.............%%%..%%%%%%%%%%..............%%%%....
m ...................%%%%%%%%%.%%%%%%%%%........%%%%%%..%....%%%%%.............%%%..%%%%%%%%%...............%%%%....
m ...................%%%%.%%%.....%%%%%%%........%%%%%%.%.....%%%%............%%%%%%%%%%%%%%%.%%%............%%%%...
m %%%...............%%............%%%%%.%.......%%%%%%......%%%.%....%%....%%%%%%%%%%%%%%%%...%%.............%%%%%..
m ...%.................%%..%%%%..%%%%%..%%.....%%%%%%%............%%.%%.%%%%%%%%%%%%%%%%%%%%.................%%%%%%%
m ...%........%%%%.....%%%%%%%%..%%%%...........%%%%%%%..........%%%....%%%%%%%%%%%..%%%%%%%................%%%%%%%.
m ............%%%%.......%%%%%%.....%%........%%%%%%%%..%......%%%%%%%%%%%%%..%.%%%..%%%.%%%%.........%%....%%%%%%%.
m %.............%%%...%..%%%%%%%%%%.%%........%%%%%%%...%%%......%%%%%%%.%.............%..%%%%%.......%%%..%%%%%%%%%
m %%.............%%...%..%%%%%%%%%%..%%.........%%%%%..%%%%......%%%%%%....................%%%%.......%%%%%%%%%%%%%%
m %%%....................%%%%%%%%%%..%%.........%%%%%............%%%%%...%.................%..%...........%%%%%%%%%%
m %%%%...............%....%%%%%%%%%%.......%%.%%%%%%...........%%%%%%%..%%%................%..%.........%%%%%%%%%%%%
m %%%...............%%..%%%%%%%%%%%%%.%%%.%%%.%%%%%..%........%%%%%%%....%................................%..%..%%%%
m %%...%..............%%%%%%%%%%%%%%%%%%%%%%%.%%%%...%%......%%%%%%%............................................%%%%
m %%..%%%%...............%%%%%%%%%%%%%%%%%%%%..%.%...........%%%%%%%%%%.................................%%%%%%%%%%%%
m %%..%%%%..2............%%%%%%%%%%%%%%%%%%%%..%..............%%%%..%...............%....................%%..%%%%%%%
m %%.%%%....................%%%%%%%%%%%%%%%%%%................%%..............%%%..%%%.%................%%....%....%
m ..%%%%..........%%........%%%%%%%%%%.....%%.....%%%%....%%%.%%.............%%%%..%%%%%%%.........................%
m ...%%%..........%%.........%%%%%%.%%..%%.........%%......%%%%%%....%%.....%%%%%%%%%%%%%%%.........................
m ...%%%%.........%%....%%..%%%%%%...%%..%%.......%%%......%%%%%%.............%%%%%%%%%%%%%%%.......................
m .....%%.........%%....%%%%%%%%%....%%%.%....%..%%......%%%%%%%%.............%%%%%%%%%%%%%%%............%..........
m ......................%%%%%%%%..............%%%%........%%%%%%...........%%%%%%%%%%%%%%%%%%%%%%.......%%..........
m %...%%........%......%%%%.....................%%..........%%%%..........%%%%%%%%%%%%%%%%%%%%%%..................%%
m ....%%.......%%......%%%%.......................%%.........................%.%%%%%%%%%%%%%%%%%...................%
m ....%%..................%.............%%%%......%%%..........%%%.............%%%%%%%%%%%%%%%%%%%..................
m .......%%.......................................%%%..........%%%%............%%%%%%%%%%%%%%%%...%%................
m ......%%%.................%.......................%...........%%..................%%%%%%%%%%%%%..%................
m ........%%...............%%%%.................................%%..................%%%%%%%%%%%%%.%%................
m ........%...............%%......................%%.%%.....%%......................%%%%...%%%%%%...................
m .........................%.....%%................%.%.........................%%...%%%....%%%%%%%%%.%..............
m .....................%...................................................................%.%%%%%%%.%..............
m ....................%%....%.......................................................%%%...%%...%%%%%.%..............
m ...................%%%.%%%%..%.%.....%%.%.........................%%..............%%%%%....%%%%%%%................
m ................%..%%%.%%%%..%%%.%....%%%%............%...........%%%%.........%%%%%%%%%....%%%...................
m ..............%%%.........%%...%%%.....%..............%.........%.......%......%%%%%%%%%%....%....................
m ...%..........%%%..........%%..%%%.............................%%%%%%%.%%....%%%%%%%%%%%%%.%......................
m ...%.....%%%%%%%%..............%%%%............................%%%%%%%%%...%..%%%%%%%%%%%%%%......................
m ..........%%%%%%...............%%%%...........................%%%%%%%%%%...%..%%%%%%%%%%%%%%%%................%%..
m ..........%%%%%%........%%......%%...........................%%%%%%%%%%%%.....%%%%%%%%%%%%%%%%....................
m ...%.%%.%%%%%%%..............................................%%%%%%%%%%%%......%%%%%%%%%%%%%%%......%.............
m ...%....%%%%%%..................%...............%%...........%%%%%%%%%%%%%%.%......%%%%%%%%%%%....%%%%............
m .%%%..%%%%%%%%%%..............%%%%..............%...........%%%%%%%%%%%%%%%%%......%%%%%%%.......%%%%%............
m .%%%..%%%%%%%%%...............%%%%.......................%%%%%%%%%.%%%%%%%%%........%%%%%%..%....%%%%%............
m %%%%%%%%%%%%%%%.%%%............%%%%......................%%%%.%%%.....%%%%%%%........%%%%%%.%.....%%%%............
m %%%%%%%%%%%%%...%%.............%%%%%..%%%...............%%............%%%%%.%.......%%%%%%......%%%.%....%%....%%%
