# map type: blank
# random seed: -760800399
# hill distance  31, 36   5, 77
#        31, 36       0      67 
#         5, 77      67       0 
players 2
rows 52
cols 82
m ...................................%..................................%...........
m ...................................%%.............................................
m ..........................%%%.....................................................
m ..........%%......%.......%%%................................%....................
m .........%%%.....%%...%..%%%%%...............................%....................
m .........%%%....%%%%%%%%%%%%%%.....................................%%........1....
m .........%%%....%%%%%%%%%%%%%%%....................................%%.............
m .........%%.....%%%%%%%%%%%........................................%%%%.........%%
m ....%..%%%%.....%%%%%...%............................................%%...........
m ..%%%%%%%%%%%%%%%%%.............................................................%.
m ....%%%%%%%%%%%%%%%.............................................%...........%...%.
m ....%%%%%%%%%%%%%.....................%.........................%...........%...%.
m ..%.%%%%%%.%%%%%%.%..................%%...........................................
m ..%%%%%%....%%%%%%%...............................................................
m ...%%%.......%%%%%%.....%%........................................................
m %..............%%.......%%........................................................
m %...%%...%..............%%.......................................................%
m ......%%%%..............%.........................................................
m ......%...........................................................................
m ..................................................%%..............................
m ....................................%%...%.......%......................%%%.......
m .................................%.%%%...%....%%%%...............%.......%%.......
m .................................%............%%%%...%%..........%................
m ............................................%%%.....%%............................
m .............................%.%..................................................
m .............................%.%.............................................%%...
m .............................%..............................................%.....
m ............................................................................%%....
m ...................................................................%%%............
m ....................%..............................%%......%.......%%%............
m ....................%.............................%%%.....%%...%..%%%%%...........
m ..........................%%........0.............%%%....%%%%%%%%%%%%%%...........
m ..........................%%......................%%%....%%%%%%%%%%%%%%%..........
m ..........................%%%%.........%%.........%%.....%%%%%%%%%%%..............
m ............................%%...............%..%%%%.....%%%%%...%................
m .......................................%...%%%%%%%%%%%%%%%%%......................
m .......................%...........%...%.....%%%%%%%%%%%%%%%......................
m .......................%...........%...%.....%%%%%%%%%%%%%.....................%..
m ...........................................%.%%%%%%.%%%%%%.%..................%%..
m ...........................................%%%%%%....%%%%%%%......................
m ............................................%%%.......%%%%%%.....%%...............
m .........................................%..............%%.......%%...............
m ........................................%%...%%...%..............%%...............
m ...............................................%%%%..............%................
m ...............................................%..................................
m .........%%.......................................................................
m %.......%......................%%%...........................................%%...
m %....%%%%...............%.......%%........................................%.%%%...
m .....%%%%...%%..........%.................................................%.......
m ...%%%.....%%.....................................................................
m ......................................................................%.%.........
m ....................................%%................................%.%.........
