# map type: blank
# random seed: 1676233451
# hill distance  46, 59  72, 35  20, 11
#        46, 59       0      50      50 
#        72, 35      50       0      50 
#        20, 11      50      50       0 
players 3
rows 78
cols 72
m .................%%%%...........................%%................%%%...
m .................%%%%...................................................
m .................%%%%%.........................%%.......................
m .................%%%%%....%%....................%.......................
m .................%%%%%%.......%%........................................
m ..................%%%%%%%..%%%%%%.......................................
m ...............%.%%%%%%%%..%%%%%%.......................................
m ..............%%%%%%%%%%%%.%%%%%%.......................................
m ...................%%%%%%%%%%%%%%...............%%......................
m %..........%%....%..%%.%%%%%.%%.................%%..............%%.%..%%
m ..............%%%%%.%%.%%%%%.%%..........%......%%.............%%%%%%%%%
m %........................................%......%%.................%%%%%
m %........................................%%...........................%%
m .........................................%..............................
m ........................................................................
m ........................................................................
m .......................................................%%...............
m ........................................................%...............
m ................................................%.......................
m ................................................%............%%.........
m ...........2......................................%%....................
m %..%%...........................................%%%%....................
m %%.%%%.............................................%..............%%....
m %%..%.............%%%%............................................%.....
m ..................%%%%%%%%.......................................%%%....
m .....................%%%%..................%.....................%%%%...
m ........................%%................%%%....................%%%%...
m .................................................................%%%%...
m .......................%%........................................%%%%%..
m ..%%....................%........................................%%%%%..
m ......%%.........................................................%%%%%%.
m %..%%%%%%.........................................................%%%%%%
m %..%%%%%%......................................................%.%%%%%%%
m %%.%%%%%%.....................................................%%%%%%%%%%
m %%%%%%%%%...............%%.........................................%%%%%
m %%%%.%%.................%%..............%%.%..%%%..........%%....%..%%.%
m %%%%.%%..........%......%%.............%%%%%%%%%..............%%%%%.%%.%
m .................%......%%.................%%%%%%.......................
m .................%%...........................%%%.......................
m .................%......................................................
m ........................................................................
m ........................................................................
m ...............................%%.......................................
m ................................%.......................................
m ........................%...............................................
m ........................%............%%.................................
m ..........................%%...............................1............
m ........................%%%%....................%..%%...................
m ...........................%..............%%....%%.%%%..................
m ..........................................%.....%%..%.............%%%%..
m %%.......................................%%%......................%%%%%%
m %..................%.....................%%%%........................%%%
m %%................%%%....................%%%%...........................
m .........................................%%%%...........................
m %........................................%%%%%.........................%
m %........................................%%%%%....%%....................
m .........................................%%%%%%.......%%................
m ..........................................%%%%%%%..%%%%%%...............
m .......................................%.%%%%%%%%..%%%%%%...............
m ......................................%%%%%%%%%%%%.%%%%%%...............
m %%.........................................%%%%%%%%%%%%%%...............
m %%..............%%.%..%%%..........%%....%..%%.%%%%%.%%.................
m %%.............%%%%%%%%%..............%%%%%.%%.%%%%%.%%..........%......
m %%.................%%%%%%........................................%......
m ......................%%%........................................%%.....
m .................................................................%......
m ........................................................................
m ........................................................................
m .......%%...............................................................
m ........%...............................................................
m %.......................................................................
m %............%%.........................................................
m ..%%...............................0....................................
m %%%%....................%..%%...........................................
m ...%..............%%....%%.%%%..........................................
m ..................%.....%%..%.............%%%%..........................
m .................%%%......................%%%%%%%%......................
m .................%%%%........................%%%%..................%....
