# map type: blank
# random seed: -461764555
# hill distance  12,117  32, 81  72,  9  52, 45
#        12,117       0      56      56     112 
#        32, 81      56       0     112      56 
#        72,  9      56     112       0      56 
#        52, 45     112      56      56       0 
players 4
rows 80
cols 144
m .%....%%............................%...........%%.....%%.%%...%%%%%.....%..................%%%%%%...................%...%%%............%.......
m .%..................................%............%........%%%.%%%%%%%%%.%%..............%....%%%%%..%%%..............%%...%.............%.......
m ....................................%%.................%%.%%..%.%...%%%..%%%......%%....%%...%%%%%...................%%.........................
m ..........................%%%%%%%.........................%%....%...%%%....%%......%....%...%%%%%%..................%%%%..............%.....%%..
m ...........................%%%%%%%..%%....................%.........%%..%%%...........%.....%%%%..%%...............%%%%%.............%%...%%%%..
m .....%.....................%%%%%%%%.....%%...................%%......%.%%.........%%..%%%%%.%%%..................%.%..%...................%%%...
m %%..%%....................%%..%%%%%......%.................................%%......%%%%.%.%.....................%%........................%%%...
m .%%...........................%%%%%%%%%...%%%..........%...........................%.............................%%%%....................%%.....
m ..............................%%%%%%%%%................%%..........................%.............................%%%%...........................
m %%............................%%%%.%%%%.......%...%..%%%%..%%....................................................%%%%%..........%%%.............
m ...............%...........%....%...........%.%...%%%%%%%%.%%%......................................%............%..............%%%.............
m .....%.........%.......%%%%%................%.....%%%%%%%...........................................%...................%........%%.......%%%...
m .....%................%%%..................%%...%%%%%%%%%%...%%.............................................%%.......0.%%..............%........
m .....................%%%...................%%%%..%%%%%%%%%%%%%%...................................%........%%%.........................%%.%....%
m ..............%%....%%%..%%%..............%%%%%....%%%%%%%%%%%%%..................%%..........%%%%%........%%%.........................%.%%....%
m .................%%.%%%..%%%%%............%%%%%%...%%%%%%%%%%%%%%.................%%.......................%%%..%%%........................%%%%.
m ............%%%%..........%%%%.............%%%%%...%%%%%%%%%%%%%%%................%........................%%.%%%%%........................%%...
m ...........%%%%%...........................%%%%%...%....%%%%%%%.%%.........................................%..%%%%%..................%%%...%%%..
m .........%%%%%%............................%%%%%........%%%%%%%..%...............%..%%.........................%%%%%.................%%.........
m ...........%%.....%%%.......%%%.............%%........%%%%%%%%%..%..............%%..%%..............%..........%%%%%.................%%%........
m %...........%%.....%%.%%...%%%%%.....%..................%%%%%%...................%...%%%............%........%....%%............................
m %............%........%%%.%%%%%%%%%.%%..............%....%%%%%..%%%..............%%...%.............%........%..................................
m %%.................%%.%%..%.%...%%%..%%%......%%....%%...%%%%%...................%%.............................................................
m ......................%%....%...%%%....%%......%....%...%%%%%%..................%%%%..............%.....%%............................%%%%%%%...
m %%....................%.........%%..%%%...........%.....%%%%..%%...............%%%%%.............%%...%%%%.............................%%%%%%%..
m ....%%...................%%......%.%%.........%%..%%%%%.%%%..................%.%..%...................%%%........%.....................%%%%%%%%.
m .....%.................................%%......%%%%.%.%.....................%%........................%%%...%%..%%....................%%..%%%%%.
m %%%...%%%..........%...........................%.............................%%%%....................%%......%%...........................%%%%%%
m %%%................%%..........................%.............................%%%%.........................................................%%%%%%
m %%%.......%...%..%%%%..%%....................................................%%%%%..........%%%.............%%............................%%%%.%
m ........%.%...%%%%%%%%.%%%......................................%............%..............%%%............................%...........%....%...
m ........%.....%%%%%%%...........................................%...................%........%%.......%%%........%.........%.......%%%%%........
m .......%%...%%%%%%%%%%...%%.............................................%%.......1.%%..............%.............%................%%%...........
m .......%%%%..%%%%%%%%%%%%%%...................................%........%%%.........................%%.%....%.....................%%%............
m ......%%%%%....%%%%%%%%%%%%%..................%%..........%%%%%........%%%.........................%.%%....%..............%%....%%%..%%%........
m ......%%%%%%...%%%%%%%%%%%%%%.................%%.......................%%%..%%%........................%%%%..................%%.%%%..%%%%%......
m .......%%%%%...%%%%%%%%%%%%%%%................%........................%%.%%%%%........................%%...............%%%%..........%%%%......
m .......%%%%%...%....%%%%%%%.%%.........................................%..%%%%%..................%%%...%%%.............%%%%%....................
m .......%%%%%........%%%%%%%..%...............%..%%.........................%%%%%.................%%..................%%%%%%.....................
m ........%%........%%%%%%%%%..%..............%%..%%..............%..........%%%%%.................%%%...................%%.....%%%.......%%%.....
m .%..................%%%%%%...................%...%%%............%........%....%%............................%...........%%.....%%.%%...%%%%%....
m %%..............%....%%%%%..%%%..............%%...%.............%........%..................................%............%........%%%.%%%%%%%%%.
m .%%%......%%....%%...%%%%%...................%%.............................................................%%.................%%.%%..%.%...%%%.
m ...%%......%....%...%%%%%%..................%%%%..............%.....%%............................%%%%%%%.........................%%....%...%%%.
m %%%...........%.....%%%%..%%...............%%%%%.............%%...%%%%.............................%%%%%%%..%%....................%.........%%..
m %.........%%..%%%%%.%%%..................%.%..%...................%%%........%.....................%%%%%%%%.....%%...................%%......%.%
m ...%%......%%%%.%.%.....................%%........................%%%...%%..%%....................%%..%%%%%......%..............................
m ...........%.............................%%%%....................%%......%%...........................%%%%%%%%%...%%%..........%................
m ...........%.............................%%%%.........................................................%%%%%%%%%................%%...............
m .........................................%%%%%..........%%%.............%%............................%%%%.%%%%.......%...%..%%%%..%%...........
m ............................%............%..............%%%............................%...........%....%...........%.%...%%%%%%%%.%%%..........
m ............................%...................%........%%.......%%%........%.........%.......%%%%%................%.....%%%%%%%...............
m ....................................%%.......2.%%..............%.............%................%%%..................%%...%%%%%%%%%%...%%.........
m ..........................%........%%%.........................%%.%....%.....................%%%...................%%%%..%%%%%%%%%%%%%%.........
m ..........%%..........%%%%%........%%%.........................%.%%....%..............%%....%%%..%%%..............%%%%%....%%%%%%%%%%%%%........
m ..........%%.......................%%%..%%%........................%%%%..................%%.%%%..%%%%%............%%%%%%...%%%%%%%%%%%%%%.......
m ..........%........................%%.%%%%%........................%%...............%%%%..........%%%%.............%%%%%...%%%%%%%%%%%%%%%......
m ...................................%..%%%%%..................%%%...%%%.............%%%%%...........................%%%%%...%....%%%%%%%.%%......
m .........%..%%.........................%%%%%.................%%..................%%%%%%............................%%%%%........%%%%%%%..%......
m ........%%..%%..............%..........%%%%%.................%%%...................%%.....%%%.......%%%.............%%........%%%%%%%%%..%......
m .........%...%%%............%........%....%%............................%...........%%.....%%.%%...%%%%%.....%..................%%%%%%..........
m .........%%...%.............%........%..................................%............%........%%%.%%%%%%%%%.%%..............%....%%%%%..%%%.....
m .........%%.............................................................%%.................%%.%%..%.%...%%%..%%%......%%....%%...%%%%%..........
m ........%%%%..............%.....%%............................%%%%%%%.........................%%....%...%%%....%%......%....%...%%%%%%..........
m .......%%%%%.............%%...%%%%.............................%%%%%%%..%%....................%.........%%..%%%...........%.....%%%%..%%........
m .....%.%..%...................%%%........%.....................%%%%%%%%.....%%...................%%......%.%%.........%%..%%%%%.%%%.............
m ....%%........................%%%...%%..%%....................%%..%%%%%......%.................................%%......%%%%.%.%.................
m .....%%%%....................%%......%%...........................%%%%%%%%%...%%%..........%...........................%........................
m .....%%%%.........................................................%%%%%%%%%................%%..........................%........................
m .....%%%%%..........%%%.............%%............................%%%%.%%%%.......%...%..%%%%..%%...............................................
m .....%..............%%%............................%...........%....%...........%.%...%%%%%%%%.%%%......................................%.......
m ............%........%%.......%%%........%.........%.......%%%%%................%.....%%%%%%%...........................................%.......
m %%.......3.%%..............%.............%................%%%..................%%...%%%%%%%%%%...%%.............................................
m %%.........................%%.%....%.....................%%%...................%%%%..%%%%%%%%%%%%%%...................................%........%
m %%.........................%.%%....%..............%%....%%%..%%%..............%%%%%....%%%%%%%%%%%%%..................%%..........%%%%%........%
m %%..%%%........................%%%%..................%%.%%%..%%%%%............%%%%%%...%%%%%%%%%%%%%%.................%%.......................%
m %.%%%%%........................%%...............%%%%..........%%%%.............%%%%%...%%%%%%%%%%%%%%%................%........................%
m ..%%%%%..................%%%...%%%.............%%%%%...........................%%%%%...%....%%%%%%%.%%.........................................%
m ...%%%%%.................%%..................%%%%%%............................%%%%%........%%%%%%%..%...............%..%%......................
m ...%%%%%.................%%%...................%%.....%%%.......%%%.............%%........%%%%%%%%%..%..............%%..%%..............%.......
