# map type: blank
# random seed: -710864416
# hill distance   9,  3  69, 79  39, 41
#         9,  3       0      70      70 
#        69, 79      70       0      70 
#        39, 41      70      70       0 
players 3
rows 90
cols 114
m %......................%%%%%%...%............%%%%%%.%.....%%%%%%%%%%%%%%.....%..%.%%%............%%%%...........%%
m %%....................%%%%%.....%............%%%%%%.%.....%%%%%%%%%%%%..........%%%%%.............%%%...........%%
m %%....................%.%%....%...%....%....%%%%%%%.....%%%%%%%%%%%%%%.......%%%%%%%%.............%%%...........%%
m ......................%......%%%..%.%%%%.....%%%%......%%%%%%%%%%%%%%%%.............%............%%%...........%%%
m .............................%%%.%%%%%%%......%........%%%%%%%%%%%%%%%..........................%%%...........%%%%
m ..............................%%.%%%%%.................%%%%%%%%%%%%%%%.........................%%%............%%%.
m %........%%....................%.%%%%%.................%%%%..%%%%%%%%%%........................%%.................
m %.....%%................%%........%%%%%%...............%%%...%%%%%%%%%...................................%%.%%%%%%
m %........%%............%%%%%.......%%%%%..............%....%%%%%%%%%%....................................%%%%%%..%
m %..2....%%%.............%%%%%%.......%%...............%....%%%%%%%%%%%%%%..................................%%%%...
m .........%%.......%..........%%......%%.....................%%%.%%%%%%%%%...........%%.....%%.....................
m ..................%..%%..............%%%........%%%.........%%%...%%%%%%............%%......%.....................
m ......................%..............%%%%%%.....%%%.......%%%%...%%%..............................................
m ........................%............%%%%%%%%...............%..%%%%%.........%%%........................%%%.......
m .%%%%....%..............%..............%%%.%......................%%....%%..%%%%%%%.....................%%%.......
m .%%%%..%%%............................%%...%...............%...........%%%%%%%%%%%%.%%..................%%%.......
m ..%%..%%%..................................%%..............%%%.........%%%%%%%%%%%.......................%%.......
m ..%%..%%%...............%%......%%.........................%%..........%%%%%%%%%%.................................
m ..%%%..%%...............%%.............................................%%%%%%%%%%...................%..%..........
m %%%%%..%%%...................................................%.........%%%%%%%%%..%.%..............%%.%%..........
m %%..%..%%%.......................%...........................%.........%%%%..%....%%%..............%.........%....
m %...%..%%...............%......%%%%..........................%......%%%%%.%.......%%%...........%............%....
m %......%%...............%%.......%....%%.............................%%%........................%...............%%
m %%..........................%.......%%%%...........................%%.............%%.........................%%%.%
m ..........%%%...............%......%%%%%%.........................%................%..............................
m ...................%...%............%%%%.................%.....%%%%%......................................%%%..%..
m %......%.........%%%%%%%..%......%.%%%%%%%...............%.....%%%%%%.................................%%.%%%%%%%%%
m .....%%%.........%%%.%%%..%.%....%%%%%%%%%...............%%...%%%%%%%%..................%..............%%%%%%%%.%%
m .%.................%.%%%%%..%%....%.%%%%%%...............%%.%%%%%%%%%................%%%%%.........%..%%%%%%%%%...
m .%...................%%%%...........%%%..................%...%%%%%%%%%.............%%%%%%.........%%%%%%%%%%%%%...
m .%..%.%%%............%%%%...........%%%......................%%%%%%...%............%%%%%%.%.....%%%%%%%%%%%%%%....
m ....%%%%%.............%%%...........%%%%....................%%%%%.....%............%%%%%%.%.....%%%%%%%%%%%%......
m .%%%%%%%%.............%%%...........%%%%....................%.%%....%...%....%....%%%%%%%.....%%%%%%%%%%%%%%......
m ........%............%%%...........%%%......................%......%%%..%.%%%%.....%%%%......%%%%%%%%%%%%%%%%.....
m ....................%%%...........%%%%.............................%%%.%%%%%%%......%........%%%%%%%%%%%%%%%......
m ...................%%%............%%%...............................%%.%%%%%.................%%%%%%%%%%%%%%%......
m ...................%%.................%........%%....................%.%%%%%.................%%%%..%%%%%%%%%%.....
m .............................%%.%%%%%%%.....%%................%%........%%%%%%...............%%%...%%%%%%%%%......
m .............................%%%%%%..%%........%%............%%%%%.......%%%%%..............%....%%%%%%%%%%.......
m ...............................%%%%...%..1....%%%.............%%%%%%.......%%...............%....%%%%%%%%%%%%%%...
m ........%%.....%%..............................%%.......%..........%%......%%.....................%%%.%%%%%%%%%...
m ........%%......%.......................................%..%%..............%%%........%%%.........%%%...%%%%%%....
m ............................................................%..............%%%%%%.....%%%.......%%%%...%%%........
m .%%%........................%%%...............................%............%%%%%%%%...............%..%%%%%........
m %%%%%%%.....................%%%........%%%%....%..............%..............%%%.%......................%%....%%..
m %%%%%%%.%%..................%%%........%%%%..%%%............................%%...%...............%...........%%%%%
m %%%%%%.......................%%.........%%..%%%..................................%%..............%%%.........%%%%%
m %%%%%...................................%%..%%%...............%%......%%.........................%%..........%%%%%
m %%%%%...................%..%............%%%..%%...............%%.............................................%%%%%
m %%%%..%.%..............%%.%%..........%%%%%..%%%...................................................%.........%%%%%
m .%....%%%..............%.........%....%%..%..%%%.......................%...........................%.........%%%%.
m ......%%%...........%............%....%...%..%%...............%......%%%%..........................%......%%%%%.%.
m ....................%...............%%%......%%...............%%.......%....%%.............................%%%....
m ......%%.........................%%%.%%%..........................%.......%%%%...........................%%.......
m .......%........................................%%%...............%......%%%%%%.........................%.........
m ..............................%%%..%.....................%...%............%%%%.................%.....%%%%%........
m ..........................%%.%%%%%%%%%%......%.........%%%%%%%..%......%.%%%%%%%...............%.....%%%%%%.......
m ............%..............%%%%%%%%.%%.....%%%.........%%%.%%%..%.%....%%%%%%%%%...............%%...%%%%%%%%......
m .........%%%%%.........%..%%%%%%%%%....%.................%.%%%%%..%%....%.%%%%%%...............%%.%%%%%%%%%.......
m .......%%%%%%.........%%%%%%%%%%%%%....%...................%%%%...........%%%..................%...%%%%%%%%%......
m .......%%%%%%.%.....%%%%%%%%%%%%%%.....%..%.%%%............%%%%...........%%%......................%%%%%%...%.....
m .......%%%%%%.%.....%%%%%%%%%%%%..........%%%%%.............%%%...........%%%%....................%%%%%.....%.....
m .%....%%%%%%%.....%%%%%%%%%%%%%%.......%%%%%%%%.............%%%...........%%%%....................%.%%....%...%...
m %%.....%%%%......%%%%%%%%%%%%%%%%.............%............%%%...........%%%......................%......%%%..%.%%
m %%......%........%%%%%%%%%%%%%%%..........................%%%...........%%%%.............................%%%.%%%%%
m .................%%%%%%%%%%%%%%%.........................%%%............%%%...............................%%.%%%%%
m .................%%%%..%%%%%%%%%%........................%%.................%........%%....................%.%%%%%
m %%...............%%%...%%%%%%%%%...................................%%.%%%%%%%.....%%................%%........%%%%
m %%..............%....%%%%%%%%%%....................................%%%%%%..%%........%%............%%%%%.......%%%
m %...............%....%%%%%%%%%%%%%%..................................%%%%...%..0....%%%.............%%%%%%.......%
m %.....................%%%.%%%%%%%%%...........%%.....%%..............................%%.......%..........%%......%
m %%........%%%.........%%%...%%%%%%............%%......%.......................................%..%%..............%
m %%%%%.....%%%.......%%%%...%%%....................................................................%..............%
m %%%%%%%...............%..%%%%%.........%%%........................%%%...............................%............%
m .%%%.%......................%%....%%..%%%%%%%.....................%%%........%%%%....%..............%.............
m %%...%...............%...........%%%%%%%%%%%%.%%..................%%%........%%%%..%%%............................
m .....%%..............%%%.........%%%%%%%%%%%.......................%%.........%%..%%%.............................
m .....................%%..........%%%%%%%%%%...................................%%..%%%...............%%......%%....
m .................................%%%%%%%%%%...................%..%............%%%..%%...............%%............
m .......................%.........%%%%%%%%%..%.%..............%%.%%..........%%%%%..%%%............................
m .......................%.........%%%%..%....%%%..............%.........%....%%..%..%%%.......................%....
m .......................%......%%%%%.%.......%%%...........%............%....%...%..%%...............%......%%%%...
m %%.............................%%%........................%...............%%%......%%...............%%.......%....
m %%...........................%%.............%%.........................%%%.%%%..........................%.......%%
m %%%.........................%................%........................................%%%...............%......%%%
m %%.................%.....%%%%%......................................%%%..%.....................%...%............%%
m %%%%...............%.....%%%%%%.................................%%.%%%%%%%%%%......%.........%%%%%%%..%......%.%%%
m %%%%...............%%...%%%%%%%%..................%..............%%%%%%%%.%%.....%%%.........%%%.%%%..%.%....%%%%%
m %%%%...............%%.%%%%%%%%%................%%%%%.........%..%%%%%%%%%....%.................%.%%%%%..%%....%.%%
m %..................%...%%%%%%%%%.............%%%%%%.........%%%%%%%%%%%%%....%...................%%%%...........%%
