# map type: blank
# random seed: -133605726
# hill distance   6, 40  47, 90  88,140
#         6, 40       0      91      91 
#        47, 90      91       0      91 
#        88,140      91      91       0 
players 3
rows 123
cols 150
m %%...........%...........%%%%%......%.%..%%%%..%%%.....%...................................%%%%%%%%%%....%%...................%%....................%%
m %%...........%.........%%%%%%..%.........%%%%....%.....%%%%.%%..........................%%.%%....%%%.............................................%..%%
m %%.................%....%%%%..%%%.........%%%...........%%...%%..........................%%..................................................%%%%%%%%%
m %%.................%%..%%%....%%%...........%.................%............................%.....................................................%%%%%
m ................%%%%..%%.%....%............................................................%..................................................%%..%%%%
m ..................%%%...............%......................................................%..........................................%...............
m ...................%%%%.............%...1..................................................%..........................................%...............
m ..................%%%%....%%%.....................................%%.................................................................%..........%%....
m ............%....%%%%......%......%%.......................%%....%%%.......................%%%.......................................%%...............
m ............%....%%................................%.....%.%%%%%%%.......................%%%............%%..%%%.......................%........%%.....
m ..............%%...................................%.....%%%%%%%%%%......................%%.............%%.%%%%...............................%%%%....
m .%...........%%%...%...............................%.....%%%%%%%%......................%%%%%...........%%%%%%%..................................%%%%..
m %%.........%%%%%%..%%....................................%%%%%%%.............%%.........%%%%...........%%%%%%%%..................................%%...
m %.........%%%%.............................%...........%%%%%%%..............%%%%.%%.....%%%%...........%%%%%%%%..................................%%...
m %........%%%%.......%......................%..........%%%%%%%%%...............%%..%.....%%%%%.........%..%%%%%.........%%%........................%%..
m ....%.....%.%.......%%..............................%%%%%.%%%%%%%.............%%.........%%%%%........%...%..%.........%%%............................
m ....%................%%................................%..%%%%%%..............%..........%%%%%%........................%%%%....%......................
m ..........................................%%...............%%%%%...............%.........%%%%%..........................%%%....%%.....................
m .........................................%%%................%%.%...............%....%%%.%%%%%.............................%%%%.%%.....................
m ........................................................................................%%%%.............%%.%.....%%.%%%%..%%%%%%.....................
m ...................................%%....................%..%%............................%%.............%%%%%%%%%%%%%%%....%%........................
m .................................%.......................%...............................................%%%.....%%%%%......%%%.......................
m ................................%%....................%.........................................%........%.......%%%%%.......%%.......................
m ............................%%%%......................%.......................%%................%...........%.....%%%%%......%%.......................
m ...............%...........%%%%...............................................%.............................%....%%%%.%%..............................
m .......%%%.....%.%.........%.%........................%............................................%%......%%....%................................%...
m .......%.%%....%.%....................................%............................................%....%%%%%%....................................%%..
m ...............%.%%............................................%%.......................................%%%%%%..............%....................%%%%.
m .................%............................................%%%.......................................%%%%%%..............%............%%......%.%..
m ........................%%.%%%%%........................%%%...%%.................................................................................%....
m %%............%............%%%%%%.............................%...........................%%..............................%........................%%%
m .%............%..........%%%%%%%%%....................%....%%...%%........................%%..............................%....................%%%....
m .........................%%%%%%.................%.....%..............................%.......%.%........................%%..............%.............
m %%..%%...................%%%%%.................%%...%%%%............................%%%......%.%%.....................................%%%.......%%....
m %%%%%%%..................%%%%%.%%..............%%...%................................%.......%..%.....................................%.........%....%
m %%%........................%%%.%............%%.%....%%...........................................%%%%.................%%%%.%%.....................%%%%
m ....%......................%%%..............%%%....%%%%..........%%................%........%.....%..................%%%%%%%.............%.%%....%%%%%
m %...%%%.....................%%..............%%%....%%%%...........%........%.......%%.%%%%%%%%%....................%%%%%%..............%%%%%....%%%%%%
m %...%%......................%%..............%%%.....%%%......%%...%..%.....%%%.....%%%%%%%%%%%.........................................%%%%%.%%.%%%%%%
m %..%%%.........%............................%%.........%....%%.......%..%%%%%%....%%%%%%%%%%%%...%%..................................%%%%%%..%%%%%%%%%
m %....%%......%%%.......................................%%....%......%%.....%%%......%%%%%%%%%%....%%.....%...........................%%%.%%..%%%%%%%%%
m %....%%...................%%....................%%%%...........%...........%%%%%......%.%..%%%%..%%%.....%...................................%%%%%%%%%
m .............................................%..%%%%...........%.........%%%%%%..%.........%%%%....%.....%%%%.%%..........................%%.%%....%%%
m .........................................%%%%%%%%%%%.................%....%%%%..%%%.........%%%...........%%...%%..........................%%.........
m .............................................%%%%%%%.................%%..%%%....%%%...........%.................%............................%........
m ..........................................%%..%%%%................%%%%..%%.%....%............................................................%........
m ..................................%.................................%%%...............%......................................................%........
m ..................................%..................................%%%%.............%...2..................................................%........
m .................................%..........%%......................%%%%....%%%.....................................%%................................
m .................................%%...........................%....%%%%......%......%%.......................%%....%%%.......................%%%......
m ....%%..%%%.......................%........%%.................%....%%................................%.....%.%%%%%%%.......................%%%........
m ....%%.%%%%...............................%%%%..................%%...................................%.....%%%%%%%%%%......................%%.........
m ...%%%%%%%..................................%%%%...%...........%%%...%...............................%.....%%%%%%%%......................%%%%%........
m ...%%%%%%%%..................................%%...%%.........%%%%%%..%%....................................%%%%%%%.............%%.........%%%%........
m ...%%%%%%%%..................................%%...%.........%%%%.............................%...........%%%%%%%..............%%%%.%%.....%%%%........
m ..%..%%%%%.........%%%........................%%..%........%%%%.......%......................%..........%%%%%%%%%...............%%..%.....%%%%%.......
m ..%...%..%.........%%%................................%.....%.%.......%%..............................%%%%%.%%%%%%%.............%%.........%%%%%......
m ...................%%%%....%..........................%................%%................................%..%%%%%%..............%..........%%%%%%.....
m ....................%%%....%%...............................................................%%...............%%%%%...............%.........%%%%%......
m ......................%%%%.%%..............................................................%%%................%%.%...............%....%%%.%%%%%.......
m .....%%.%.....%%.%%%%..%%%%%%.............................................................................................................%%%%........
m .....%%%%%%%%%%%%%%%....%%...........................................................%%....................%..%%............................%%........
m .....%%%.....%%%%%......%%%........................................................%.......................%..........................................
m .....%.......%%%%%.......%%.......................................................%%....................%.........................................%...
m ........%.....%%%%%......%%...................................................%%%%......................%.......................%%................%...
m ........%....%%%%.%%.............................................%...........%%%%...............................................%.....................
m %......%%....%................................%..........%%%.....%.%.........%.%........................%............................................%
m ....%%%%%%....................................%%.........%.%%....%.%....................................%............................................%
m ....%%%%%%..............%....................%%%%................%.%%............................................%%...................................
m ....%%%%%%..............%............%%......%.%...................%............................................%%%...................................
m .............................................%............................%%.%%%%%........................%%%...%%....................................
m ......................%........................%%%%%............%............%%%%%%.............................%...........................%%........
m ......................%....................%%%.....%............%..........%%%%%%%%%....................%....%%...%%........................%%........
m ....................%%..............%......................................%%%%%%.................%.....%..............................%.......%.%....
m ..................................%%%.......%%....%%..%%...................%%%%%.................%%...%%%%............................%%%......%.%%...
m ..................................%.........%....%%%%%%%%..................%%%%%.%%..............%%...%................................%.......%..%...
m %.................%%%%.%%.....................%%%%%%%........................%%%.%............%%.%....%%...........................................%%%
m .................%%%%%%%.............%.%%....%%%%%....%......................%%%..............%%%....%%%%..........%%................%........%.....%.
m ...............%%%%%%..............%%%%%....%%%%%%%...%%%.....................%%..............%%%....%%%%...........%........%.......%%.%%%%%%%%%.....
m ...................................%%%%%.%%.%%%%%%%...%%......................%%..............%%%.....%%%......%%...%..%.....%%%.....%%%%%%%%%%%......
m .................................%%%%%%..%%%%%%%%%%..%%%.........%............................%%.........%....%%.......%..%%%%%%....%%%%%%%%%%%%...%%.
m .....%...........................%%%.%%..%%%%%%%%%%....%%......%%%.......................................%%....%......%%.....%%%......%%%%%%%%%%....%%
m .....%...................................%%%%%%%%%%....%%...................%%....................%%%%...........%...........%%%%%......%.%..%%%%..%%%
m .....%%%%.%%..........................%%.%%....%%%.............................................%..%%%%...........%.........%%%%%%..%.........%%%%....%
m ......%%...%%..........................%%..................................................%%%%%%%%%%%.................%....%%%%..%%%.........%%%.....
m ............%............................%.....................................................%%%%%%%.................%%..%%%....%%%...........%.....
m .........................................%..................................................%%..%%%%................%%%%..%%.%....%...................
m .........................................%..........................................%.................................%%%...............%.............
m .........................................%..........................................%..................................%%%%.............%...0.........
m ................%%.................................................................%..........%%......................%%%%....%%%.....................
m .........%%....%%%.......................%%%.......................................%%...........................%....%%%%......%......%%..............
m .%.....%.%%%%%%%.......................%%%............%%..%%%.......................%........%%.................%....%%...............................
m .%.....%%%%%%%%%%......................%%.............%%.%%%%...............................%%%%..................%%..................................
m .%.....%%%%%%%%......................%%%%%...........%%%%%%%..................................%%%%...%...........%%%...%..............................
m .......%%%%%%%.............%%.........%%%%...........%%%%%%%%..................................%%...%%.........%%%%%%..%%.............................
m .....%%%%%%%..............%%%%.%%.....%%%%...........%%%%%%%%..................................%%...%.........%%%%.............................%......
m ....%%%%%%%%%...............%%..%.....%%%%%.........%..%%%%%.........%%%........................%%..%........%%%%.......%......................%......
m ..%%%%%.%%%%%%%.............%%.........%%%%%........%...%..%.........%%%................................%.....%.%.......%%............................
m .....%..%%%%%%..............%..........%%%%%%........................%%%%....%..........................%................%%...........................
m .........%%%%%...............%.........%%%%%..........................%%%....%%...............................................................%%......
m ..........%%.%...............%....%%%.%%%%%.............................%%%%.%%..............................................................%%%......
m ......................................%%%%.............%%.%.....%%.%%%%..%%%%%%.......................................................................
m .......%..%%............................%%.............%%%%%%%%%%%%%%%....%%...........................................................%%.............
m .......%...............................................%%%.....%%%%%......%%%........................................................%................
m ....%.........................................%........%.......%%%%%.......%%.......................................................%%................
m ....%.......................%%................%...........%.....%%%%%......%%...................................................%%%%..................
m ............................%.............................%....%%%%.%%.............................................%...........%%%%...................
m ....%............................................%%......%%....%................................%..........%%%.....%.%.........%.%....................
m ....%............................................%....%%%%%%....................................%%.........%.%%....%.%................................
m .............%%.......................................%%%%%%..............%....................%%%%................%.%%...............................
m ............%%%.......................................%%%%%%..............%............%%......%.%...................%................................
m ......%%%...%%.................................................................................%............................%%.%%%%%..................
m ............%...........................%%..............................%........................%%%%%............%............%%%%%%.................
m ....%....%%...%%........................%%..............................%....................%%%.....%............%..........%%%%%%%%%................
m ....%..............................%.......%.%........................%%..............%......................................%%%%%%.................%.
m ..%%%%............................%%%......%.%%.....................................%%%.......%%....%%..%%...................%%%%%.................%%.
m ..%................................%.......%..%.....................................%.........%....%%%%%%%%..................%%%%%.%%..............%%.
m ..%%...........................................%%%%.................%%%%.%%.....................%%%%%%%........................%%%.%............%%.%..
m .%%%%..........%%................%........%.....%..................%%%%%%%.............%.%%....%%%%%....%......................%%%..............%%%...
m .%%%%...........%........%.......%%.%%%%%%%%%....................%%%%%%..............%%%%%....%%%%%%%...%%%.....................%%..............%%%...
m ..%%%......%%...%..%.....%%%.....%%%%%%%%%%%.........................................%%%%%.%%.%%%%%%%...%%......................%%..............%%%...
m .....%....%%.......%..%%%%%%....%%%%%%%%%%%%...%%..................................%%%%%%..%%%%%%%%%%..%%%.........%............................%%....
m .....%%....%......%%.....%%%......%%%%%%%%%%....%%.....%...........................%%%.%%..%%%%%%%%%%....%%......%%%..................................
