# map type: blank
# random seed: 501164549
# hill distance  29, 25   3, 51
#        29, 25       0      52 
#         3, 51      52       0 
players 2
rows 52
cols 52
m .........%...........%%..%%.%.......................
m .........%..........................................
m ....................................................
m .........................................%..%%%....1
m ....................................%...%%.%%%%%....
m .................%%%%..............%%%..%%..%%%.....
m .................%......................%%.%%.......
m %%.%.......................................%%.......
m .%%%%%...................%.............%%%.%%%......
m .%%%.....................%.%%%.........%%%%%%.......
m ..%%.....................................%%%........
m ..%%%................%.......%.....%.....%%%........
m ...%..............%..%.......%....%%%...%%%%........
m ...%..............%..........%......%...............
m ..................%%%..%%....%%%%...%..%%...........
m ..................%%....%....%%%%..%%%%%%%....%.....
m ...............................%%%%%%%%%%.....%.....
m %%..................................%%%%%.%...%%%...
m %%%.................................%%....%....%...%
m %%%%.....................................%%%%.......
m .%%%%................%%.......%.........%%%%%%......
m %%%%%................%%.......%..........%.%%%......
m %%%%%.........................%%............%.......
m %%%...........................%......%..%%......%%%.
m %%%%.................................%..........%%%%
m %%%%%................................%.............%
m %.%................................%...........%%..%
m ...................................%................
m ....................................................
m ...............%..%%%....0..........................
m ..........%...%%.%%%%%..............................
m .........%%%..%%..%%%......................%%%%.....
m ..............%%.%%........................%........
m .................%%.......%%.%......................
m .............%%%.%%%.......%%%%%...................%
m .%%%.........%%%%%%........%%%.....................%
m ...............%%%..........%%......................
m ...%.....%.....%%%..........%%%................%....
m ...%....%%%...%%%%...........%..............%..%....
m ...%......%..................%..............%.......
m ...%%%%...%..%%.............................%%%..%%.
m ...%%%%..%%%%%%%....%.......................%%....%.
m .....%%%%%%%%%%.....%...............................
m ..........%%%%%.%...%%%...%%........................
m ..........%%....%....%...%%%%.......................
m ...............%%%%.......%%%%......................
m ....%.........%%%%%%.......%%%%................%%...
m ....%..........%.%%%......%%%%%................%%...
m ....%%............%.......%%%%%.....................
m ....%......%..%%......%%%.%%%.......................
m ...........%..........%%%%%%%%......................
m ...........%.............%%%%%%.....................
