# map type: blank
# random seed: 1885867259
# hill distance  75,  8  35, 46
#        75,  8       0      78 
#        35, 46      78       0 
players 2
rows 80
cols 76
m ................................%%%%%%%%%%%.....................%%%%%.......
m .................................%%%%%%%%%%%................................
m ...........................%%%%..%%%%%%%%%%.....................%%%.........
m ..........................%%%%%%%%%%%%%%%%%.....................%%%%...%....
m .............................%%%%%%%%%%..%%.....................%..%%..%%...
m ...............%..............%%%%%..%.....................%%......%%..%....
m ...............%%.............%%%%%........................%......%%...%....
m ..............%%%................%.......%%..................%..............
m ..............%%%.........................%%%%............%%%%%........%....
m ....%%....%..%%%%............................%.............%...........%....
m ...%%%%%%%%%%%%%....................................................%%%%%...
m ...%%%%%%%%%%%%...................................................%%%%.%....
m .%%%%%%%%%%%%%%%%.................................................%%%%......
m ..%%%..%%%%%%%%%%.................................................%%%%..%...
m ......%%%%%%%%%%%....................................%............%%%%.%%%.%
m ......%%%%%%%%%%%....................................%............%%%%..%%.%
m .%.....%%%%%%%%%%...%%...%.........%%%%...................%%.......%%...%%..
m %%.%..%%%%%%%%%%%....%...%..........%%...................%%%%...........%%%%
m %%%%%%%%%%%%%%%%..%%....................................%%%%%%...........%%%
m %%%%%%%%%%%%%%%%..%%.....................................%%%%%............%%
m %%%%%%%%%%%%%%%%..%%%....................................%%%%%%.%%........%%
m .%%%%%%%%%%%%%....%%..............%........................%%%%.%%.........%
m .%%%%%%%%%%%%%...................%%.....................%%..................
m ..%%%%%%%%%%%%......%.........%%%%%.....................%%.............%%...
m ..%%%%%%%%%%%%......%%........%....%%.........................%%......%%....
m ..%%%%%%..%%%%%%%%...%........%...%%%...................%%....%%............
m ...%%%%%..%%%%...............%%.........................%%%.................
m ...%%%%%%..%%%%...............%%%......................%%%%.%%%%............
m ..%%%%.......%%...............%%..%.%...............%..%%%%%%%%.............
m ..%%%%%...........................%%%.............%%%..%%%%%%%%%%%%...%%....
m ...%%%%............................................%....%%%...%%%%%%%.%%....
m ....%%%%%%.........................................%....%%....%%%%%%%%%.....
m .%%%%%%%%%..............................................%.....%%%%%%%%%%....
m .%%%%%%%%%%..................................................%%%%%%%%%%%....
m ..%%%%%%.%%.................................................%%%%%%%%%%%%....
m %%%%%%%.......................................1.............%%%%%%%%..%%....
m %%%%%%..................%%...................................%%..%%%..%%%%..
m %%%%%%..................%%%%%%...................................%%....%%%%%
m %%%%%%%..................%%%%%%...................................%..%%%%%%%
m %%%%%%...................%%%%%%%..................................%..%%%%%%%
m %%%%%.....................%%%%%.......................................%%%%%%
m %%%%%%.................................................................%%%%%
m %%%%%.....................%%%....................................%%%%..%%%%%
m %%%%%.....................%%%%...%..............................%%%%%%%%%%%%
m %..%%.....................%..%%..%%................................%%%%%%%%%
m .....................%%......%%..%...................%..............%%%%%..%
m .....................%......%%...%...................%%.............%%%%%...
m ...%%..................%............................%%%................%....
m ....%%%%............%%%%%........%..................%%%.....................
m .......%.............%...........%........%%....%..%%%%.....................
m ..............................%%%%%......%%%%%%%%%%%%%......................
m ............................%%%%.%.......%%%%%%%%%%%%.......................
m ............................%%%%.......%%%%%%%%%%%%%%%%.....................
m ............................%%%%..%.....%%%..%%%%%%%%%%.....................
m ...............%............%%%%.%%%.%......%%%%%%%%%%%.....................
m ...............%............%%%%..%%.%......%%%%%%%%%%%.....................
m %...................%%.......%%...%%...%.....%%%%%%%%%%...%%...%.........%%%
m ...................%%%%...........%%%%%%.%..%%%%%%%%%%%....%...%..........%%
m ..................%%%%%%...........%%%%%%%%%%%%%%%%%%%..%%..................
m ...................%%%%%............%%%%%%%%%%%%%%%%%%..%%..................
m ...................%%%%%%.%%........%%%%%%%%%%%%%%%%%%..%%%.................
m .....................%%%%.%%.........%.%%%%%%%%%%%%%....%%..............%...
m ..................%%...................%%%%%%%%%%%%%...................%%...
m ..................%%.............%%.....%%%%%%%%%%%%......%.........%%%%%...
m ........................%%......%%......%%%%%%%%%%%%......%%........%....%%.
m ..................%%....%%..............%%%%%%..%%%%%%%%...%........%...%%%.
m ..................%%%....................%%%%%..%%%%...............%%.......
m .................%%%%.%%%%...............%%%%%%..%%%%...............%%%.....
m ..............%..%%%%%%%%...............%%%%.......%%...............%%..%.%.
m ............%%%..%%%%%%%%%%%%...%%......%%%%%...........................%%%.
m .............%....%%%...%%%%%%%.%%.......%%%%...............................
m .............%....%%....%%%%%%%%%.........%%%%%%............................
m ..................%.....%%%%%%%%%%.....%%%%%%%%%............................
m .......................%%%%%%%%%%%.....%%%%%%%%%%...........................
m ......................%%%%%%%%%%%%......%%%%%%.%%...........................
m ........0.............%%%%%%%%..%%....%%%%%%%...............................
m .......................%%..%%%..%%%%..%%%%%%..................%%............
m ...........................%%....%%%%%%%%%%%..................%%%%%%........
m ............................%..%%%%%%%%%%%%%%..................%%%%%%.......
m ............................%..%%%%%%%%%%%%%...................%%%%%%%......
