# map type: blank
# random seed: 2013777480
# hill distance   2, 77  46, 37
#         2, 77       0      84 
#        46, 37      84       0 
players 2
rows 88
cols 80
m .......%%%.....%................................................................
m ...............%................................................................
m ...........%.................................................................1..
m ..........%%....................................................................
m ........%%%%%...........%%......................................................
m .%%............%%........%......................................................
m ..........%...%%%%.........%%...................................................
m ..........%....%%%......%..%....................................................
m ................%.......%%%%%...................................................
m ..................%.%%%%%%%.....................................................
m .................%%%%%%%%%%..................................................%..
m .................%%%%%%%%%%.......%.........................................%%%.
m ..................%%%%%%%%%.......%.............................................
m ...............%%.%%%%%%%%......................................................
m ...............%%%%%%%%%%%.....%%%..............................................
m ...............%%%%%%%%%%%.....%%.......%%%.....................................
m .................%%%%%%%%......%........%%......................................
m ..................%%%%%.........................................................
m ..................%%%%%.........................................................
m ...................%%%....%%....................................................
m ....................%............................................%..............
m ........................%%................................%%.....%%.............
m ........................%%...................................%%%%%..............
m ........................%....................................%%%%%..............
m .............................................................%%.................
m .............................................................%..................
m ................................................................................
m .......................................................%%..%....................
m .....................................................%%%...%%...........%%%%%...
m ..........................................................................%%....
m ....................................................%...........................
m ....................................................%...........................
m ................................................................................
m ................................................................................
m .........................................%......................................
m .........................................%......................................
m ................................................................................
m ..........................................%.....................................
m ...%......................................%.%%..................................
m ...%%...........................................................................
m ................................................................................
m ................................................................................
m ................................................................................
m ................................................................................
m ...............................................%%%.....%........................
m .......................................................%........................
m .....................................0.............%............................
m ..................................................%%............................
m ................................................%%%%%...........%%..............
m .........................................%%............%%........%..............
m ..................................................%...%%%%.........%%...........
m ..................................................%....%%%......%..%............
m ........................................................%.......%%%%%...........
m ..........................................................%.%%%%%%%.............
m .....................................%...................%%%%%%%%%%.............
m ....................................%%%..................%%%%%%%%%%.......%.....
m ..........................................................%%%%%%%%%.......%.....
m .......................................................%%.%%%%%%%%..............
m .......................................................%%%%%%%%%%%.....%%%......
m %%%....................................................%%%%%%%%%%%.....%%.......
m %%.......................................................%%%%%%%%......%........
m ..........................................................%%%%%.................
m ..........................................................%%%%%.................
m ...........................................................%%%....%%............
m .........................%..................................%...................
m ..................%%.....%%.....................................%%..............
m .....................%%%%%......................................%%..............
m .....................%%%%%......................................%...............
m .....................%%.........................................................
m .....................%..........................................................
m ................................................................................
m ...............%%..%............................................................
m .............%%%...%%...........%%%%%...........................................
m ..................................%%............................................
m ............%...................................................................
m ............%...................................................................
m ................................................................................
m ................................................................................
m .%..............................................................................
m .%..............................................................................
m ................................................................................
m ..%.............................................................................
m ..%.%%.....................................%....................................
m ...........................................%%...................................
m ................................................................................
m ................................................................................
m ................................................................................
m ................................................................................
