# map type: blank
# random seed: -801634773
# hill distance   2, 21  34, 58
#         2, 21       0      69 
#        34, 58      69       0 
players 2
rows 64
cols 74
m ..........................%%......................................%..%%...
m ..................................................................%.......
m .....................0..........................%.........................
m ................................................%%.............%..........
m ...............................................................%..........
m ............%.............................................................
m ......%%....%%...............%%.....................%.....................
m .......%..%%%%%.....................................%%....................
m ..........%%%%%%%%.....................................................%..
m ..%........%....%%.....%%%.............................................%%.
m %.%.....................%%..................%%%..............%%.......%%%%
m %...%%...................................%%%%%%..............%%....%%..%%%
m ...........................................%...........%%..%......%%%..%%.
m .......................................................%%%.%%%%%%.........
m .........................................................%%.%%%%%%%%......
m ......................................%%....................%%%%%%%%%%%...
m ......................................%%..............%...%%%%%%%%%%%%%...
m .............................%%......%%...............%%.%%%%%%%%%%%%%%...
m .................................%%%.....................%%%%%%%%%%%%.....
m ...............................%%%%..%%........%..........%%%%%%%%%.......
m .........................%.....%%%....%.....%%%%%%%.........%%%...........
m .............%...........%......%.....%%....%%%%%%%%.........%%...........
m .............%.........................%..%%%%%%%%%%......................
m ............%%%.....................%.%%....%..%%%%.......................
m ............%%%%%%%.................%...........%%........................
m ............%%%%%%%..........................%..%.........................
m ............%%%%%%%........................%.%%.%.........................
m ..............%%%%%%.......................%.................%............
m ..................%%%%.......................................%............
m ..............%...%%..........%...........................................
m ..............%...............%%..........................................
m ...........%%.................%%%%............................%%..........
m .............................%..%%.............................%%.........
m .............................%............................................
m ...........%..............................................1...............
m ...........%%.............%...............................................
m ..........................%...............................................
m .................................................%........................
m ...............%...........................%%....%%...............%%......
m ...............%%...........................%..%%%%%......................
m ..................................%............%%%%%%%%...................
m ..................................%%...%........%....%%.....%%%...........
m .......%%%..............%%.......%%%%%.%.....................%%...........
m ....%%%%%%..............%%....%%..%%%%...%%...............................
m ......%...........%%..%......%%%..%%......................................
m ..................%%%.%%%%%%..............................................
m ....................%%.%%%%%%%%...........................................
m .%%....................%%%%%%%%%%%........................................
m .%%..............%...%%%%%%%%%%%%%........................................
m %%...............%%.%%%%%%%%%%%%%%................................%%......
m ....................%%%%%%%%%%%%......................................%%%.
m %%........%..........%%%%%%%%%......................................%%%%..
m .%.....%%%%%%%.........%%%....................................%.....%%%...
m .%%....%%%%%%%%.........%%........................%...........%......%....
m ..%..%%%%%%%%%%...................................%.......................
m .%%....%..%%%%...................................%%%.....................%
m ...........%%....................................%%%%%%%.................%
m ........%..%.....................................%%%%%%%..................
m ......%.%%.%.....................................%%%%%%%..................
m ......%.................%..........................%%%%%%.................
m ........................%..............................%%%%...............
m ...................................................%...%%..........%......
m ...................................................%...............%%.....
m .........................%%.....................%%.................%%%%...
