# map type: blank
# random seed: 1089322860
# hill distance  48,  6   4, 43
#        48,  6       0      81 
#         4, 43      81       0 
players 2
rows 88
cols 74
m .....................................................%%%%%%.....%%%%%%%%..
m .....................................%.............%......%..%..%%%..%....
m ...%...........................%...%%%%........%%%%%%%%......%.%%.........
m ...%...........................%%..%%%%%.......%%%%%%%%...................
m ...%%%%...................%%........%%%....0...%%.%...................%%%.
m ...%%%%.................%%%%.........%%%................................%%
m ..%%%%%.........%%%.....%%%%..%%.....%%......%%%........................%%
m ...%%............%%%%...%%%%%........%%......%%%%%........................
m %..%..............%.....%%%%%.....%%%%%....%%%%%%%.......................%
m %%......................%%%%%%..%.........%%%%%%%..%%.%...................
m %%%.........................%%..%%%.......%%%%%%%..%%%%%..................
m %%%.........................%............%%%%%%%...%%%%%%.................
m ...........................%%.............%%%%%%%...%%%%.............%....
m .......................................%.%%%%%%%%%..%%%%%............%....
m ...............................%%....%%%%%%%%%%%%%..%%%..............%....
m ...............................%%....%%%%%%%%%%%%%%...%.....%.......%%....
m ......%.%%%.................%%%%%....%%%%%%%%%%%%%........%%%.......%%....
m ...%%%%%%%%..................%.%%....%%%%%%%%%%%%%.......%%%%%......%%....
m ...%%%%%%%%%...................%.....%%%%%%%%%%%%.........%%%%%...%%%.....
m ....%%%%%%%%.........................%%%%%%%%%%%%%..........%%%%..%%......
m .%%....%%%%%.........................%..%%%%%%%%%...............%%%%......
m ......%%%%...........................%..%%%%%%%%%%..............%...%%....
m ........................................%%%%%%%%%%%................%%.....
m .....%..................................%%%%%%%%%%%%...............%%.....
m .....%.............%%.................%%%%%%%%%%%%%%..............%%%%....
m %%%%%%%%%..........%%%..%%%%%.......%%%%%%%%%%%%%%%%%..............%%.%%%.
m .....%%%%....%%......%.%%%%%%%......%%%%%%%%%%%%%%%%%.................%%..
m .....%%%.%%............%%%%%%%%.....%%%%%%%%%%%%%%%%...................%..
m .......%.%%..............%%%%%%....%%%%%%%%%%%%%%%%%%..%%%................
m ..........................%%%%%....%%%%%%%%%%%%%%%%%%%....................
m ...........................%%.%%%...%%%%%%%%%%%%%%%%%%%................%..
m ....................%%%%%%......%%%..%%%%%%%%%%%%...%%%......%%%%%%...%%%%
m ..%%%................%%%%%%...%..%%%....%%%%......%...%.......%%%%%%..%%%%
m %..%.%...............%%%%%%%%%%....%...%%%%......%%...........%%%%%%%%...%
m .....%%.............%%%%%%%%%%%%%.....%%%%........%..........%%%%%%..%...%
m .....%%...............%%%%%%%%%%......%%%....................%%%%%........
m .......................%%%%%%%%%%%%%%%%.%.....................%%%%%%......
m .......................%%%%%%%%%%%%%%%...........................%%%......
m ....................%.%%%%%%%%%%%%%....%.......%%..%%.....................
m ..............%...%%%%%%%%%%%%%%%%%...%%..%%.%%%%%.%..............%%......
m ..............%%..%%%%%%%%%%%%%%%%%...%%.....%%%%...%%....................
m ...............%%%%%%%%%%%%%%%%%%%%.....%...%%%%%....%%...................
m ................%%%%%%%%%%%%%%%%%%%.....%%....%......%%...................
m ...............%%%%%%%%%%%%%%%%%%%%.......................................
m ................%%%%%%.....%%%%%%%%.......................................
m %.............%......%..%..%%%..%.........................................
m %%........%%%%%%%%......%.%%............%...........................%...%%
m %%%.......%%%%%%%%......................%...........................%%..%%
m %%....1...%%.%...................%%%....%%%%...................%%........%
m %%%................................%%...%%%%.................%%%%.........
m %%......%%%........................%%..%%%%%.........%%%.....%%%%..%%.....
m %%......%%%%%...........................%%............%%%%...%%%%%........
m %%....%%%%%%%.......................%%..%..............%.....%%%%%.....%%%
m .....%%%%%%%..%%.%...................%%......................%%%%%%..%....
m .....%%%%%%%..%%%%%..................%%%.........................%%..%%%..
m ....%%%%%%%...%%%%%%.................%%%.........................%........
m .....%%%%%%%...%%%%.............%...............................%%........
m ..%.%%%%%%%%%..%%%%%............%.........................................
m %%%%%%%%%%%%%..%%%..............%...................................%%....
m %%%%%%%%%%%%%%...%.....%.......%%...................................%%....
m %%%%%%%%%%%%%........%%%.......%%..........%.%%%.................%%%%%....
m %%%%%%%%%%%%%.......%%%%%......%%.......%%%%%%%%..................%.%%....
m %%%%%%%%%%%%.........%%%%%...%%%........%%%%%%%%%...................%.....
m %%%%%%%%%%%%%..........%%%%..%%..........%%%%%%%%.........................
m %..%%%%%%%%%...............%%%%.......%%....%%%%%.........................
m %..%%%%%%%%%%..............%...%%..........%%%%...........................
m ...%%%%%%%%%%%................%%..........................................
m ...%%%%%%%%%%%%...............%%..........%...............................
m .%%%%%%%%%%%%%%..............%%%%.........%.............%%................
m %%%%%%%%%%%%%%%%..............%%.%%%.%%%%%%%%%..........%%%..%%%%%.......%
m %%%%%%%%%%%%%%%%.................%%.......%%%%....%%......%.%%%%%%%......%
m %%%%%%%%%%%%%%%...................%.......%%%.%%............%%%%%%%%.....%
m %%%%%%%%%%%%%%%%..%%%.......................%.%%..............%%%%%%....%%
m %%%%%%%%%%%%%%%%%..............................................%%%%%....%%
m %%%%%%%%%%%%%%%%%%................%.............................%%.%%%...%
m %%%%%%%%%%%%...%%%......%%%%%%...%%%%....................%%%%%%......%%%..
m ...%%%%......%...%.......%%%%%%..%%%%..%%%................%%%%%%...%..%%%.
m ..%%%%......%%...........%%%%%%%%...%%..%.%...............%%%%%%%%%%....%.
m .%%%%........%..........%%%%%%..%...%.....%%.............%%%%%%%%%%%%%....
m .%%%....................%%%%%.............%%...............%%%%%%%%%%.....
m %%.%.....................%%%%%%.............................%%%%%%%%%%%%%%
m %...........................%%%.............................%%%%%%%%%%%%%%
m ..%.......%%..%%.........................................%.%%%%%%%%%%%%%..
m .%%..%%.%%%%%.%..............%%....................%...%%%%%%%%%%%%%%%%%..
m .%%.....%%%%...%%..................................%%..%%%%%%%%%%%%%%%%%..
m ...%...%%%%%....%%..................................%%%%%%%%%%%%%%%%%%%%..
m ...%%....%......%%...................................%%%%%%%%%%%%%%%%%%%..
m ....................................................%%%%%%%%%%%%%%%%%%%%..
