# map type: blank
# random seed: 1483969936
# hill distance  64,130  93, 93   6, 56  35, 19
#        64,130       0      66     132      66 
#        93, 93      66       0      66     132 
#         6, 56     132      66       0      66 
#        35, 19      66     132      66       0 
players 4
rows 116
cols 148
m .............%..%..............%%%.%.........%%........................................................................................%%..%....%...
m .............%%%%.....................................................................................................%%................%.....%.%%..
m .............%%................%%%...................................................................................%%%%.................%...%.....
m .............%%....%%%......%%%%%%%%................................................................................%%%%..................%%%..%%...
m .......%%%...%......%%..%...%%%.%%%%................................................................................%%%%............%......%%..%%...
m ....%%%%%...%%%....%%%..%%..%%......................................................................................%%%%%...........%......%%%...%%.
m .....%%%..%%%%%....%.....%..%%..........................2.........................................................%%%%%%............%%...........%..
m .........%%%%%%..........%%%%%.....%..................................................................%..........%%%%%%%%.%%.......%%%...........%..
m .....%%%%%%%%%%..%%.......%%%%.....%%%................................................................%%%..........%%%%%%..%......%%%%...........%..
m ......%%%%%.%%%...%%%......%%......%...................................................................%%%..%%.....%%%%%%.........%.................
m ......%%%%%...%................%%.............................................................%%..%....%%%..%%.....%%%%%%%%............%%...........
m ......%%%.....%.......%%......%%............................................%.................%%..%%..%%%%%...%%..%%%%%...%.........................
m ............................%%%%%...........................................%........................%%%............%%...%%.........................
m ..................%.........%.........................................................................%%............................................
m ..................%.................................................................................................................................
m .........................................................%............................................................%.%%................%.........
m .........................................................%............................................................%%%%%...............%.........
m ................%........................................%..........................................................%%%%..................%..%......
m ................%...................................................................................................%%%.....................%%......
m ...............................%%...................................................%.%.............................%.%......................%......
m .......................%.......%%%%%................................................%%%...............................%.....................%%......
m .......................%........%%%%........................................................................................................%%%.....
m ...............................%%%%%%%%%....................................................................................................%%......
m .................................%%%%%..............................................................................................................
m %................................%%%%%.......................................................................................%%%%%%%%...............
m %................................%%%%%........................................................................%................%..................%%
m ................................%%%%..%..%%...................................................%...............%%%%%.......%%%.......................
m .................................%%...%..%%%%.................................................%.......%.......%%%%%%.%....%%%%......................
m %.........................................%%..................................................%...%%.%%........%.....%......%.....%%............%.%%
m ........%%........................................................................................%%..%....%................%..%..............%%%.%.
m .................................................................................%%................%.....%.%%...............%%%%....................
m ................................................................................%%%%.................%...%..................%%................%%%...
m ...............................................................................%%%%..................%%%..%%................%%....%%%......%%%%%%%%.
m ...............................................................................%%%%............%......%%..%%..........%%%...%......%%..%...%%%.%%%%.
m ...............................................................................%%%%%...........%......%%%...%%.....%%%%%...%%%....%%%..%%..%%.......
m ...................1.........................................................%%%%%%............%%...........%.......%%%..%%%%%....%.....%..%%.......
m .................................................................%..........%%%%%%%%.%%.......%%%...........%...........%%%%%%..........%%%%%.....%.
m %................................................................%%%..........%%%%%%..%......%%%%...........%.......%%%%%%%%%%..%%.......%%%%.....%%
m ..................................................................%%%..%%.....%%%%%%.........%.......................%%%%%.%%%...%%%......%%......%.
m .........................................................%%..%....%%%..%%.....%%%%%%%%............%%.................%%%%%...%................%%....
m .......................................%.................%%..%%..%%%%%...%%..%%%%%...%...............................%%%.....%.......%%......%%.....
m .......................................%........................%%%............%%...%%.....................................................%%%%%....
m .................................................................%%..............................................................%.........%........
m .................................................................................................................................%..................
m ....................%............................................................%.%%................%..............................................
m ....................%............................................................%%%%%...............%..............................................
m ....................%..........................................................%%%%..................%..%......................%....................
m ...............................................................................%%%.....................%%......................%....................
m ...............................................%.%.............................%.%......................%.....................................%%....
m ...............................................%%%...............................%.....................%%.............................%.......%%%%%.
m .......................................................................................................%%%............................%........%%%%.
m %%%....................................................................................................%%.....................................%%%%%%
m %...............................................................................................................................................%%%%
m %.......................................................................................%%%%%%%%...............%................................%%%%
m %........................................................................%................%..................%%%................................%%%%
m .%..%%...................................................%...............%%%%%.......%%%.......................................................%%%%.
m .%..%%%%.................................................%.......%.......%%%%%%.%....%%%%.......................................................%%..
m .....%%..................................................%...%%.%%........%.....%......%.....%%............%.%%%....................................
m .............................................................%%..%....%................%..%..............%%%.%.........%%...........................
m ............................................%%................%.....%.%%...............%%%%.........................................................
m ...........................................%%%%.................%...%..................%%................%%%........................................
m ..........................................%%%%..................%%%..%%................%%....%%%......%%%%%%%%......................................
m ..........................................%%%%............%......%%..%%..........%%%...%......%%..%...%%%.%%%%......................................
m ..........................................%%%%%...........%......%%%...%%.....%%%%%...%%%....%%%..%%..%%............................................
m ........................................%%%%%%............%%...........%.......%%%..%%%%%....%.....%..%%..........................0.................
m ............................%..........%%%%%%%%.%%.......%%%...........%...........%%%%%%..........%%%%%.....%......................................
m ............................%%%..........%%%%%%..%......%%%%...........%.......%%%%%%%%%%..%%.......%%%%.....%%%....................................
m .............................%%%..%%.....%%%%%%.........%.......................%%%%%.%%%...%%%......%%......%......................................
m ....................%%..%....%%%..%%.....%%%%%%%%............%%.................%%%%%...%................%%.........................................
m ..%.................%%..%%..%%%%%...%%..%%%%%...%...............................%%%.....%.......%%......%%..........................................
m ..%........................%%%............%%...%%.....................................................%%%%%.........................................
m ............................%%..............................................................%.........%.............................................
m ............................................................................................%.......................................................
m ............................................%.%%................%..................................................................%................
m ............................................%%%%%...............%..................................................................%................
m ..........................................%%%%..................%..%......................%........................................%................
m ..........................................%%%.....................%%......................%.........................................................
m ..........%.%.............................%.%......................%.....................................%%.........................................
m ..........%%%...............................%.....................%%.............................%.......%%%%%......................................
m ..................................................................%%%............................%........%%%%......................................
m ..................................................................%%.....................................%%%%%%%%%..................................
m ...........................................................................................................%%%%%....................................
m ...................................................%%%%%%%%...............%................................%%%%%....................................
m ....................................%................%..................%%%................................%%%%%....................................
m ....................%...............%%%%%.......%%%.......................................................%%%%..%..%%...............................
m ....................%.......%.......%%%%%%.%....%%%%.......................................................%%...%..%%%%.............................
m ....................%...%%.%%........%.....%......%.....%%............%.%%%.........................................%%..............................
m ........................%%..%....%................%..%..............%%%.%.........%%................................................................
m .......%%................%.....%.%%...............%%%%..............................................................................................
m ......%%%%.................%...%..................%%................%%%.............................................................................
m .....%%%%..................%%%..%%................%%....%%%......%%%%%%%%...........................................................................
m .....%%%%............%......%%..%%..........%%%...%......%%..%...%%%.%%%%...........................................................................
m .....%%%%%...........%......%%%...%%.....%%%%%...%%%....%%%..%%..%%.................................................................................
m ...%%%%%%............%%...........%.......%%%..%%%%%....%.....%..%%..........................3......................................................
m ..%%%%%%%%.%%.......%%%...........%...........%%%%%%..........%%%%%.....%..................................................................%........
m ....%%%%%%..%......%%%%...........%.......%%%%%%%%%%..%%.......%%%%.....%%%................................................................%%%......
m ....%%%%%%.........%.......................%%%%%.%%%...%%%......%%......%...................................................................%%%..%%.
m ....%%%%%%%%............%%.................%%%%%...%................%%.............................................................%%..%....%%%..%%.
m %..%%%%%...%...............................%%%.....%.......%%......%%............................................%.................%%..%%..%%%%%...%
m .....%%...%%.....................................................%%%%%...........................................%........................%%%.......
m .......................................................%.........%.........................................................................%%.......
m .......................................................%............................................................................................
m .......%.%%................%..................................................................%.....................................................
m .......%%%%%...............%..................................................................%.....................................................
m .....%%%%..................%..%......................%........................................%.....................................................
m .....%%%.....................%%......................%..............................................................................................
m .....%.%......................%.....................................%%...................................................%.%........................
m .......%.....................%%.............................%.......%%%%%................................................%%%........................
m .............................%%%............................%........%%%%...........................................................................
m .............................%%.....................................%%%%%%%%%.......................................................................
m ......................................................................%%%%%.........................................................................
m ..............%%%%%%%%...............%................................%%%%%.........................................................................
m ................%..................%%%................................%%%%%........................................................................%
m %%%%.......%%%.......................................................%%%%..%..%%...................................................%...............%
m %%%%%.%....%%%%.......................................................%%...%..%%%%.................................................%.......%.......%
m %.....%......%.....%%............%.%%%.........................................%%..................................................%...%%.%%........
