# map type: blank
# random seed: -1955180518
# hill distance  69, 25 119, 75  94, 50  19,100  44,  0
#        69, 25       0     100      50     100      50 
#       119, 75     100       0      50      50     100 
#        94, 50      50      50       0     100     100 
#        19,100     100      50     100       0      50 
#        44,  0      50     100     100      50       0 
players 5
rows 125
cols 125
m .........................................%%%%%%%............................................%%%%...%%%%%%%%%%%%%%%%%.........
m ...................................%%..%%%%%%%%%...........%...%%...........................%..%..%%%%%%%%%%%%%%%%%%.........
m ...................................%%%%%%%%%%%%%%..........%%%%%%.................................%%%%%%%%%%%%%%%............
m %.................................%%%%%%%%%%%%%%%%.........%%%%.%.................................%%%%%%%%%%%%%%%%..........%
m ...............................%%%%%%%%%%%%%%%%%%%%%...%%%%%%%......%.%.........................%%%%%%%%%%%%%%%%%%%..........
m ..........%...................%%%%%%%%%%%%%%%%%%%%%%...%%%%%%%.%%...%.%............................%..%%%%%%%..%%%...........
m ..........%...................%%%%%%%%%%%%%%%%%%%%%....%%%%%%%.%%......%%.......%.......................%%%%%%.%%%...........
m ..........%%..................%%%%%%%.%%%%%%%%%%%%%....%%...%%.......%%.........%......................%%%%%%%..%............
m ..........%..................%%%%%....%%%%%%%%%%%%%%%%.%....%%.......%.................................%%%%.....%............
m .............................%%%%.......%%%%%%%%%%%%%%.%.%.............................................%%%%..................
m .............................%%%%......%%%...%%%%%%%...%.%.............................................%%%%..................
m .............................%%%.......%.%...%%%%%%%............%%.....................................%%%...%%..............
m ...............%.............%%...............%%%%%%............%...............................................%%...........
m ...............%%%...........%%................%%%%%.........................................................%..%%...........
m ............%.%%%%..........%%%...%%...........%%%%.......................................................%%.%...%%..........
m ............%%%%%...........%%%%%.%%%..........%%%%.......................................................%%.......%.........
m ............%%%%............%......%%................................%.%...................................%%......%%..%.....
m ...............%............%..%%%%%%%%..............................%%%%%....................................%%.....%.%%%...
m ...............................%%%%%%%%.............................%%%%%%..............................%%....%......%...%...
m ...............................%%%%......................%...........%%%%%..........................2...%..................%.
m %%.............................%%%%......................%%%.......%%%%%%%............................%%...................%%
m %%%........%%..................%%....................................%%%%%..........................................%.......%
m %%%%%......%%%%.........%......%...................................%%%%%%......................................%...%%....%%%%
m %%%%%%%%....%%%%........%%........................................%%%%%%%%.....................................%..%%%%%%%%.%%
m %%%%%%%%%%%.%%%%..................................................%%%%%%%%%%...................................%..%%.%%%%....
m %%%%%%%%%%%%%%%%..................................................%%%%%%%............................................%%%%...%
m %%%%%%%%%%%%%%%%............................................%%..%%%%%%%%%...........%...%%...........................%..%..%%
m %%%%%%%%%%%%%...............................................%%%%%%%%%%%%%%..........%%%%%%.................................%%
m %%%%%%%%%%%%%%..........%%.................................%%%%%%%%%%%%%%%%.........%%%%.%.................................%%
m %%%%%%%%%%%%%%%.........................................%%%%%%%%%%%%%%%%%%%%%...%%%%%%%......%.%.........................%%%%
m ..%%%%%%%..%%%.....................%...................%%%%%%%%%%%%%%%%%%%%%%...%%%%%%%.%%...%.%............................%
m ....%%%%%%.%%%.....................%...................%%%%%%%%%%%%%%%%%%%%%....%%%%%%%.%%......%%.......%...................
m ...%%%%%%%..%......................%%..................%%%%%%%.%%%%%%%%%%%%%....%%...%%.......%%.........%...................
m ...%%%%.....%......................%..................%%%%%....%%%%%%%%%%%%%%%%.%....%%.......%..............................
m ...%%%%...............................................%%%%.......%%%%%%%%%%%%%%.%.%..........................................
m ...%%%%...............................................%%%%......%%%...%%%%%%%...%.%..........................................
m ...%%%...%%...........................................%%%.......%.%...%%%%%%%............%%..................................
m ............%%..........................%.............%%...............%%%%%%............%...................................
m .........%..%%..........................%%%...........%%................%%%%%................................................
m ......%%.%...%%......................%.%%%%..........%%%...%%...........%%%%.................................................
m ......%%.......%.....................%%%%%...........%%%%%.%%%..........%%%%.................................................
m .......%%......%%..%.................%%%%............%......%%................................%.%............................
m ..........%%.....%.%%%..................%............%..%%%%%%%%..............................%%%%%..........................
m ....%%....%......%...%..................................%%%%%%%%.............................%%%%%%..........................
m 4...%..................%................................%%%%......................%...........%%%%%..........................
m ..%%...................%%%%.............................%%%%......................%%%.......%%%%%%%..........................
m ................%.......%%%%........%%..................%%....................................%%%%%..........................
m ...........%...%%....%%%%%%%%%......%%%%.........%......%...................................%%%%%%...........................
m ...........%..%%%%%%%%.%%%%%%%%%%....%%%%........%%........................................%%%%%%%%..........................
m ...........%..%%.%%%%....%%%%%%%%%%%.%%%%..................................................%%%%%%%%%%........................
m .................%%%%...%%%%%%%%%%%%%%%%%..................................................%%%%%%%...........................
m .................%..%..%%%%%%%%%%%%%%%%%%............................................%%..%%%%%%%%%...........%...%%..........
m .......................%%%%%%%%%%%%%%%...............................................%%%%%%%%%%%%%%..........%%%%%%..........
m .......................%%%%%%%%%%%%%%%%..........%%.................................%%%%%%%%%%%%%%%%.........%%%%.%..........
m .....................%%%%%%%%%%%%%%%%%%%.........................................%%%%%%%%%%%%%%%%%%%%%...%%%%%%%......%.%....
m ........................%..%%%%%%%..%%%.....................%...................%%%%%%%%%%%%%%%%%%%%%%...%%%%%%%.%%...%.%....
m .....%.......................%%%%%%.%%%.....................%...................%%%%%%%%%%%%%%%%%%%%%....%%%%%%%.%%......%%..
m .....%......................%%%%%%%..%......................%%..................%%%%%%%.%%%%%%%%%%%%%....%%...%%.......%%....
m ............................%%%%.....%......................%..................%%%%%....%%%%%%%%%%%%%%%%.%....%%.......%.....
m ............................%%%%...............................................%%%%.......%%%%%%%%%%%%%%.%.%.................
m ............................%%%%...............................................%%%%......%%%...%%%%%%%...%.%.................
m ............................%%%...%%...........................................%%%.......%.%...%%%%%%%............%%.........
m .....................................%%..........................%.............%%...............%%%%%%............%..........
m ..................................%..%%..........................%%%...........%%................%%%%%.......................
m ...............................%%.%...%%......................%.%%%%..........%%%...%%...........%%%%........................
m ...............................%%.......%.....................%%%%%...........%%%%%.%%%..........%%%%........................
m ................................%%......%%..%.................%%%%............%......%%................................%.%...
m ...................................%%.....%.%%%..................%............%..%%%%%%%%..............................%%%%%.
m .............................%%....%......%...%..................................%%%%%%%%.............................%%%%%%.
m .........................1...%..................%................................%%%%......................%...........%%%%%.
m ...........................%%...................%%%%.............................%%%%......................%%%.......%%%%%%%.
m .........................................%.......%%%%........%%..................%%....................................%%%%%.
m ....................................%...%%....%%%%%%%%%......%%%%.........%......%...................................%%%%%%..
m ....................................%..%%%%%%%%.%%%%%%%%%%....%%%%........%%........................................%%%%%%%%.
m %...................................%..%%.%%%%....%%%%%%%%%%%.%%%%..................................................%%%%%%%%%
m ..........................................%%%%...%%%%%%%%%%%%%%%%%..................................................%%%%%%%..
m .........%...%%...........................%..%..%%%%%%%%%%%%%%%%%%............................................%%..%%%%%%%%%..
m .........%%%%%%.................................%%%%%%%%%%%%%%%...............................................%%%%%%%%%%%%%%.
m .........%%%%.%.................................%%%%%%%%%%%%%%%%..........%%.................................%%%%%%%%%%%%%%%%
m %%...%%%%%%%......%.%.........................%%%%%%%%%%%%%%%%%%%.........................................%%%%%%%%%%%%%%%%%%%
m %%...%%%%%%%.%%...%.%............................%..%%%%%%%..%%%.....................%...................%%%%%%%%%%%%%%%%%%%%
m %....%%%%%%%.%%......%%.......%.......................%%%%%%.%%%.....................%...................%%%%%%%%%%%%%%%%%%%%
m %....%%...%%.......%%.........%......................%%%%%%%..%......................%%..................%%%%%%%.%%%%%%%%%%%%
m %%%%.%....%%.......%.................................%%%%.....%......................%..................%%%%%....%%%%%%%%%%%%
m %%%%.%.%.............................................%%%%...............................................%%%%.......%%%%%%%%%%
m %%...%.%.............................................%%%%...............................................%%%%......%%%...%%%%%
m %%............%%.....................................%%%...%%...........................................%%%.......%.%...%%%%%
m %%............%...............................................%%..........................%.............%%...............%%%%
m %%.........................................................%..%%..........................%%%...........%%................%%%
m %.......................................................%%.%...%%......................%.%%%%..........%%%...%%...........%%%
m %.......................................................%%.......%.....................%%%%%...........%%%%%.%%%..........%%%
m ...................%.%...................................%%......%%..%.................%%%%............%......%%.............
m ...................%%%%%....................................%%.....%.%%%..................%............%..%%%%%%%%...........
m ..................%%%%%%..............................%%....%......%...%..................................%%%%%%%%...........
m .......%...........%%%%%..........................3...%..................%................................%%%%...............
m .......%%%.......%%%%%%%............................%%...................%%%%.............................%%%%...............
m ...................%%%%%..........................................%.......%%%%........%%..................%%.................
m .................%%%%%%......................................%...%%....%%%%%%%%%......%%%%.........%......%..................
m ................%%%%%%%%.....................................%..%%%%%%%%.%%%%%%%%%%....%%%%........%%........................
m ................%%%%%%%%%%...................................%..%%.%%%%....%%%%%%%%%%%.%%%%..................................
m ................%%%%%%%............................................%%%%...%%%%%%%%%%%%%%%%%..................................
m ..........%%..%%%%%%%%%...........%...%%...........................%..%..%%%%%%%%%%%%%%%%%%..................................
m ..........%%%%%%%%%%%%%%..........%%%%%%.................................%%%%%%%%%%%%%%%.....................................
m .........%%%%%%%%%%%%%%%%.........%%%%.%.................................%%%%%%%%%%%%%%%%..........%%........................
m ......%%%%%%%%%%%%%%%%%%%%%...%%%%%%%......%.%.........................%%%%%%%%%%%%%%%%%%%...................................
m .....%%%%%%%%%%%%%%%%%%%%%%...%%%%%%%.%%...%.%............................%..%%%%%%%..%%%.....................%..............
m .....%%%%%%%%%%%%%%%%%%%%%....%%%%%%%.%%......%%.......%.......................%%%%%%.%%%.....................%..............
m .....%%%%%%%.%%%%%%%%%%%%%....%%...%%.......%%.........%......................%%%%%%%..%......................%%.............
m ....%%%%%....%%%%%%%%%%%%%%%%.%....%%.......%.................................%%%%.....%......................%..............
m ....%%%%.......%%%%%%%%%%%%%%.%.%.............................................%%%%...........................................
m ....%%%%......%%%...%%%%%%%...%.%.............................................%%%%...........................................
m ....%%%.......%.%...%%%%%%%............%%.....................................%%%...%%.......................................
m ....%%...............%%%%%%............%...............................................%%..........................%.........
m ....%%................%%%%%.........................................................%..%%..........................%%%.......
m ...%%%...%%...........%%%%.......................................................%%.%...%%......................%.%%%%.......
m ...%%%%%.%%%..........%%%%.......................................................%%.......%.....................%%%%%........
m ...%......%%................................%.%...................................%%......%%..%.................%%%%.........
m ...%..%%%%%%%%..............................%%%%%....................................%%.....%.%%%..................%.........
m ......%%%%%%%%.............................%%%%%%..............................%%....%......%...%............................
m ......%%%%......................%...........%%%%%..........................0...%..................%..........................
m ......%%%%......................%%%.......%%%%%%%............................%%...................%%%%.......................
m ......%%....................................%%%%%..........................................%.......%%%%........%%............
m ......%...................................%%%%%%......................................%...%%....%%%%%%%%%......%%%%.........%
m %........................................%%%%%%%%.....................................%..%%%%%%%%.%%%%%%%%%%....%%%%........%
m .........................................%%%%%%%%%%...................................%..%%.%%%%....%%%%%%%%%%%.%%%%.........
