rows 119
cols 126
players 7
m .........%%%%%%%%%%%%%%....%%%%%%%%%%...%...%%%%........%%........%%%%%%%.....%%%%%.%%%%%%%%%....%%%........%%%%%%%%%%..%%%...
m ....%%.%.%%%%%%%%%%%%%%%....%%%%%%%%%...%%..%%%...%%%...%%.....%%..%%%%%%......%%%%..%%%%%%......%%%%%%......%%%%%%%%..%%%%..%
m %......%%%%%%%%%%%%%%%........%%%%%%%%%%%%%.%%%%%.%%%..%%%%........%%%%%%......%%%..%%%%%%..%.....%%%%%...%..%%%%%%%%..%%%%..%
m .......%%.%%%%%%%%%%%%........%%%%%%%.%%%%%%%%%%%.%...%%%%%%%....%%%%%%%%........%..%%%%...%%..%...%%%%..%%...%%%%%%...%%%%%..
m ...........%%%%%%%%%%.........%%..%%%.%%%%%%%%%%%.......%%..%.%%%%%%%%%%...........%%%%%....%.%%...%%%%.%%..%%..%%%%....%%%%..
m ............%.%%%%%%%.........%.........%%%%%%%%%%%.............%%%%%%%%.........%%%%%%%...%%%.....%.............%%%.....%%%..
m ..3..............%%%..........%..........%%%%..%%...................%.%%%%........%%........%...........%%.....%.%%%%.........
m .................%%%..........%.....%%%..%%%...%%......................%%....%%%..%..%%%....%.................%%..............
m ..................%%%........%%.....%%%%.%%%%%.......%%%.......%%..%...%%%...%%%.%%%%%%%......................%%..............
m ...................%...%.....%%......%%%...%%%.......%%%.......%..%%%..%%%%%%%%%%%%%%%%%....................%%%%..............
m .......................%%%.................%%........%%%......%%..%%%%.%%%%%%%%%%%%%%%%%%...................%%%...............
m .............%..........%%..%........%%....%..........%%...........%%%.%%%%%%%%%%%%%%%%.%.....................................
m .............%..%.......%%..%.........%..%%%.........%%%%......%%%%%%%.%%%%.%%%%%%%%%%........%%%.............................
m ................%.....%%%...%............%%%.........%%%%%..................%%%%%%%%%%......%.%........................%......
m %%%...........%%.....%%%%.......%.%%....%%%..........%%%%%%..........%........%%%%%%%%.....%%%%.......%%%%....%%.....%%%...%.%
m %%%%..........%%%.%%.%%%%%....%%%%%%%%.%%%%...........%%%%%%......%%%%...........%%%%%%%%%%%%%%.......%%%%%%%.%%....%%%....%..
m .%%%%........%%%%.%..%.%%%.....%%%%%%%%%%%%%..........%%%%%%%%%...%%......%%%%...%%%%%%%%%%%%%%...%%%%%%%%%%%.......%%%.......
m ..%%........%%%%%%%.....%%%%%.%%%%%%%%%....%%%........%%%%%%%%%%..%%%............%%%%%%%%%%%%%%....%%%%%%%%%%...%...%%%%......
m ..%%.....%%..%%%%%%......%%%%..%%%%%%......%%%%%%......%%%%%%%%..%%%%..%....%%.%.%%%%%%%%%%%%%%%....%%%%%%%%%...%%..%%%...%%%.
m .%%%%........%%%%%%......%%%..%%%%%%..%.....%%%%%...%..%%%%%%%%..%%%%..%%......%%%%%%%%%%%%%%%........%%%%%%%%%%%%%.%%%%%.%%%.
m %%%%%%%....%%%%%%%%........%..%%%%...%%..%...%%%%..%%...%%%%%%...%%%%%.........%%.%%%%%%%%%%%%........%%%%%%%.%%%%%%%%%%%.%...
m ..%%..%.%%%%%%%%%%...........%%%%%....%.%%...%%%%.%%..%%..%%%%....%%%%.............%%%%%%%%%%.........%%..%%%.%%%%%%%%%%%.....
m ..........%%%%%%%%.........%%%%%%%...%%%.....%.............%%%.....%%%..............%.%%%%%%%.........%.........%%%%%%%%%%%...
m ..............%.%%%%........%%........%...........%%.....%.%%%%...........2..............%%%..........%..........%%%%..%%.....
m .................%%....%%%..%..%%%....%.................%%...............................%%%..........%.....%%%..%%%...%%.....
m %%.......%%..%...%%%...%%%.%%%%%%%......................%%................................%%%........%%.....%%%%.%%%%%.......%
m %%.......%..%%%..%%%%%%%%%%%%%%%%%....................%%%%.................................%...%.....%%......%%%...%%%.......%
m %%......%%..%%%%.%%%%%%%%%%%%%%%%%%...................%%%......................................%%%.................%%........%
m %%...........%%%.%%%%%%%%%%%%%%%%.%..................................................%..........%%..%........%%....%..........
m %%%......%%%%%%%.%%%%.%%%%%%%%%%........%%%..........................................%..%.......%%..%.........%..%%%.........%
m %%%%..................%%%%%%%%%%......%.%........................%......................%.....%%%...%............%%%.........%
m %%%%%..........%........%%%%%%%%.....%%%%.......%%%%....%%.....%%%...%.%%%%...........%%.....%%%%.......%.%%....%%%..........%
m %%%%%%......%%%%...........%%%%%%%%%%%%%%.......%%%%%%%.%%....%%%....%..%%%%..........%%%.%%.%%%%%....%%%%%%%%.%%%%...........
m %%%%%%%%%...%%......%%%%...%%%%%%%%%%%%%%...%%%%%%%%%%%.......%%%........%%%%........%%%%.%..%.%%%.....%%%%%%%%%%%%%..........
m %%%%%%%%%%..%%%............%%%%%%%%%%%%%%....%%%%%%%%%%...%...%%%%........%%........%%%%%%%.....%%%%%.%%%%%%%%%....%%%........
m .%%%%%%%%..%%%%..%....%%.%.%%%%%%%%%%%%%%%....%%%%%%%%%...%%..%%%...%%%...%%.....%%..%%%%%%......%%%%..%%%%%%......%%%%%%.....
m .%%%%%%%%..%%%%..%%......%%%%%%%%%%%%%%%........%%%%%%%%%%%%%.%%%%%.%%%..%%%%........%%%%%%......%%%..%%%%%%..%.....%%%%%...%.
m ..%%%%%%...%%%%%.........%%.%%%%%%%%%%%%........%%%%%%%.%%%%%%%%%%%.%...%%%%%%%....%%%%%%%%........%..%%%%...%%..%...%%%%..%%.
m %%..%%%%....%%%%.............%%%%%%%%%%.........%%..%%%.%%%%%%%%%%%.......%%..%.%%%%%%%%%%...........%%%%%....%.%%...%%%%.%%..
m .....%%%.....%%%..............%.%%%%%%%.........%.........%%%%%%%%%%%.............%%%%%%%%.........%%%%%%%...%%%.....%........
m ...%.%%%%...........1..............%%%..........%..........%%%%..%%...................%.%%%%........%%........%...........%%..
m ..%%...............................%%%..........%.....%%%..%%%...%%......................%%....%%%..%..%%%....%...............
m ..%%................................%%%........%%.....%%%%.%%%%%.......%%%.......%%..%...%%%...%%%.%%%%%%%....................
m %%%%.................................%...%.....%%......%%%...%%%.......%%%.......%..%%%..%%%%%%%%%%%%%%%%%....................
m %%%......................................%%%.................%%........%%%......%%..%%%%.%%%%%%%%%%%%%%%%%%...................
m ...............................%..........%%..%........%%....%..........%%...........%%%.%%%%%%%%%%%%%%%%.%...................
m ...............................%..%.......%%..%.........%..%%%.........%%%%......%%%%%%%.%%%%.%%%%%%%%%%........%%%...........
m ...........%......................%.....%%%...%............%%%.........%%%%%..................%%%%%%%%%%......%.%.............
m ..%%.....%%%...%.%%%%...........%%.....%%%%.......%.%%....%%%..........%%%%%%..........%........%%%%%%%%.....%%%%.......%%%%..
m %.%%....%%%....%..%%%%..........%%%.%%.%%%%%....%%%%%%%%.%%%%...........%%%%%%......%%%%...........%%%%%%%%%%%%%%.......%%%%%%
m %.......%%%........%%%%........%%%%.%..%.%%%.....%%%%%%%%%%%%%..........%%%%%%%%%...%%......%%%%...%%%%%%%%%%%%%%...%%%%%%%%%%
m %...%...%%%%........%%........%%%%%%%.....%%%%%.%%%%%%%%%....%%%........%%%%%%%%%%..%%%............%%%%%%%%%%%%%%....%%%%%%%%%
m %...%%..%%%...%%%...%%.....%%..%%%%%%......%%%%..%%%%%%......%%%%%%......%%%%%%%%..%%%%..%....%%.%.%%%%%%%%%%%%%%%....%%%%%%%%
m %%%%%%%.%%%%%.%%%..%%%%........%%%%%%......%%%..%%%%%%..%.....%%%%%...%..%%%%%%%%..%%%%..%%......%%%%%%%%%%%%%%%........%%%%%%
m %.%%%%%%%%%%%.%...%%%%%%%....%%%%%%%%........%..%%%%...%%..%...%%%%..%%...%%%%%%...%%%%%.........%%.%%%%%%%%%%%%........%%%%%%
m %.%%%%%%%%%%%.......%%..%.%%%%%%%%%%...........%%%%%....%.%%...%%%%.%%..%%..%%%%....%%%%.............%%%%%%%%%%.........%%..%%
m ....%%%%%%%%%%%.............%%%%%%%%.........%%%%%%%...%%%.....%.............%%%.....%%%..............%.%%%%%%%.........%.....
m .....%%%%..%%...................%.%%%%........%%........%...........%%.....%.%%%%...........0..............%%%..........%.....
m %%%..%%%...%%......................%%....%%%..%..%%%....%.................%%...............................%%%..........%.....
m %%%%.%%%%%.......%%%.......%%..%...%%%...%%%.%%%%%%%......................%%................................%%%........%%.....
m .%%%...%%%.......%%%.......%..%%%..%%%%%%%%%%%%%%%%%....................%%%%.................................%...%.....%%.....
m .......%%........%%%......%%..%%%%.%%%%%%%%%%%%%%%%%%...................%%%......................................%%%..........
m .%%....%..........%%...........%%%.%%%%%%%%%%%%%%%%.%..................................................%..........%%..%.......
m ..%..%%%.........%%%%......%%%%%%%.%%%%.%%%%%%%%%%........%%%..........................................%..%.......%%..%.......
m .....%%%.........%%%%%..................%%%%%%%%%%......%.%........................%......................%.....%%%...%.......
m ....%%%..........%%%%%%..........%........%%%%%%%%.....%%%%.......%%%%....%%.....%%%...%.%%%%...........%%.....%%%%.......%.%%
m %%.%%%%...........%%%%%%......%%%%...........%%%%%%%%%%%%%%.......%%%%%%%.%%....%%%....%..%%%%..........%%%.%%.%%%%%....%%%%%%
m %%%%%%%%..........%%%%%%%%%...%%......%%%%...%%%%%%%%%%%%%%...%%%%%%%%%%%.......%%%........%%%%........%%%%.%..%.%%%.....%%%%%
m %%%....%%%........%%%%%%%%%%..%%%............%%%%%%%%%%%%%%....%%%%%%%%%%...%...%%%%........%%........%%%%%%%.....%%%%%.%%%%%%
m %......%%%%%%......%%%%%%%%..%%%%..%....%%.%.%%%%%%%%%%%%%%%....%%%%%%%%%...%%..%%%...%%%...%%.....%%..%%%%%%......%%%%..%%%%%
m ..%.....%%%%%...%..%%%%%%%%..%%%%..%%......%%%%%%%%%%%%%%%........%%%%%%%%%%%%%.%%%%%.%%%..%%%%........%%%%%%......%%%..%%%%%%
m .%%..%...%%%%..%%...%%%%%%...%%%%%.........%%.%%%%%%%%%%%%........%%%%%%%.%%%%%%%%%%%.%...%%%%%%%....%%%%%%%%........%..%%%%..
m ..%.%%...%%%%.%%..%%..%%%%....%%%%.............%%%%%%%%%%.........%%..%%%.%%%%%%%%%%%.......%%..%.%%%%%%%%%%...........%%%%%..
m .%%%.....%.............%%%.....%%%..............%.%%%%%%%.........%.........%%%%%%%%%%%.............%%%%%%%%.........%%%%%%%..
m ..%...........%%.....%.%%%%...........6..............%%%..........%..........%%%%..%%...................%.%%%%........%%......
m ..%.................%%...............................%%%..........%.....%%%..%%%...%%......................%%....%%%..%..%%%..
m ....................%%................................%%%........%%.....%%%%.%%%%%.......%%%.......%%..%...%%%...%%%.%%%%%%%..
m ..................%%%%.................................%...%.....%%......%%%...%%%.......%%%.......%..%%%..%%%%%%%%%%%%%%%%%..
m ..................%%%......................................%%%.................%%........%%%......%%..%%%%.%%%%%%%%%%%%%%%%%%.
m .................................................%..........%%..%........%%....%..........%%...........%%%.%%%%%%%%%%%%%%%%.%.
m ....%%%..........................................%..%.......%%..%.........%..%%%.........%%%%......%%%%%%%.%%%%.%%%%%%%%%%....
m ..%.%........................%......................%.....%%%...%............%%%.........%%%%%..................%%%%%%%%%%....
m .%%%%.......%%%%....%%.....%%%...%.%%%%...........%%.....%%%%.......%.%%....%%%..........%%%%%%..........%........%%%%%%%%....
m %%%%%.......%%%%%%%.%%....%%%....%..%%%%..........%%%.%%.%%%%%....%%%%%%%%.%%%%...........%%%%%%......%%%%...........%%%%%%%%%
m %%%%%...%%%%%%%%%%%.......%%%........%%%%........%%%%.%..%.%%%.....%%%%%%%%%%%%%..........%%%%%%%%%...%%......%%%%...%%%%%%%%%
m %%%%%....%%%%%%%%%%...%...%%%%........%%........%%%%%%%.....%%%%%.%%%%%%%%%....%%%........%%%%%%%%%%..%%%............%%%%%%%%%
m %%%%%%....%%%%%%%%%...%%..%%%...%%%...%%.....%%..%%%%%%......%%%%..%%%%%%......%%%%%%......%%%%%%%%..%%%%..%....%%.%.%%%%%%%%%
m %%%%........%%%%%%%%%%%%%.%%%%%.%%%..%%%%........%%%%%%......%%%..%%%%%%..%.....%%%%%...%..%%%%%%%%..%%%%..%%......%%%%%%%%%%%
m %%%%........%%%%%%%.%%%%%%%%%%%.%...%%%%%%%....%%%%%%%%........%..%%%%...%%..%...%%%%..%%...%%%%%%...%%%%%.........%%.%%%%%%%%
m %%%.........%%..%%%.%%%%%%%%%%%.......%%..%.%%%%%%%%%%...........%%%%%....%.%%...%%%%.%%..%%..%%%%....%%%%.............%%%%%%%
m %%%.........%.........%%%%%%%%%%%.............%%%%%%%%.........%%%%%%%...%%%.....%.............%%%.....%%%..............%.%%%%
m %%..........%..........%%%%..%%...................%.%%%%........%%........%...........%%.....%.%%%%...........5..............%
m %%..........%.....%%%..%%%...%%......................%%....%%%..%..%%%....%.................%%...............................%
m %%%........%%.....%%%%.%%%%%.......%%%.......%%..%...%%%...%%%.%%%%%%%......................%%................................
m .%...%.....%%......%%%...%%%.......%%%.......%..%%%..%%%%%%%%%%%%%%%%%....................%%%%................................
m .....%%%.................%%........%%%......%%..%%%%.%%%%%%%%%%%%%%%%%%...................%%%.................................
m ......%%..%........%%....%..........%%...........%%%.%%%%%%%%%%%%%%%%.%..................................................%....
m ......%%..%.........%..%%%.........%%%%......%%%%%%%.%%%%.%%%%%%%%%%........%%%..........................................%..%.
m ....%%%...%............%%%.........%%%%%..................%%%%%%%%%%......%.%........................%......................%.
m ...%%%%.......%.%%....%%%..........%%%%%%..........%........%%%%%%%%.....%%%%.......%%%%....%%.....%%%...%.%%%%...........%%..
m %%.%%%%%....%%%%%%%%.%%%%...........%%%%%%......%%%%...........%%%%%%%%%%%%%%.......%%%%%%%.%%....%%%....%..%%%%..........%%%.
m %..%.%%%.....%%%%%%%%%%%%%..........%%%%%%%%%...%%......%%%%...%%%%%%%%%%%%%%...%%%%%%%%%%%.......%%%........%%%%........%%%%.
m %.....%%%%%.%%%%%%%%%....%%%........%%%%%%%%%%..%%%............%%%%%%%%%%%%%%....%%%%%%%%%%...%...%%%%........%%........%%%%%%
m %......%%%%..%%%%%%......%%%%%%......%%%%%%%%..%%%%..%....%%.%.%%%%%%%%%%%%%%%....%%%%%%%%%...%%..%%%...%%%...%%.....%%..%%%%%
m %......%%%..%%%%%%..%.....%%%%%...%..%%%%%%%%..%%%%..%%......%%%%%%%%%%%%%%%........%%%%%%%%%%%%%.%%%%%.%%%..%%%%........%%%%%
m %........%..%%%%...%%..%...%%%%..%%...%%%%%%...%%%%%.........%%.%%%%%%%%%%%%........%%%%%%%.%%%%%%%%%%%.%...%%%%%%%....%%%%%%%
m ...........%%%%%....%.%%...%%%%.%%..%%..%%%%....%%%%.............%%%%%%%%%%.........%%..%%%.%%%%%%%%%%%.......%%..%.%%%%%%%%%%
m .........%%%%%%%...%%%.....%.............%%%.....%%%..............%.%%%%%%%.........%.........%%%%%%%%%%%.............%%%%%%%%
m %%........%%........%...........%%.....%.%%%%...........4..............%%%..........%..........%%%%..%%...................%.%%
m %....%%%..%..%%%....%.................%%...............................%%%..........%.....%%%..%%%...%%......................%
m %%...%%%.%%%%%%%......................%%................................%%%........%%.....%%%%.%%%%%.......%%%.......%%..%...%
m %%%%%%%%%%%%%%%%....................%%%%.................................%...%.....%%......%%%...%%%.......%%%.......%..%%%..%
m %%%%%%%%%%%%%%%%%...................%%%......................................%%%.................%%........%%%......%%..%%%%.%
m %%%%%%%%%%%%%%%.%..................................................%..........%%..%........%%....%..........%%...........%%%.%
m %%%.%%%%%%%%%%........%%%..........................................%..%.......%%..%.........%..%%%.........%%%%......%%%%%%%.%
m ....%%%%%%%%%%......%.%........................%......................%.....%%%...%............%%%.........%%%%%..............
m ......%%%%%%%%.....%%%%.......%%%%....%%.....%%%...%.%%%%...........%%.....%%%%.......%.%%....%%%..........%%%%%%..........%..
m .........%%%%%%%%%%%%%%.......%%%%%%%.%%....%%%....%..%%%%..........%%%.%%.%%%%%....%%%%%%%%.%%%%...........%%%%%%......%%%%..
m ..%%%%...%%%%%%%%%%%%%%...%%%%%%%%%%%.......%%%........%%%%........%%%%.%..%.%%%.....%%%%%%%%%%%%%..........%%%%%%%%%...%%....
