# map type: blank
# random seed: 414713727
# hill distance  42, 24  92, 64
#        42, 24       0      92 
#        92, 64      92       0 
players 2
rows 100
cols 80
m ..%%%%%..%%%%%%%%%%%....%%...%%..%%%%..............%..%...%%.%..................
m ..%%%%.....%%%%%%.......%%...%%%...................%..%....%...........%%.......
m ...........%.%.....%%...%%..%%%%..................%%..%....%...........%%%......
m ....%%%...%%...%%.%%.....%..%%%%%.............%...%%%.%..................%...%..
m ......%.....................%.%%..............%%..%%%.%.........%%...........%..
m ............................%..................%%%%%%....%%%.....%..............
m ..%%.%%%......%...............................%%%%%%%%.............%%.....%%%%%.
m ...%%%%%%.%.%%%..%...%%.................%%%.%%%%%%%%%%%..%%.............%%%%%%%%
m ...%%%%%%%%..%%..%....%...................%..%%%%%%%%%...................%%%%%%%
m ....%%%%%%...%%%%%%.................%%........%%%%%%%%........%%.........%%%%%%.
m ......%%...%%%%%%%%............%.....%........%%%%%%%%%.................%%%%%%..
m ......%%...%%%%%...............%.....%%%.....%%%%%%%%%%...............%%%%%%%%..
m %...%......%%%%%.....................%%%%.%%%%%%%%%%%%%..............%%%%%%%%%.%
m ....%....%%%%%%%....%....%%%.........%%%%%%%%%%%%%%%%%%%%.........%%.%%%%%%%%...
m ....%%%....%%%%%%%..%..%%............%%%%%%%%%%%%%%%%%%%%%.........%%%%%%.%%%%%%
m ....%.%%%.%%%%%%%%%%%..%%............%%%%%%%%%%%%%%%%%%%%%%%.......%%%%%%...%%..
m ..........%%%%%%%%%%%%.%..............%%%%%%%%%%%%%%%%%%%%%%.......%%......%%%..
m ..........%%%%%%%%%%%................%%%%%%%%%%%%.%%%%%%%%%%%....%%%%..%%%%%%%..
m .......%%.%%%%%%%%%%.................%%%%.%%%%%...%%%%%%%%%%%...%%%%%.......%%..
m ............%%%%%%%%................%%..%.%%%%....%%%%%%%%%%%........%%%........
m %%................%%%%%..............%.............%%%%%%%%%%...........%%%...%%
m %%%%%%.....%%.%%%%%%..%.............%%..............%%%%%%%%%........%%..%%%..%%
m %%%%%%%.....%%%%%%%.................%.%%%...........%.%%%%%%%%.......%%%.%%%..%%
m %%%%%%%%....%%%%%%%%%..................................%%%%..........%%%%%%%%%%%
m .%%%%%%%...%%%%%%..%.............%...........%%.............%%........%%%%%%%%%%
m ...%%%%%%%%%%%%%%................%.....................................%%.%%%%%.
m ...%%%%%%%%%%%%%%..............................%%.........................%%%%..
m ...%%%%.%%%%%%%%%%..............%............%...........................%%%%%..
m .....%....%.%%%%%%%............%%............%%..........................%%%%...
m ..........%...................%%%............%%.................................
m ..........%%......%.............%%..........%%............%......%%.......%%....
m .........%%%%%...%%%........................%%...........%%%...%%%..........%%..
m ..........%..%%%%%%%........................%..%............................%%..
m ..........%..%%%%%%%%%%........................%..........%%...............%%...
m %.........%..%%%%%%%%%%............%........%%%...%.........................%%%%
m %%........%..%%%%%%%%%%%%..%%......%%%%%%%..%%%..%%..%......%%%%..............%%
m %%.%......%%...%%%%%%%%%%...%%.......%%%%%%%%%%.....%%%%....%%%%.........%%.....
m %%%%......%.....%%%%%%%.................%%%%%%%.%%%%%%%.....%%...........%%%...%
m %%%%..............%%%%%...................%%%%%%%%%%%%%.....%%............%....%
m %.................%%%%%....................%%%%%%%%%%%%.....................%%.%
m .........%%.........%%%..................%%%%%%%%%%%%%%%%%......................
m ............%.......%%%..................%%%%%%%%%%%%%%%%%......................
m ............%%..%%%%%%%.1.................%%%%%%%%%%%%%%%%...........%%.........
m ..%.%....%%%%%%%%%%%%%%...................%%%%%%%%%%%%%%%...........%%%%........
m .%%%%....%%%%%%%%%%%%%%.................%%%%%%%%%%%%%%%%%...........%%%%........
m ........%%%%%%%%%%%%%%%%.................%%%%%%%%%%%%%%%%...%%%%%%.%%%%%%.......
m ..%%%%%%%%%%%%%%%%%%%%%%................%%%%%%%%%%%%%%%%%%%%%%%%%%%%%%%%%.%.....
m .%%%%%%%%%%%%%%%%%%%%%%%%................%%%%%%%%%%%%%%%%%%%%%.%%%%%%%%...%.....
m .....%%%%%%%%%%%%%%%%%%%%..............%.%%%%%..%%%%%%%%%%%%%..%%%%%%%%...%.....
m .......%%....%%%%%%%%%%................%.%%%%%..%%%%%%%%%%%%%...%%...%%..%%%....
m ...........%..%...%%.%....................%%%%%..%%%%%%%%%%%....%%...%%..%%%%...
m ...........%..%....%...........%%.........%%%%.....%%%%%%.......%%...%%%........
m ..........%%..%....%...........%%%.................%.%.....%%...%%..%%%%........
m ......%...%%%.%..................%...%......%%%...%%...%%.%%.....%..%%%%%.......
m ......%%..%%%.%.........%%...........%........%.....................%.%%........
m .......%%%%%%....%%%.....%..........................................%...........
m ......%%%%%%%%.............%%.....%%%%%...%%.%%%......%.........................
m %%%.%%%%%%%%%%%..%%.............%%%%%%%%...%%%%%%.%.%%%..%...%%.................
m ..%..%%%%%%%%%...................%%%%%%%...%%%%%%%%..%%..%....%.................
m ......%%%%%%%%........%%.........%%%%%%.....%%%%%%...%%%%%%.................%%..
m ......%%%%%%%%%.................%%%%%%........%%...%%%%%%%%............%.....%..
m .....%%%%%%%%%%...............%%%%%%%%........%%...%%%%%...............%.....%%%
m %.%%%%%%%%%%%%%..............%%%%%%%%%.%%...%......%%%%%.....................%%%
m %%%%%%%%%%%%%%%%%.........%%.%%%%%%%%.......%....%%%%%%%....%....%%%.........%%%
m %%%%%%%%%%%%%%%%%%.........%%%%%%.%%%%%%....%%%....%%%%%%%..%..%%............%%%
m %%%%%%%%%%%%%%%%%%%%.......%%%%%%...%%......%.%%%.%%%%%%%%%%%..%%............%%%
m %%%%%%%%%%%%%%%%%%%%.......%%......%%%............%%%%%%%%%%%%.%..............%%
m %%%%%%%%%.%%%%%%%%%%%....%%%%..%%%%%%%............%%%%%%%%%%%................%%%
m %.%%%%%...%%%%%%%%%%%...%%%%%.......%%.........%%.%%%%%%%%%%.................%%%
m %.%%%%....%%%%%%%%%%%........%%%....................%%%%%%%%................%%..
m ...........%%%%%%%%%%...........%%%...%%%%................%%%%%..............%..
m ............%%%%%%%%%........%%..%%%..%%%%%%%%.....%%.%%%%%%..%.............%%..
m %...........%.%%%%%%%%.......%%%.%%%..%%%%%%%%%.....%%%%%%%.................%.%%
m ...............%%%%..........%%%%%%%%%%%%%%%%%%%....%%%%%%%%%...................
m .....%%.............%%........%%%%%%%%%%.%%%%%%%...%%%%%%..%.............%......
m ...............................%%.%%%%%....%%%%%%%%%%%%%%................%......
m .......%%.........................%%%%.....%%%%%%%%%%%%%%.......................
m .....%...........................%%%%%.....%%%%.%%%%%%%%%%..............%.......
m .....%%..........................%%%%........%....%.%%%%%%%............%%.......
m .....%%...........................................%...................%%%.......
m ....%%............%......%%.......%%..............%%......%.............%%......
m ....%%...........%%%...%%%..........%%...........%%%%%...%%%....................
m ....%..%............................%%............%..%%%%%%%....................
m .......%..........%%...............%%.............%..%%%%%%%%%%.................
m ....%%%...%.........................%%%%%.........%..%%%%%%%%%%............%....
m %%..%%%..%%..%......%%%%..............%%%%........%..%%%%%%%%%%%%..%%......%%%%%
m %%%%%%%.....%%%%....%%%%.........%%.....%%.%......%%...%%%%%%%%%%...%%.......%%%
m %%%%%%%.%%%%%%%.....%%...........%%%...%%%%%......%.....%%%%%%%.................
m ..%%%%%%%%%%%%%.....%%............%....%%%%%..............%%%%%.................
m ...%%%%%%%%%%%%.....................%%.%%.................%%%%%.................
m .%%%%%%%%%%%%%%%%%...............................%%.........%%%.................
m .%%%%%%%%%%%%%%%%%..................................%.......%%%.................
m ..%%%%%%%%%%%%%%%%...........%%.....................%%..%%%%%%%.0...............
m ..%%%%%%%%%%%%%%%...........%%%%..........%.%....%%%%%%%%%%%%%%.................
m %%%%%%%%%%%%%%%%%...........%%%%.........%%%%....%%%%%%%%%%%%%%.................
m .%%%%%%%%%%%%%%%%...%%%%%%.%%%%%%...............%%%%%%%%%%%%%%%%................
m %%%%%%%%%%%%%%%%%%%%%%%%%%%%%%%%%.%.......%%%%%%%%%%%%%%%%%%%%%%................
m .%%%%%%%%%%%%%%%%%%%%%.%%%%%%%%...%......%%%%%%%%%%%%%%%%%%%%%%%%...............
m .%%%%%..%%%%%%%%%%%%%..%%%%%%%%...%..........%%%%%%%%%%%%%%%%%%%%..............%
m .%%%%%..%%%%%%%%%%%%%...%%...%%..%%%...........%%....%%%%%%%%%%................%
