# map type: blank
# random seed: 1129336555
# hill distance  66, 38 104, 87  28,136
#        66, 38       0      87      87 
#       104, 87      87       0      87 
#        28,136      87      87       0 
players 3
rows 114
cols 147
m .......%%%%.....................%%.............%%...........%%%%.....%%%%....................%%%%%.......%...............%%%%%%%%%%.%%%%%%......%%%
m ..........%%.....................%...........................%%%...%%%%............%%........%%%%%.......%%..............%%%%%%%%%%%%%%%%%...%.....
m .........%%%%%%..............................................%%%%...%%%.%%%%........%...........%%..%...%%................%%%%%%%%%%%%..%%...%%%%..
m .................%%%%%....................................%..%%%%..%%%%.%%%%...................%%%%%%%%%%%%%%..............%%%%%%%%%....%%%.%%%%%..
m ...............%..%%%%....................................%...%%...%..%....%...................%%%%%%%%%%%%%%....%%........%%%%%%%%..%%.%%%.%%%%...
m ........%.....%%%%%%%%%....................................................%%..................%%%...%%%%%%.%...%%......%%%%%%%%%.%.%%%..%%%%......
m .......%%...%%%%%%%%%%%..............................................................................%%%%%%...%%%%.....%%%%%%%%%%...%%%%..%%.......
m ..........%%%%%%%%%%%%%.............................................................................%%%%%.......%%......%..%%%%%%..%...%..%........
m ............%%%%%%%%%%...%...............................................%%...........................%%%.......%%..........%%%%...%.....%%........
m .........%...%%%%%%%%....%%...............................................................................%%%%..%%%.....%%...%%%.......%%%%........
m .........%%%.%%%%%%%......................................................%............................%%%%%%%%%%%%%....%%%..%%%......%%%%%........
m .............%%%%.%%...%%.................................................%........................%....%%%%%%%%%%%%%%%..%%..........%%%%%%%.......
m ..............%%%.....%%%%......................................................%%.............%%%%%......%%%%%%%%%%%%%..%...........%%............
m ..............%%%%%.%%%%%%......................................................%%..............%%.........%%%%..%%%%...%%...%%......%.............
m ..%%%.........%%%%%.%%%%%.......................................................%...........................%....%%%%.........%......%..%%.........
m ..%%.............%%.%....................................................%%%......................................%%%.........%%%%..%%...%%%%......
m ..%%...........%%%..%....%..........................................%%%%%%%%%.....................................%%..........%%%%.................
m ..%............%%.......%%...........................................%%%%%%%%.....................................%%..........%%%..................
m ...............%.....................................................%%%%%%%%%....................................%%...........%%..................
m .....%%...............................................................%%%%%%%%.................................................%%..................
m ......%%%.............................................................%%%%%%%%........%.............%%%%.......................%%%.................
m ......%%%...........................................................%%%%%%%%%%%%.%....%.............%%.........................%...................
m ............................................................%......%%%%%%%%%%%%%%%.....%.......%%...%%%..........................%%................
m ......................................%%...%%.............%.%.%...%%%%%%%%%%%%%%%%.%%..%%...........%%%............................................
m ...%.........%...%.......................%%%..............%%%%%....%%%%%%%%%%%%%%...%.%%%..........%..%.....................%......................
m ...%%........%..%%........%..%%......%...%%%%...............%%%%%..%%%%%%%%%%%.....%%%%%...........%........................%......................
m .%%%%.%.........%%.....%%.%..%%...%..%.....%%.................%.....%%%%%%%%%%%....%%%..............%......................%%%.....................
m ..%%%%%%%........%%%%%.%%....%%%%.%....%%.%%%%......................%......%%%%...%%%%..............%%.....................%%%.....................
m ..%%%%%%%........%%%%...%%...%%%%.........%.....%%%.................%.......%%%%...%%%..............%%%.................................1..........
m ......%%...........%...%%%%..%%%%%%.......%......%%%.%....................%%%%%%%.%%%%...%........%%%%%%%..........................................
m ......%%.................%%..%%%%%%%.............%%%%%%.%%%.............%%%%%%%%%%%%%%%%.%........%%%%%%%..%.......................................
m .........................%%....%%%%%%%............%%....%%%................%%%%%%%%%%%%%%..........%%%%%..%%.........%...%%........................
m .%%......................%.....%%%%%...%%.........%%...%%%%.................%%%%%%%%%%%%%..........%%%%%.%%%%........%%..%%........................
m ...............................%...%...%...........%......%%..%%............%%%%%%%%%%............%%%.....%%%.....%.%%...%%%..............%%.......
m .................%%%........%%.%.......%%....%.........%%.%....%............%%%%%%%%%%%%%.............%....%%...%%%......%%%.......................
m .................%%%%......%%%....%%...%%%...%%.......%%%....................%%%%%%%..%%..............%%%%...%%%%%.........%%......................
m .................%%%%%......%%....%%%%%%%%%%%%%%......%%%%...........%%.......%.%%%...%%%.............%%.%.%%%%%......%%...%%%%%...................
m .......%.............%.%%%%.%%%%..%%%%%%%%%%%.%%%%.....%%%.%..........%.......%.%%%%....%%...............%..%%%%%.....%%%%%%.%...................%.
m .......%...............%%%%%%%%%%.%%%%%%......%%%.......%%%%.....................%%.............%%...........%%%%.....%%%%....................%%%%%
m .......%%..............%%%%%%%%%%%%%%%%%...%...............%%.....................%...........................%%%...%%%%............%%........%%%%%
m ..%...%%................%%%%%%%%%%%%..%%...%%%%...........%%%%%%..............................................%%%%...%%%.%%%%........%...........%%
m %%%%%%%%%%%..............%%%%%%%%%....%%%.%%%%%...................%%%%%....................................%..%%%%..%%%%.%%%%...................%%%
m %%%%%%%%%%%....%%........%%%%%%%%..%%.%%%.%%%%..................%..%%%%....................................%...%%...%..%....%...................%%%
m ...%%%%%%.%...%%......%%%%%%%%%.%.%%%..%%%%..............%.....%%%%%%%%%....................................................%%..................%%%
m ...%%%%%%...%%%%.....%%%%%%%%%%...%%%%..%%..............%%...%%%%%%%%%%%...........................................................................
m ..%%%%%.......%%......%..%%%%%%..%...%..%..................%%%%%%%%%%%%%...........................................................................
m ....%%%.......%%..........%%%%...%.....%%....................%%%%%%%%%%...%...............................................%%.......................
m ........%%%%..%%%.....%%...%%%.......%%%%.................%...%%%%%%%%....%%.......................................................................
m .....%%%%%%%%%%%%%....%%%..%%%......%%%%%.................%%%.%%%%%%%......................................................%.......................
m .%....%%%%%%%%%%%%%%%..%%..........%%%%%%%....................%%%%.%%...%%.................................................%.......................
m %%......%%%%%%%%%%%%%..%...........%%..........................%%%.....%%%%......................................................%%.............%%%
m .........%%%%..%%%%...%%...%%......%...........................%%%%%.%%%%%%......................................................%%..............%%
m ..........%....%%%%.........%......%..%%...........%%%.........%%%%%.%%%%%.......................................................%.................
m ................%%%.........%%%%..%%...%%%%........%%.............%%.%....................................................%%%......................
m ................%%..........%%%%...................%%...........%%%..%....%..........................................%%%%%%%%%.....................
m ................%%..........%%%....................%............%%.......%%...........................................%%%%%%%%.....................
m ................%%...........%%.................................%.....................................................%%%%%%%%%....................
m .............................%%.......................%%...............................................................%%%%%%%%....................
m ..%%%%.......................%%%.......................%%%.............................................................%%%%%%%%........%...........
m ..%%.........................%.........................%%%...........................................................%%%%%%%%%%%%.%....%...........
m ..%%%..........................%%............................................................................%......%%%%%%%%%%%%%%%.....%.......%%.
m ..%%%..................................................................................%%...%%.............%.%.%...%%%%%%%%%%%%%%%%.%%..%%.........
m .%..%.....................%.........................%.........%...%.......................%%%..............%%%%%....%%%%%%%%%%%%%%...%.%%%.........
m .%........................%.........................%%........%..%%........%..%%......%...%%%%...............%%%%%..%%%%%%%%%%%.....%%%%%..........
m ..%......................%%%......................%%%%.%.........%%.....%%.%..%%...%..%.....%%.................%.....%%%%%%%%%%%....%%%............
m ..%%.....................%%%.......................%%%%%%%........%%%%%.%%....%%%%.%....%%.%%%%......................%......%%%%...%%%%............
m ..%%%.................................2............%%%%%%%........%%%%...%%...%%%%.........%.....%%%.................%.......%%%%...%%%............
m %%%%%%%................................................%%...........%...%%%%..%%%%%%.......%......%%%.%....................%%%%%%%.%%%%...%........
m %%%%%%%..%.............................................%%.................%%..%%%%%%%.............%%%%%%.%%%.............%%%%%%%%%%%%%%%%.%........
m .%%%%%..%%.........%...%%.................................................%%....%%%%%%%............%%....%%%................%%%%%%%%%%%%%%.........
m .%%%%%.%%%%........%%..%%.........................%%......................%.....%%%%%...%%.........%%...%%%%.................%%%%%%%%%%%%%.........
m %%%.....%%%.....%.%%...%%%..............%%......................................%...%...%...........%......%%..%%............%%%%%%%%%%............
m ....%....%%...%%%......%%%........................................%%%........%%.%.......%%....%.........%%.%....%............%%%%%%%%%%%%%.........
m ....%%%%...%%%%%.........%%.......................................%%%%......%%%....%%...%%%...%%.......%%%....................%%%%%%%..%%..........
m ....%%.%.%%%%%......%%...%%%%%....................................%%%%%......%%....%%%%%%%%%%%%%%......%%%%...........%%.......%.%%%...%%%.........
m .......%..%%%%%.....%%%%%%.%...................%........%.............%.%%%%.%%%%..%%%%%%%%%%%.%%%%.....%%%.%..........%.......%.%%%%....%%........
m ...........%%%%.....%%%%....................%%%%%.......%...............%%%%%%%%%%.%%%%%%......%%%.......%%%%.....................%%.............%%
m ............%%%...%%%%............%%........%%%%%.......%%..............%%%%%%%%%%%%%%%%%...%...............%%.....................%...............
m ............%%%%...%%%.%%%%........%...........%%..%...%%................%%%%%%%%%%%%..%%...%%%%...........%%%%%%..................................
m .........%..%%%%..%%%%.%%%%...................%%%%%%%%%%%%%%..............%%%%%%%%%....%%%.%%%%%...................%%%%%...........................
m .........%...%%...%..%....%...................%%%%%%%%%%%%%%....%%........%%%%%%%%..%%.%%%.%%%%..................%..%%%%...........................
m ..........................%%..................%%%...%%%%%%.%...%%......%%%%%%%%%.%.%%%..%%%%..............%.....%%%%%%%%%..........................
m ....................................................%%%%%%...%%%%.....%%%%%%%%%%...%%%%..%%..............%%...%%%%%%%%%%%..........................
m ...................................................%%%%%.......%%......%..%%%%%%..%...%..%..................%%%%%%%%%%%%%..........................
m ........................%%...........................%%%.......%%..........%%%%...%.....%%....................%%%%%%%%%%...%.......................
m .........................................................%%%%..%%%.....%%...%%%.......%%%%.................%...%%%%%%%%....%%......................
m .........................%............................%%%%%%%%%%%%%....%%%..%%%......%%%%%.................%%%.%%%%%%%.............................
m .........................%........................%....%%%%%%%%%%%%%%%..%%..........%%%%%%%....................%%%%.%%...%%........................
m ...............................%%.............%%%%%......%%%%%%%%%%%%%..%...........%%..........................%%%.....%%%%.......................
m ...............................%%..............%%.........%%%%..%%%%...%%...%%......%...........................%%%%%.%%%%%%.......................
m ...............................%...........................%....%%%%.........%......%..%%...........%%%.........%%%%%.%%%%%........................
m ........................%%%......................................%%%.........%%%%..%%...%%%%........%%.............%%.%............................
m ...................%%%%%%%%%.....................................%%..........%%%%...................%%...........%%%..%....%.......................
m ....................%%%%%%%%.....................................%%..........%%%....................%............%%.......%%.......................
m ....................%%%%%%%%%....................................%%...........%%.................................%.................................
m .....................%%%%%%%%.................................................%%.......................%%..........................................
m .....................%%%%%%%%........%.............%%%%.......................%%%.......................%%%........................................
m ...................%%%%%%%%%%%%.%....%.............%%.........................%.........................%%%........................................
m ...........%......%%%%%%%%%%%%%%%.....%.......%%...%%%..........................%%.................................................................
m .........%.%.%...%%%%%%%%%%%%%%%%.%%..%%...........%%%..................................................................................%%...%%....
m .........%%%%%....%%%%%%%%%%%%%%...%.%%%..........%..%.....................%.........................%.........%...%.......................%%%.....
m ...........%%%%%..%%%%%%%%%%%.....%%%%%...........%........................%.........................%%........%..%%........%..%%......%...%%%%....
m .............%.....%%%%%%%%%%%....%%%..............%......................%%%......................%%%%.%.........%%.....%%.%..%%...%..%.....%%....
m ...................%......%%%%...%%%%..............%%.....................%%%.......................%%%%%%%........%%%%%.%%....%%%%.%....%%.%%%%...
m %%.................%.......%%%%...%%%..............%%%.................................0............%%%%%%%........%%%%...%%...%%%%.........%.....%
m %%%.%....................%%%%%%%.%%%%...%........%%%%%%%................................................%%...........%...%%%%..%%%%%%.......%......
m %%%%%%.%%%.............%%%%%%%%%%%%%%%%.%........%%%%%%%..%.............................................%%.................%%..%%%%%%%.............
m .%%....%%%................%%%%%%%%%%%%%%..........%%%%%..%%.........%...%%.................................................%%....%%%%%%%...........
m .%%...%%%%.................%%%%%%%%%%%%%..........%%%%%.%%%%........%%..%%.........................%%......................%.....%%%%%...%%........
m ..%......%%..%%............%%%%%%%%%%............%%%.....%%%.....%.%%...%%%..............%%......................................%...%...%.........
m ......%%.%....%............%%%%%%%%%%%%%.............%....%%...%%%......%%%........................................%%%........%%.%.......%%....%...
m .....%%%....................%%%%%%%..%%..............%%%%...%%%%%.........%%.......................................%%%%......%%%....%%...%%%...%%..
m .....%%%%...........%%.......%.%%%...%%%.............%%.%.%%%%%......%%...%%%%%....................................%%%%%......%%....%%%%%%%%%%%%%%.
m %.....%%%.%..........%.......%.%%%%....%%...............%..%%%%%.....%%%%%%.%...................%........%.............%.%%%%.%%%%..%%%%%%%%%%%.%%%
