# map type: blank
# random seed: -1772268211
# hill distance  64, 51  27, 12
#        64, 51       0      76 
#        27, 12      76       0 
players 2
rows 74
cols 78
m ..............................................................................
m ..............................................................................
m ..............................................................................
m ...........................................................................%..
m ..........................................................................%%%%
m .......................................................................%.%%%%%
m .......................................................................%%%%%%%
m .......................................................................%%%%%%%
m .......%.................................................................%....
m ......%%%%%%.............................................................%....
m ...%%%%%%%%%%%..........................................................%%%...
m ..%%%%%%%%%%..............%%.............................................%....
m .%%%%%%%%%%...........................................%%......................
m %%%%%%%%%%%...................................................................
m .%%%%%%%%%%%%%%...............................................................
m %%..%%%%%%%%%%%...............................................................
m %%....%%%%%%%%%.............................................................%%
m %%....%%%...%%%............................................................%%%
m %%%....%%.....%..........................................................%%%%%
m %%%............................................................%%........%%%%%
m %..............................................................%%..........%%%
m %.............................................................%%%.....%%...%%%
m %..........%%.............................%%%%%.......................%%......
m ............%..........................%%.....................................
m .......................................%%.....................................
m ..........................................%...................................
m .........................................%%%..................................
m .%..........0..............................%..................................
m %%.........................................................................%.%
m .%...........%%............................................................%..
m .............%%...............................................................
m ..............................................................................
m ..............................................................................
m ..............................................................................
m ..............................................................................
m ........................................%%....................................
m .........................................%%...................................
m ..............................................................................
m ..............................................................................
m ..............................................................................
m ....................................%.........................................
m ...................................%%%%.......................................
m ................................%.%%%%%.......................................
m ................................%%%%%%%.......................................
m ................................%%%%%%%.......................................
m ..................................%...........%...............................
m ..................................%..........%%%%%%...........................
m .................................%%%......%%%%%%%%%%%.........................
m ..................................%......%%%%%%%%%%..............%%...........
m ...............%%.......................%%%%%%%%%%............................
m .......................................%%%%%%%%%%%............................
m ........................................%%%%%%%%%%%%%%........................
m .......................................%%..%%%%%%%%%%%........................
m .....................................%%%%....%%%%%%%%%........................
m ....................................%%%%%....%%%...%%%........................
m ..................................%%%%%%%%....%%.....%........................
m ........................%%........%%%%%%%%....................................
m ........................%%..........%%%%......................................
m .......................%%%.....%%...%%%%......................................
m ...%%%%%.......................%%......%..........%%..........................
m %%.................................................%..........................
m %%............................................................................
m ...%..........................................................................
m ..%%%.........................................................................
m ....%...................................%..........1..........................
m ....................................%.%%%.....................................
m ....................................%...%...........%%........................
m ....................................................%%........................
m ..............................................................................
m ..............................................................................
m ..............................................................................
m ..............................................................................
m .%%...........................................................................
m ..%%..........................................................................
