# map type: blank
# random seed: -2008247974
# hill distance   0, 41  38,  5
#         0, 41       0      74 
#        38,  5      74       0 
players 2
rows 76
cols 72
m .........................................1.....%%%.............%%%%%%%%%
m ....................................%%..........%%................%%%%%%
m %%.........................%%..%%...............%.................%%%%%%
m %...............................%..............%%............%%.....%%%%
m %...........................%%%%%.%%...........%%............%%......%%%
m %.....%.......................%%%%%%%..........%%.....................%%
m ......%........................%%%%%%%....%.%%%%%...........%...........
m .................................%%%%%%...%.%...%%..........%%%%........
m ...............................%%%%%%%%..........%%%%........%%%........
m ..............................%%%%%%%%%.%........%...........%%.....%%..
m .............................%%%%%%%%%..%........%......................
m ..%%.........................%%%%%%%.......................%...%%.......
m ...%.........................%...%......................%%%%............
m ...%...............................%%.....................%%............
m ...%...%.................................%................%%%...........
m ...%...%%.........................%%.....%%...............%%%...........
m .%%%..............................%......%%...............%%%%..........
m .%%%%........................%%%%%........................%%%%..........
m %%%%%%.......%%..............%%%%%...........%%...........%%%%%%.......%
m %%%%......................%....%%%........................%%%%%%........
m %.........................%........................%......%%%%%%%.......
m ........%...............%%%%%.%%..........%%.......%%%....%%%%%%%%%.....
m ...%....%%...........%.%%%%%%%%%.........%%........%%%...%%%%%%.%.......
m ...%%..%%%...........%%%%%%%%%%%%..................%%%...%%%%%........%.
m .......%%%%%.........%%%%%%%%%%%%..........%%%.....%%...%%%%%%..%%.%..%.
m ........%%%...........%%%%%%%%%%%............%.....%%%..%%%%%%%....%%...
m ......................%%%%%%%%%%%...................%....%%.........%%..
m ..........%%..........%%%%%%%%%%%.........................%.........%%..
m ............%%.......%%%%%%%%%%%.............................%%.........
m .............%....%%%%%%%%%%%%%%......................................%.
m .............%.....%%%%%%%%%%%%%............................%%........%%
m ...%%%............%%..%%%%%%%%%%...................................%%%%.
m ....%%%...............%%%%%%%..%......................................%%
m ....%.....................%%...%%%......................................
m .....................%%........%%%......................................
m ............................%.%%%%%.....................................
m ...........%................%%%%%%%%.....%..............................
m ..........%%%..............%%%%%%%%%.....%..............................
m .....0.....%%%.............%%%%%%%%%....................................
m %%..........%%................%%%%%%....................................
m ............%.................%%%%%%%%.........................%%..%%...
m ...........%%............%%.....%%%%%...............................%...
m ...........%%............%%......%%%%...........................%%%%%.%%
m %..........%%.....................%%%.....%.......................%%%%%%
m %%....%.%%%%%...........%.................%........................%%%%%
m %%%...%.%...%%..........%%%%.........................................%%%
m %%%..........%%%%........%%%.......................................%%%%%
m %%%.%........%...........%%.....%%................................%%%%%%
m %%..%........%...................................................%%%%%%%
m .......................%...%%.........%%.........................%%%%%%%
m ....................%%%%...............%.........................%...%..
m %.....................%%...............%...............................%
m .....%................%%%..............%...%............................
m .....%%...............%%%..............%...%%.........................%%
m .....%%...............%%%%...........%%%..............................%.
m ......................%%%%...........%%%%........................%%%%%..
m .........%%...........%%%%%%.......%%%%%%%.......%%..............%%%%%..
m ......................%%%%%%........%%%%......................%....%%%..
m ...............%......%%%%%%%.......%.........................%.........
m ......%%.......%%%....%%%%%%%%%.............%...............%%%%%.%%....
m .....%%........%%%...%%%%%%.%..........%....%%...........%.%%%%%%%%%....
m ...............%%%...%%%%%........%....%%..%%%...........%%%%%%%%%%%%...
m .......%%%.....%%...%%%%%%..%%.%..%........%%%%%.........%%%%%%%%%%%%...
m .........%.....%%%..%%%%%%%....%%...........%%%...........%%%%%%%%%%%...
m ................%....%%.........%%........................%%%%%%%%%%%...
m ......................%.........%%............%%..........%%%%%%%%%%%...
m .........................%%.....................%%.......%%%%%%%%%%%....
m ..................................%..............%....%%%%%%%%%%%%%%....
m ........................%%........%%.............%.....%%%%%%%%%%%%%....
m ...............................%%%%....%%%............%%..%%%%%%%%%%....
m ..................................%%....%%%...............%%%%%%%..%....
m ........................................%.....................%%...%%%..
m .........................................................%%........%%%..
m ................................................................%.%%%%%.
m .....%.........................................%................%%%%%%%%
m .....%........................................%%%..............%%%%%%%%%
