# map type: blank
# random seed: 704837299
# hill distance   7, 14  51, 52
#         7, 14       0      90 
#        51, 52      90       0 
players 2
rows 88
cols 76
m ............%%%%%..%%%%%%%%%%%%%%%%%%%%%........%%%%%%%%%%%%%%.....%........
m .............%%%..%%%%%%%%%%%%%%%%%%%%%%..%%%...%%%%%%%%%%%%%%%%..%%........
m .............%%..%%%%%%%%%%%%%%%%%%%%%..%..%....%%%%%%%%%%%%%%%%%%%%%.......
m ..............%%%%%%%%%%%%%%%%%%%%%%%%%.%.....%%%%%%%%%%%%%%%%%%%%..........
m .....%%.....%%%%%%%%%%%%%%%%%%%%%%%%%%......%%%%%%%%%%%%%%%%%%.%%...........
m ...%%%%%.%%..%%%%%%%%%%%%%%%%%%%%%%%%%..%%%%%%%%...%..%%%%%%%...............
m .%.%%%%%%%.....%%%%%%%%%%%%%%%%%%%%%%%%.%%%%%%%%......%%%%%%%...............
m .%%..%%%%%%%..1.%%%%%%%%%%%%%%%%%%%...%.%%%%%%%%....%%%%%%%%%...............
m .....%%%%.......%%%%%%%%%%%%%%%%%%%...%..%%..%%%......%%%%%%%%..............
m ......%%........%%%%%%%%%%%%%%%%%%%...%.......%.........%%%%%...............
m ................%%%%%%%%%%%%%%%%%%......................%%%%................
m ...............%%%%%%..%%%%%%%%%%%......%%.............%%%%%%...............
m ........%........%.....%%%%%%%%........................%%%%.................
m ........%...%.%..%.....%%%%%%%%.......................%%%%%.................
m ............%.%%%%...........%%%%.....................%%.%%.................
m ...%...........%%%...........%%%%..%%..............%..%.....................
m ...%%%%......................%%.%...%%.............%........................
m ............................%%%....%%%..................%%..................
m ....%%................%.....%%%...%%%%...................%%.................
m ......................%....%%%%%............................................
m ...........................%%%%%%...........................................
m ..........................%%%%%%%%..%%..................................%%..
m .........................%%%%%%%........................................%%%.
m .........................%%%%%%%....................................%%%%%%..
m ...........................%%%%%%.....................................%%%...
m ...........................%%%%..................................%.....%....
m ...........................%%%%..................................%..........
m ........................%%.%%%%..............................%%.............
m .......%......%%......%%%%%%%%%...............................%..%..........
m ......%%%%.%..%.....%%%%%%%%%%%..........................%%%.....%..........
m ....%%%%%..%%%......%%%%%%%%%%%..........................%%%%%%.............
m ....%%%%.....%......%%%%%%%%%%%..............................%%%%...........
m ....%%.........%%%..%%%%%%%%%%%...........................%.%%%%............
m ...%%%.........%%%%.%%%%%%%%%%%...........................%...%%............
m ..%%%.......%%%%%%%%%%%%%%%%%%%.............................................
m ...%%.......%%%%%%%%%%%%%%%%%%...............................%%%............
m ...%%........%%%%%%%%%%%%%%%%%%..............................%..............
m .%%%%..........%%%%%%%%%%%%%%%%...%%...............%%.......................
m .%%%%%........%%%%%%%%%%%%..%%......................%%.%%..................%
m %%%%%%%.....%%%%%%%%%%%%%..%.......................%%%%%%%..%..............%
m .%%%%%%%%%%%%%%%%%%%%%%%%..%.....................%%%%%%%%..%%..%%...........
m %%%%%%%%%%%%%%%%%%%%%%%%%........................%%%%%%%...%%%%%%%%.....%%%%
m %%%%%%.%%.%%%%%%%%%%%%%%%..........................%%%%%.%%%%%%%%%%.....%%%%
m %%%%%%....%%%%%%%%%%%%%%.........................%%%%%%..%%%%%%%%%%%%%%%%%%%
m %%........%%%%%%%%%%%%%%.....%....................%%%%%..%%%%%%%%%%%%%%%%%%%
m %%..%%%...%%%%%%%%%%%%%%%%..%%.....................%%%..%%%%%%%%%%%%%%%%%%%%
m ..%..%....%%%%%%%%%%%%%%%%%%%%%....................%%..%%%%%%%%%%%%%%%%%%%%%
m %.%.....%%%%%%%%%%%%%%%%%%%%........................%%%%%%%%%%%%%%%%%%%%%%%%
m ......%%%%%%%%%%%%%%%%%%.%%................%%.....%%%%%%%%%%%%%%%%%%%%%%%%%%
m ..%%%%%%%%...%..%%%%%%%..................%%%%%.%%..%%%%%%%%%%%%%%%%%%%%%%%%%
m %.%%%%%%%%......%%%%%%%................%.%%%%%%%.....%%%%%%%%%%%%%%%%%%%%%%%
m %.%%%%%%%%....%%%%%%%%%................%%..%%%%%%%..0.%%%%%%%%%%%%%%%%%%%...
m %..%%..%%%......%%%%%%%%...................%%%%.......%%%%%%%%%%%%%%%%%%%...
m %.......%.........%%%%%.....................%%........%%%%%%%%%%%%%%%%%%%...
m ..................%%%%................................%%%%%%%%%%%%%%%%%%....
m ..%%.............%%%%%%..............................%%%%%%..%%%%%%%%%%%....
m .................%%%%.........................%........%.....%%%%%%%%.......
m ................%%%%%.........................%...%.%..%.....%%%%%%%%.......
m ................%%.%%.............................%.%%%%...........%%%%.....
m .............%..%........................%...........%%%...........%%%%..%%.
m .............%...........................%%%%......................%%.%...%%
m ..................%%..............................................%%%....%%%
m ...................%%.....................%%................%.....%%%...%%%%
m ............................................................%....%%%%%......
m .................................................................%%%%%%.....
m ..................................%%............................%%%%%%%%..%%
m ..................................%%%..........................%%%%%%%......
m ..............................%%%%%%...........................%%%%%%%......
m ................................%%%..............................%%%%%%.....
m ...........................%.....%...............................%%%%.......
m ...........................%.....................................%%%%.......
m .......................%%.....................................%%.%%%%.......
m ........................%..%.................%......%%......%%%%%%%%%.......
m ...................%%%.....%................%%%%.%..%.....%%%%%%%%%%%.......
m ...................%%%%%%.................%%%%%..%%%......%%%%%%%%%%%.......
m .......................%%%%...............%%%%.....%......%%%%%%%%%%%.......
m ....................%.%%%%................%%.........%%%..%%%%%%%%%%%.......
m ....................%...%%...............%%%.........%%%%.%%%%%%%%%%%.......
m ........................................%%%.......%%%%%%%%%%%%%%%%%%%.......
m .......................%%%...............%%.......%%%%%%%%%%%%%%%%%%........
m .......................%.................%%........%%%%%%%%%%%%%%%%%%.......
m .............%%........................%%%%..........%%%%%%%%%%%%%%%%...%%..
m ..............%%.%%..................%.%%%%%........%%%%%%%%%%%%..%%........
m .............%%%%%%%..%..............%%%%%%%%.....%%%%%%%%%%%%%..%..........
m ...........%%%%%%%%..%%..%%............%%%%%%%%%%%%%%%%%%%%%%%%..%..........
m ...........%%%%%%%...%%%%%%%%.....%%%%%%%%%%%%%%%%%%%%%%%%%%%%%.............
m .............%%%%%.%%%%%%%%%%.....%%%%%%%%%%.%%.%%%%%%%%%%%%%%%.............
m ...........%%%%%%..%%%%%%%%%%%%%%%%%%%%%%%%%....%%%%%%%%%%%%%%..............
