# map type: blank
# random seed: -2039116554
# hill distance   4, 50  46, 15
#         4, 50       0      77 
#        46, 15      77       0 
players 2
rows 84
cols 70
m ................................................................%%....
m ......................................................................
m ..................................................%...................
m ..................................................%%..................
m ..................................................1%%.................
m ....................................................%.................
m ......................................................................
m ......................................................................
m ......................................................................
m ............................%.........................................
m ............................%.........................................
m ............................%%.....%%%...%%...........................
m ............................%%%..%....................................
m ................................%%....................................
m ................................%.....................................
m ......................................................................
m .............................................%%.......................
m ............................................%%........................
m ....%%............................%%%.................................
m .....%............................%%%%.%..%%%.........................
m ...%....%%........................%%%%%%.%%....%%.....................
m .%%%%%%%%..............%%%........%%%%%%%%...%%%%.....................
m %%%%%%%%%..............%%%......%.%%%%%%%%...%%%%.................%%..
m %%%%%%%%%...............%......%%%%%%%%%%..%%.........................
m %%%%%%%%..........................%%%%%.....................%....%%%..
m %%%%%%%%......................%....%%......................%%%%.%%%%..
m %%%%%%%%....%%...............%%.....%........................%%...%...
m %%%%...%.........................%...%%%.....................%%%......
m .......%.........................%.....%...%%.......%%%.......%%......
m ......%%%.....................%%%%.....%..%%%%%%.....%%...............
m .......%%%....................%%%......%.%%%%%%%......................
m ........%%.....................%..%%........%%.%......................
m .........%...........%%...........%%..................................
m .........%...........%..................................%%............
m ........%%......%%.%%%................................................
m .........%......%%%%%%................................................
m ................%%%%%%%...............................................
m ................%%%%%%%...............................................
m .................%%%%%%...............................................
m ....................%%%%..............................................
m ....................%%%%%....%%.......................................
m ......................................................................
m .............................%%.......................................
m ......................................................................
m ...............%......................................................
m ...............%%.....................................................
m ...............0%%....................................................
m .................%....................................................
m ......................................................................
m ......................................................................
m ......................................................................
m ...............................................................%......
m ...............................................................%......
m %%%...%%.......................................................%%.....
m ...............................................................%%%..%.
m ...................................................................%%.
m ...................................................................%..
m ......................................................................
m ..........%%..........................................................
m .........%%...........................................................
m %%.....................................%%............................%
m %%%.%..%%%..............................%............................%
m %%%%%.%%....%%........................%....%%........................%
m %%%%%%%...%%%%......................%%%%%%%%..............%%%........%
m %%%%%%%...%%%%.................%%..%%%%%%%%%..............%%%......%.%
m %%%%%%..%%.........................%%%%%%%%%...............%......%%%%
m %%%%.....................%....%%%..%%%%%%%%..........................%
m %%......................%%%%.%%%%..%%%%%%%%......................%....
m .%........................%%...%...%%%%%%%%....%%...............%%....
m ..%%%.....................%%%......%%%%...%.........................%.
m ....%...%%.......%%%.......%%.............%.........................%.
m ....%..%%%%%%.....%%.....................%%%.....................%%%%.
m ....%.%%%%%%%.............................%%%....................%%%..
m %........%%.%..............................%%.....................%..%
m %...........................................%...........%%...........%
m .....................%%.....................%...........%.............
m ...........................................%%......%%.%%%.............
m ............................................%......%%%%%%.............
m ...................................................%%%%%%%............
m ...................................................%%%%%%%............
m ....................................................%%%%%%............
m .......................................................%%%%...........
m .......................................................%%%%%....%%....
m ......................................................................
