# map type: blank
# random seed: 2128715634
# hill distance  19, 56  60, 22
#        19, 56       0      75 
#        60, 22      75       0 
players 2
rows 82
cols 68
m .......%.............%...................................%..........
m ........%...........%%....................%%........................
m ........%........%%%...................%%%%%.............%%.........
m ...................%......................%..............%%%........
m ...................%......................................%.........
m ...................................................%................
m ...............................................%...%................
m ......%%..........%%%%.........%%.............%%...%%...............
m ......%%..........%%........%%%%%............%%....%................
m ......................%.....%%%%%............%%.............%.......
m ......................%.....%%%%%.............%%.......%...%%.......
m ......%%..%.........%%......%%%%%......................%............
m ......%%..%.........%%......%%%%%...................................
m ......%...%%....%%...%%.......%%%%%.................................
m ..........%...........%%......%%%%..................................
m .....%............%%%%%%%%%%%%%%%%..................................
m ....%%............%%%%%%%%%%%%%%%%%.................................
m ....%%%.....%%...%%%%%%%%.%%%%%%%%%%...........................%%%%.
m ...%%%%%%%.......%%%%%%%%..%%%%%%%%%..............%............%%%%.
m ....%%%%%%.%%....%%%%%%....%%%.%..%...............%%%...1........%%%
m ...%%%%%%%.%%%%..%%%%%%......%....................%%%......%...%%%..
m .%%%%%%%%%.%%%%..%%%%%%........................%%.%%.......%%......%
m ...%%%%%%%...%%%...%%%%%%..........................................%
m ...%%%%%%%%%.%%%.%.%%%%%............................%%..............
m ...%%%%%%%%..%%%%%....%%...%........................................
m ....%%%%%%%.%%%%%%.....%...%............................%.%%%....%..
m ....%%%%%%%..%%%%%.....%............%.....%.............%%%%%%...%..
m ....%%%%%%%..%%%%%%%%...............%...%%%..............%%%........
m ...%%.......%%%%%%%%............%%%.......................%%........
m ...%%........%%..%..............%%..................................
m ..................................................................%.
m ................................................................%%%.
m ...........................................%%%.%%...................
m ....%%..................%..................%...%....................
m ....%%..................%%%......................%%.................
m .........................%%....%%...............%%%.................
m .........................%......%...............%%%.................
m .........................%........................%.................
m .....................%%..%..........................................
m .........%......%%%%.%%%%..................%%%%......%..............
m .........%.......%%...%%%...............%%.%..%......%.%............
m .......................%.................%.............%............
m ........%%................................%...........%%............
m .....%%%%%.............%%.................%........%%%..............
m ........%..............%%%...........................%..............
m ........................%............................%..............
m .................%..................................................
m .............%...%..................................................
m ............%%...%%.....................%%..........%%%%.........%%.
m ...........%%....%......................%%..........%%........%%%%%.
m ...........%%.............%.............................%.....%%%%%.
m ............%%.......%...%%.............................%.....%%%%%.
m .....................%..................%%..%.........%%......%%%%%.
m ........................................%%..%.........%%......%%%%%.
m %.......................................%...%%....%%...%%.......%%%%
m ............................................%...........%%......%%%%
m .......................................%............%%%%%%%%%%%%%%%%
m %.....................................%%............%%%%%%%%%%%%%%%%
m %%...........................%%%%.....%%%.....%%...%%%%%%%%.%%%%%%%%
m %%..............%............%%%%....%%%%%%%.......%%%%%%%%..%%%%%%%
m %...............%%%...0........%%%....%%%%%%.%%....%%%%%%....%%%.%..
m ................%%%......%...%%%.....%%%%%%%.%%%%..%%%%%%......%....
m .............%%.%%.......%%......%.%%%%%%%%%.%%%%..%%%%%%...........
m .................................%...%%%%%%%...%%%...%%%%%%.........
m ..................%%.................%%%%%%%%%.%%%.%.%%%%%..........
m .....................................%%%%%%%%..%%%%%....%%...%......
m ......................%.%%%....%......%%%%%%%.%%%%%%.....%...%......
m ..%.....%.............%%%%%%...%......%%%%%%%..%%%%%.....%..........
m ..%...%%%..............%%%............%%%%%%%..%%%%%%%%.............
m %.......................%%...........%%.......%%%%%%%%............%%
m .....................................%%........%%..%..............%%
m ................................%...................................
m ..............................%%%...................................
m .........%%%.%%.....................................................
m .........%...%........................%%..................%.........
m ...............%%.....................%%..................%%%.......
m ..............%%%..........................................%%....%%.
m ..............%%%..........................................%......%.
m ................%..........................................%........
m .......................................................%%..%........
m .........%%%%......%.......................%......%%%%.%%%%.........
m ......%%.%..%......%.%.....................%.......%%...%%%.........
