# map type: blank
# random seed: -1041805813
# hill distance  72, 73 117,118  27, 28
#        72, 73       0      94      94 
#       117,118      94       0      94 
#        27, 28      94      94       0 
players 3
rows 135
cols 135
m ...%.............%.%...........%.........%%%%%%.....%.........%%%%%.....%%%%%%..%.%%...........%....................%%%%...%%%%%%%%%%..
m ..%%%.................%%..........%........%%%%.....%.........%%%%%......%%%%%%%...%..........%%%..........%%......%%%%%%%%%%%%%%%%%%%%
m .%%%................%%%%%%%.......%.......%%%%%%%%..%.......%.%%%........%%%%%%%...............%..........%%%%%%%.%%%%%%%%%%%%%%%%%%%%%
m %%%%.%%%.............%%%%.........%.......%%%%%%%.%.....%%.%%%%%...%.......%%%.............................%%%%%%%%%%%%%%%%%%%%%%%%%%%%
m %%%%%%%%.............%..........%.%%......%%%%%%..%.%%%%%%%%%%%%..%%.....................%%...............%%%%%%%%%%%%%%%%%%%%%%%%%%%%%
m %%%%%%%%...................%....%......%%%%%%%%.....%%%%%%%%%%%%.......................%.%%%..............%%%%%%%%%%%%.%%%%%%%%%%%%%%%%
m %%%%%%%%%.................%%...........%.%%%%%.....%%%%%%%%%%%%%%%%..%%%......%%....%%%%%%%%%.............%%%%%%%%%%%...%%%%%%%%%%%%%%%
m %%%%%%%%...................%...........%..%..%.....%%%%%%%%%%%%%%%%..%%%......%......%%%%%%%%............%%....%%%%%%...%%%%%%%%%%%%%%%
m %%%%%%%...........................................%%%%%%%%%%%%%%%%..........%%..%%%....%%%%%%.............%....%%%%%%....%%%%%%%%%%%%%%
m %%%%%%%%..................................%......%%%%%%%%..%%%.%%%%.........%...%%.....%%%%.....................%%%%..%%%%%%%%%%%%%%%%%
m %%%%%%%.................................%%%......%....%%%......%%%%........%%......%%.....%......................%...%%%%%%%%%%%%%%%%%%
m %%.%%....................................%............%%........%%%........%%...........................%............%%%%%%%%%%%%%%%%%%
m %%....%%%.......................................................%%..................................%...%..........%%%%%%%%%%%%%%%%%%%%
m %.....%%%...%................%........................................................%.............%............%.%%%%%%%%%%%%%%%%%%%%
m %..%%%%%%%%%%..%%...........%%.............................%%.........................%..........................%..%%%%%%%%%%%%%%%%%%%
m %%...%%%%%%....%.......%%...%%.............................%%....%%.................................................%%%%%%%%%%%%%%%%%%%
m %%...%%%%%%%...............................................%%...............................................%........%%%%%%%%%%%%%%%%%%
m %%%..%%%%%%%%%%%%%%...............................%%%%......................................................%.%%%%%%.%%%%%%%%%%%%%%%%%%
m %%%....%%%%%%%%%%%%..............................%%%%%..........................................%%..........%.%.%%....%%%%%%%%%%%%%%%%%
m %%%....%%%%%%%%%%..............................%%%%%%%%...................................%%.%%............%%.%.%%%...%%%%%%%%%%%%%%%%%
m %%%%%....%%%%%%%%.............%................%%%%%%%%%..................................%..%.............%%....%%.%%%%%%%%%%%%%%%%%%%
m %%%%%%...%%%%%%.%...........%%%...............%%%%%%%%%%...................................................%%.......%%%%%%%%%%%%%%%%%%%
m %%%%.....%......%...........%%%................%%%%%%%%%%..................................................%%%%%....%%%%%%%%%%%%%%%%%%%
m %%%%%.......%%...............%%................%%%%%%%%%%%%%...........%%.%................................%%.......%%%%%%%%%%%%%%%%%%%
m %%%%........%%..................................%%%%%%...%%............%%%%.%%.............%..............%%%.......%%%%%%%%%%%%%%%%%%%
m %%%%%%......%%...............................%%.%%%%%%...%.............%%%%.%%.............%%%%....%.....%%%%.....%%%%%%%%%%%%%%%%%%%%%
m %%%%........%%................%%.%%..........%..%%%%%%......%%%.........%%..%%%..........%%%%%%%%%%%%....%%%%......%%%%%%%%%%%%%%%%%%%%
m %%%%......%%%%..............0....%%%%..........%%%%%%%%.....%%%%............%%%..........%%%%%%%%%%%%%...%%......%%%%%%%%%%%%%%%%%%%%%%
m %%%%.......%.%...................%%%%..........%%%%%%%%...................%%%%%%%...%%%.%%%%%%%%%%%%%%...%%......%%%%%%%%%%%%%%%%%%%%%%
m %%%%.......%...%.................%%%%..%..%%.....%%%%%...................%%%%%%%%..%%%.%%%%%%%%%%%%%%%%..%%%%%...%%%%%%%%%%%%%%%%%%.%%%
m %%%%%.%....%..%%%.................%%%%%%%.%%%...%%%%%%.............................%%....%%%.%%%%%%%%%...%%%%%%%%%%%%%%%%%%%%%%%%%%....
m %%%%%.%.......%....................%%%%%..%%....%%%%%%%....................%...................%....%.....%%%%%%%%%%.%%%%%%%%%%%%%%...%
m .%%%%%%%.....%%....................%%%%%.........%%%%%%%..%................%................%%.%..........%%%%%%%%%%...%%%%%%%%%%%.....
m ..%%%%%%...........................%%%%%%%%......%%%%%%%.%%.........................%%.......%.%..........%%%%%%%%%%...%.%%%%%%%%%.....
m ..%%%%%%......%%..................%%%%%%%%.......%%%%%%.............................%%.......%..%%...%..%%%%%%%%%%%......%%%%%%%%%.....
m .%%%%%%%%%...%%.................%...%%..%%.......%%%%%%.............%%...............%%%.%...%%..%..%%%%%%%%%%%%%%%...%..%%%%%%%%%%..%.
m .%%%%%%%%%%..%%............%%.%%%%...%..%..%%%.....%..................................%%%%.........%%%%%%%%%%%%%%%%%..%%%%%%%%%%%%%..%%
m ..%%%%%%%................%.%...%%%..%%%.%..%%......%%.................................%%%%%.........%%%%%%%%%%.%%%%...%%%%%%%%%........
m ..%%%%%%%%............%%%%..%%.%%%..%%%....%.......%%..................................%%%..........%%%%%%%%%%..%%%....%%%%%%%.........
m ..%%%%%%.%.................%%%..%%...%%%...%.........................................%.%%...........%%%%%%%%%%...%.....%%%%.%...%...%..
m .%%%...%...............%%%%%%%..%....%%%.......%%..................................%%%%%%%..........%%%%%%..%%...%.....%%%%.....%...%..
m %%%.......%%%...........%%%%%%%......%%%%.......%..............................%%%.%%%%%%%..%%..%.....%%.........%%.....%%%%...........
m ..%.......%%%...........%%%%%%%%.....%%%%.......%................................%.%%%%%%%%%%...%%%.....................%%%.........%%.
m ..........%%......%......%%%%%%.....%%%%%%%..................................%.....%%%%%%%%%....%%%...................%%%%.....%%..%%%.
m .....%............%......%%%%%....%%%%%%%%%...................%.%...........%%....%%%%%%%%%%.....%..........%%%%......%%%%%..%%%%......
m .....%....................%%%%...%%%%%%%%%%.....%.............%.%...........%.........%%%%%%.....%.........%%%%%.....%%%%%%..%.%%......
m ....%%%..........%%......%%%%%%%%%%%%%%%%%%%%..%%%.................%%..........%........%%%%.....%.........%%%%%......%%%%%%%...%......
m .....%..........%%%%%%%.%%%%%%%%%%%%%%%%%%%%%.%%%................%%%%%%%.......%.......%%%%%%%%..%.......%.%%%........%%%%%%%..........
m .................%%%%%%%%%%%%%%%%%%%%%%%%%%%%%%%%.%%%.............%%%%.........%.......%%%%%%%.%.....%%.%%%%%...%.......%%%............
m %...............%%%%%%%%%%%%%%%%%%%%%%%%%%%%%%%%%%%%%.............%..........%.%%......%%%%%%..%.%%%%%%%%%%%%..%%.....................%
m %%..............%%%%%%%%%%%%.%%%%%%%%%%%%%%%%%%%%%%%%...................%....%......%%%%%%%%.....%%%%%%%%%%%%.......................%.%
m %%%.............%%%%%%%%%%%...%%%%%%%%%%%%%%%%%%%%%%%%.................%%...........%.%%%%%.....%%%%%%%%%%%%%%%%..%%%......%%....%%%%%%
m %%%............%%....%%%%%%...%%%%%%%%%%%%%%%%%%%%%%%...................%...........%..%..%.....%%%%%%%%%%%%%%%%..%%%......%......%%%%%
m %%%.............%....%%%%%%....%%%%%%%%%%%%%%%%%%%%%...........................................%%%%%%%%%%%%%%%%..........%%..%%%....%%%
m %.....................%%%%..%%%%%%%%%%%%%%%%%%%%%%%%%..................................%......%%%%%%%%..%%%.%%%%.........%...%%.....%%%
m %......................%...%%%%%%%%%%%%%%%%%%%%%%%%%.................................%%%......%....%%%......%%%%........%%......%%.....
m ..............%............%%%%%%%%%%%%%%%%%%%%.%%....................................%............%%........%%%........%%.............
m ..........%...%..........%%%%%%%%%%%%%%%%%%%%%%....%%%.......................................................%%........................
m ..........%............%.%%%%%%%%%%%%%%%%%%%%%.....%%%...%................%........................................................%...
m .......................%..%%%%%%%%%%%%%%%%%%%%..%%%%%%%%%%..%%...........%%.............................%%.........................%...
m ..........................%%%%%%%%%%%%%%%%%%%%%...%%%%%%....%.......%%...%%.............................%%....%%.......................
m ..................%........%%%%%%%%%%%%%%%%%%%%...%%%%%%%...............................................%%.............................
m ..................%.%%%%%%.%%%%%%%%%%%%%%%%%%%%%..%%%%%%%%%%%%%%...............................%%%%....................................
m ......%%..........%.%.%%....%%%%%%%%%%%%%%%%%%%%....%%%%%%%%%%%%..............................%%%%%....................................
m %%.%%............%%.%.%%%...%%%%%%%%%%%%%%%%%%%%....%%%%%%%%%%..............................%%%%%%%%...................................
m %..%.............%%....%%.%%%%%%%%%%%%%%%%%%%%%%%%....%%%%%%%%.............%................%%%%%%%%%..................................
m .................%%.......%%%%%%%%%%%%%%%%%%%%%%%%%...%%%%%%.%...........%%%...............%%%%%%%%%%..................................
m .................%%%%%....%%%%%%%%%%%%%%%%%%%%%%%.....%......%...........%%%................%%%%%%%%%%.................................
m .................%%.......%%%%%%%%%%%%%%%%%%%%%%%%.......%%...............%%................%%%%%%%%%%%%%...........%%.%...............
m .%..............%%%.......%%%%%%%%%%%%%%%%%%%%%%%........%%..................................%%%%%%...%%............%%%%.%%............
m .%%%%....%.....%%%%.....%%%%%%%%%%%%%%%%%%%%%%%%%%%......%%...............................%%.%%%%%%...%.............%%%%.%%............
m %%%%%%%%%%%....%%%%......%%%%%%%%%%%%%%%%%%%%%%%%........%%................%%.%%..........%..%%%%%%......%%%.........%%..%%%..........%
m %%%%%%%%%%%%...%%......%%%%%%%%%%%%%%%%%%%%%%%%%%......%%%%..............2....%%%%..........%%%%%%%%.....%%%%............%%%..........%
m %%%%%%%%%%%%...%%......%%%%%%%%%%%%%%%%%%%%%%%%%%.......%.%...................%%%%..........%%%%%%%%...................%%%%%%%...%%%.%%
m %%%%%%%%%%%%%..%%%%%...%%%%%%%%%%%%%%%%%%.%%%%%%%.......%...%.................%%%%..%..%%.....%%%%%...................%%%%%%%%..%%%.%%%
m %%.%%%%%%%%%...%%%%%%%%%%%%%%%%%%%%%%%%%%....%%%%%.%....%..%%%.................%%%%%%%.%%%...%%%%%%.............................%%....%
m .....%....%.....%%%%%%%%%%.%%%%%%%%%%%%%%...%%%%%%.%.......%....................%%%%%..%%....%%%%%%%....................%..............
m ..%%.%..........%%%%%%%%%%...%%%%%%%%%%%......%%%%%%%.....%%....................%%%%%.........%%%%%%%..%................%..............
m ...%.%..........%%%%%%%%%%...%.%%%%%%%%%.......%%%%%%...........................%%%%%%%%......%%%%%%%.%%.........................%%....
m ...%..%%...%..%%%%%%%%%%%......%%%%%%%%%.......%%%%%%......%%..................%%%%%%%%.......%%%%%%.............................%%....
m ...%%..%..%%%%%%%%%%%%%%%...%..%%%%%%%%%%..%..%%%%%%%%%...%%.................%...%%..%%.......%%%%%%.............%%...............%%%.%
m .........%%%%%%%%%%%%%%%%%..%%%%%%%%%%%%%..%%.%%%%%%%%%%..%%............%%.%%%%...%..%..%%%.....%..................................%%%%
m %.........%%%%%%%%%%.%%%%...%%%%%%%%%..........%%%%%%%................%.%...%%%..%%%.%..%%......%%.................................%%%%
m ..........%%%%%%%%%%..%%%....%%%%%%%...........%%%%%%%%............%%%%..%%.%%%..%%%....%.......%%..................................%%%
m ..........%%%%%%%%%%...%.....%%%%.%...%...%....%%%%%%.%.................%%%..%%...%%%...%.........................................%.%%.
m ..........%%%%%%..%%...%.....%%%%.....%...%...%%%...%...............%%%%%%%..%....%%%.......%%..................................%%%%%%%
m ..%%..%.....%%.........%%.....%%%%...........%%%.......%%%...........%%%%%%%......%%%%.......%..............................%%%.%%%%%%%
m %%%...%%%.....................%%%.........%%...%.......%%%...........%%%%%%%%.....%%%%.......%................................%.%%%%%%%
m %%....%%%...................%%%%.....%%..%%%...........%%......%......%%%%%%.....%%%%%%%..................................%.....%%%%%%%
m %%.....%..........%%%%......%%%%%..%%%%...........%............%......%%%%%....%%%%%%%%%...................%.%...........%%....%%%%%%%%
m %%.....%.........%%%%%.....%%%%%%..%.%%...........%....................%%%%...%%%%%%%%%%.....%.............%.%...........%.........%%%%
m %%.....%.........%%%%%......%%%%%%%...%..........%%%..........%%......%%%%%%%%%%%%%%%%%%%%..%%%.................%%..........%........%%
m %%%%%..%.......%.%%%........%%%%%%%...............%..........%%%%%%%.%%%%%%%%%%%%%%%%%%%%%.%%%................%%%%%%%.......%.......%%%
m %%%%.%.....%%.%%%%%...%.......%%%.............................%%%%%%%%%%%%%%%%%%%%%%%%%%%%%%%%.%%%.............%%%%.........%.......%%%
m %%%..%.%%%%%%%%%%%%..%%.....................%%...............%%%%%%%%%%%%%%%%%%%%%%%%%%%%%%%%%%%%%.............%..........%.%%......%%%
m %%.....%%%%%%%%%%%%.......................%.%%%..............%%%%%%%%%%%%.%%%%%%%%%%%%%%%%%%%%%%%%...................%....%......%%%%%%
m %.....%%%%%%%%%%%%%%%%..%%%......%%....%%%%%%%%%.............%%%%%%%%%%%...%%%%%%%%%%%%%%%%%%%%%%%%.................%%...........%.%%%%
m %.....%%%%%%%%%%%%%%%%..%%%......%......%%%%%%%%............%%....%%%%%%...%%%%%%%%%%%%%%%%%%%%%%%...................%...........%..%..
m .....%%%%%%%%%%%%%%%%..........%%..%%%....%%%%%%.............%....%%%%%%....%%%%%%%%%%%%%%%%%%%%%......................................
m ....%%%%%%%%..%%%.%%%%.........%...%%.....%%%%.....................%%%%..%%%%%%%%%%%%%%%%%%%%%%%%%..................................%..
m ....%....%%%......%%%%........%%......%%.....%......................%...%%%%%%%%%%%%%%%%%%%%%%%%%.................................%%%..
m .........%%........%%%........%%...........................%............%%%%%%%%%%%%%%%%%%%%.%%....................................%...
m ...................%%..................................%...%..........%%%%%%%%%%%%%%%%%%%%%%....%%%....................................
m .........................................%.............%............%.%%%%%%%%%%%%%%%%%%%%%.....%%%...%................%...............
m ..............%%.........................%..........................%..%%%%%%%%%%%%%%%%%%%%..%%%%%%%%%%..%%...........%%...............
m ..............%%....%%.................................................%%%%%%%%%%%%%%%%%%%%%...%%%%%%....%.......%%...%%...............
m ..............%%...............................................%........%%%%%%%%%%%%%%%%%%%%...%%%%%%%.................................
m .....%%%%......................................................%.%%%%%%.%%%%%%%%%%%%%%%%%%%%%..%%%%%%%%%%%%%%..........................
m ....%%%%%..........................................%%..........%.%.%%....%%%%%%%%%%%%%%%%%%%%....%%%%%%%%%%%%..........................
m ..%%%%%%%%...................................%%.%%............%%.%.%%%...%%%%%%%%%%%%%%%%%%%%....%%%%%%%%%%............................
m ..%%%%%%%%%..................................%..%.............%%....%%.%%%%%%%%%%%%%%%%%%%%%%%%....%%%%%%%%.............%..............
m .%%%%%%%%%%...................................................%%.......%%%%%%%%%%%%%%%%%%%%%%%%%...%%%%%%.%...........%%%..............
m ..%%%%%%%%%%..................................................%%%%%....%%%%%%%%%%%%%%%%%%%%%%%.....%......%...........%%%..............
m ..%%%%%%%%%%%%%...........%%.%................................%%.......%%%%%%%%%%%%%%%%%%%%%%%%.......%%...............%%..............
m ...%%%%%%...%%............%%%%.%%.............%..............%%%.......%%%%%%%%%%%%%%%%%%%%%%%........%%...............................
m %%.%%%%%%...%.............%%%%.%%.............%%%%....%.....%%%%.....%%%%%%%%%%%%%%%%%%%%%%%%%%%......%%...............................
m %..%%%%%%......%%%.........%%..%%%..........%%%%%%%%%%%%....%%%%......%%%%%%%%%%%%%%%%%%%%%%%%........%%................%%.%%..........
m ..%%%%%%%%.....%%%%............%%%..........%%%%%%%%%%%%%...%%......%%%%%%%%%%%%%%%%%%%%%%%%%%......%%%%..............1....%%%%........
m ..%%%%%%%%...................%%%%%%%...%%%.%%%%%%%%%%%%%%...%%......%%%%%%%%%%%%%%%%%%%%%%%%%%.......%.%...................%%%%........
m ....%%%%%...................%%%%%%%%..%%%.%%%%%%%%%%%%%%%%..%%%%%...%%%%%%%%%%%%%%%%%%.%%%%%%%.......%...%.................%%%%..%..%%.
m ...%%%%%%.............................%%....%%%.%%%%%%%%%...%%%%%%%%%%%%%%%%%%%%%%%%%%....%%%%%.%....%..%%%.................%%%%%%%.%%%
m ...%%%%%%%....................%...................%....%.....%%%%%%%%%%.%%%%%%%%%%%%%%...%%%%%%.%.......%....................%%%%%..%%.
m ....%%%%%%%..%................%................%%.%..........%%%%%%%%%%...%%%%%%%%%%%......%%%%%%%.....%%....................%%%%%.....
m ....%%%%%%%.%%.........................%%.......%.%..........%%%%%%%%%%...%.%%%%%%%%%.......%%%%%%...........................%%%%%%%%..
m ....%%%%%%.............................%%.......%..%%...%..%%%%%%%%%%%......%%%%%%%%%.......%%%%%%......%%..................%%%%%%%%...
m ....%%%%%%.............%%...............%%%.%...%%..%..%%%%%%%%%%%%%%%...%..%%%%%%%%%%..%..%%%%%%%%%...%%.................%...%%..%%...
m %.....%..................................%%%%.........%%%%%%%%%%%%%%%%%..%%%%%%%%%%%%%..%%.%%%%%%%%%%..%%............%%.%%%%...%..%..%%
m ......%%.................................%%%%%.........%%%%%%%%%%.%%%%...%%%%%%%%%..........%%%%%%%................%.%...%%%..%%%.%..%%
m ......%%..................................%%%..........%%%%%%%%%%..%%%....%%%%%%%...........%%%%%%%%............%%%%..%%.%%%..%%%....%.
m ........................................%.%%...........%%%%%%%%%%...%.....%%%%.%...%...%....%%%%%%.%.................%%%..%%...%%%...%.
m ..%%..................................%%%%%%%..........%%%%%%..%%...%.....%%%%.....%...%...%%%...%...............%%%%%%%..%....%%%.....
m ...%..............................%%%.%%%%%%%..%%..%.....%%.........%%.....%%%%...........%%%.......%%%...........%%%%%%%......%%%%....
m ...%................................%.%%%%%%%%%%...%%%.....................%%%.........%%...%.......%%%...........%%%%%%%%.....%%%%....
m ................................%.....%%%%%%%%%....%%%...................%%%%.....%%..%%%...........%%......%......%%%%%%.....%%%%%%%..
m .................%.%...........%%....%%%%%%%%%%.....%..........%%%%......%%%%%..%%%%...........%............%......%%%%%....%%%%%%%%%..
