# map type: blank
# random seed: -412156421
# hill distance  49, 53  31, 26  13, 80
#        49, 53       0      45      45 
#        31, 26      45       0      45 
#        13, 80      45      45       0 
players 3
rows 54
cols 81
m ......................%%%%%%..........%%.%.......................................
m ......................%%%%%%%.........%%..........%..............................
m .....................%%%%%%%%%...%%%%%%%..........%..............................
m ......................%.%%%%%%%..%%%%.%...........%..............................
m ........................%%%%%.....%%..............%..............................
m ...........................%%%%%%.....................................%%.........
m .................%.........%%%..%.....%..........................................
m .................%.%........%%.......%%..................%%......................
m ..............%....%........%........%%...........%.......%%%%...................
m %............%%....%%......%%......%..............%%%......%%%..........%.......%
m ...........%%%%%%..%..............%%..............%........%%%..........%........
m ...........%%%%%.................%%%....%%%.........................%%...........
m .................................%.......%..............................%........
m ................%.......................................................%%......0
m ...............%%.....................................................%%%%...%%..
m ...............%%%..................................................%%%%%%%......
m ....................................................................%%%%%%%......
m ..................................................................%%%%%%%........
m .................................................%%%%%%..........%%.%............
m .................................................%%%%%%%.........%%..........%...
m ................................................%%%%%%%%%...%%%%%%%..........%...
m .................................................%.%%%%%%%..%%%%.%...........%...
m ...................................................%%%%%.....%%..............%...
m ................%%....................................%%%%%%.....................
m ............................................%.........%%%..%.....%...............
m ...%%.......................................%.%........%%.......%%...............
m ....%%%%.................................%....%........%........%%...........%...
m .....%%%..........%.......%%............%%....%%......%%......%..............%%%.
m .....%%%..........%...................%%%%%%..%..............%%..............%...
m ..............%%......................%%%%%.................%%%....%%%...........
m ..................%.........................................%.......%............
m ..................%%......2................%.....................................
m ................%%%%...%%.................%%.....................................
m ..............%%%%%%%.....................%%%....................................
m ..............%%%%%%%............................................................
m ............%%%%%%%..............................................................
m %..........%%.%.............................................................%%%%%
m %%.........%%..........%....................................................%%%%%
m %%%...%%%%%%%..........%...................................................%%%%%%
m %%%%..%%%%.%...........%....................................................%.%%%
m %%.....%%..............%......................................................%%%
m %%%%%%.....................................%%....................................
m %%%..%.....%...........................................................%.........
m .%%.......%%..................%%.......................................%.%.......
m .%........%%...........%.......%%%%.................................%....%.......
m %%......%..............%%%......%%%..........%.......%%............%%....%%......
m .......%%..............%........%%%..........%...................%%%%%%..%.......
m ......%%%....%%%.........................%%......................%%%%%...........
m ......%.......%..............................%...................................
m .............................................%%......1................%..........
m ...........................................%%%%...%%.................%%..........
m .........................................%%%%%%%.....................%%%.........
m .........................................%%%%%%%.................................
m .......................................%%%%%%%...................................
