# map type: blank
# random seed: -871163214
# hill distance  21, 47  46, 68 146, 26  96,110 121,  5  71, 89
#        21, 47       0      46      46     138      92      92 
#        46, 68      46       0      92      92     138      46 
#       146, 26      46      92       0      92      46     138 
#        96,110     138      92      92       0      46      46 
#       121,  5      92     138      46      46       0      92 
#        71, 89      92      46     138      46      92       0 
players 6
rows 150
cols 126
m ...............................................%..................................................%%..%.%.....................
m ....................................................%%.....................%%....................%%.%%%.......................
m ................................................%...........................%%..................%%%..%........................
m ...................%%............%%.............%..........................%%..................%%%.....%%.....%...............
m ...................%.............%%..........................................%..................%......%.....%%.%%%...........
m ...................................%%........................................%%%.......................%........%%%%..........
m .................................%..........................................%%..........................%%%%....%%%%%.........
m .................................%%........................................................................%.......%%%%.......
m %.%%%%%%.....................%%..%%..................................................................................%%.....%%
m ..%%%%%%.....................%%.....................................................................................%%%......%
m .....%%%......................%%.............................................................................%%.....%%%%.%....
m .%%...%%.......................%%...........................................................................%%%%.%%%%%%%.%.%%%
m %%%...%%.......................%%.............................................................................%%%%%%%%%%....%%
m %%%..............................................................................................................%%.%%%%.....%
m %%%.................................................................................................................%%.%%...%%
m %%%%................................................................................................................%...%...%%
m %......................................................................................................................%%....%
m .......................................................................................................................%%%....
m ..............................................................................................................................
m %%............................................................................................................................
m .............................................%%%.........%%...............%........................................%%%........
m ...............................................4..........................%%.........................................%.%......
m .......................................................................%..%............................................%......
m ....................................................%......%%..........%%..............................................%%.....
m %...................................................%...............%...................................................%...%%
m ....................................................................%..................................................%%..%.%
m .........................................................................%%.....................%%....................%%.%%%..
m .....................................................................%...........................%%..................%%%..%...
m .....%..................................%%............%%.............%..........................%%..................%%%.....%%
m ....%%.%%%..............................%.............%%..........................................%..................%......%.
m .......%%%%.............................................%%........................................%%%.......................%.
m %%%....%%%%%..........................................%..........................................%%..........................%
m ..%.......%%%%........................................%%......................................................................
m ............%%.....%%%.%%%%%%.....................%%..%%......................................................................
m ...........%%%......%..%%%%%%.....................%%..........................................................................
m ....%%.....%%%%.%.........%%%......................%%.........................................................................
m ...%%%%.%%%%%%%.%.%%%.%%...%%.......................%%........................................................................
m .....%%%%%%%%%%....%%%%%...%%.......................%%........................................................................
m ........%%.%%%%.....%%%%......................................................................................................
m ...........%%.%%...%%%%%......................................................................................................
m ...........%...%...%%%%%%.....................................................................................................
m ..............%%....%%........................................................................................................
m ..............%%%.............................................................................................................
m ..............................................................................................................................
m .....................%%.......................................................................................................
m ..........%%%.....................................................%%%.........%%...............%..............................
m ............%.%.....................................................5..........................%%.............................
m ..............%.............................................................................%..%..............................
m ..............%%.........................................................%......%%..........%%................................
m ...............%...%%%...................................................%...............%....................................
m ..............%%..%.%....................................................................%....................................
m .............%%.%%%...........................................................................%%.....................%%.......
m ............%%%..%........................................................................%...........................%%......
m ...........%%%.....%%.....%..................................%%............%%.............%..........................%%.......
m ............%......%.....%%.%%%..............................%.............%%..........................................%......
m ...................%........%%%%.............................................%%........................................%%%....
m ....................%%%%....%%%%%..........................................%..........................................%%......
m .......................%.......%%%%........................................%%.................................................
m .................................%%.....%%%.%%%%%%.....................%%..%%.................................................
m ................................%%%......%..%%%%%%.....................%%.....................................................
m .........................%%.....%%%%.%.........%%%......................%%....................................................
m ........................%%%%.%%%%%%%.%.%%%.%%...%%.......................%%...................................................
m ..........................%%%%%%%%%%....%%%%%...%%.......................%%...................................................
m .............................%%.%%%%.....%%%%.................................................................................
m ................................%%.%%...%%%%%.................................................................................
m ................................%...%...%%%%%%................................................................................
m ...................................%%....%%...................................................................................
m ...................................%%%........................................................................................
m ..............................................................................................................................
m ..........................................%%..................................................................................
m ...............................%%%.....................................................%%%.........%%...............%.........
m .................................%.%.....................................................0..........................%%........
m ...................................%.............................................................................%..%.........
m ...................................%%.........................................................%......%%..........%%...........
m ....................................%...%%%...................................................%...............%...............
m ...................................%%..%.%....................................................................%...............
m ............%%....................%%.%%%...........................................................................%%.........
m .............%%..................%%%..%........................................................................%..............
m ............%%..................%%%.....%%.....%..................................%%............%%.............%..............
m ..............%..................%......%.....%%.%%%..............................%.............%%............................
m ..............%%%.......................%........%%%%.............................................%%..........................
m .............%%..........................%%%%....%%%%%..........................................%.............................
m ............................................%.......%%%%........................................%%............................
m ......................................................%%.....%%%.%%%%%%.....................%%..%%............................
m .....................................................%%%......%..%%%%%%.....................%%................................
m ..............................................%%.....%%%%.%.........%%%......................%%...............................
m .............................................%%%%.%%%%%%%.%.%%%.%%...%%.......................%%..............................
m ...............................................%%%%%%%%%%....%%%%%...%%.......................%%..............................
m ..................................................%%.%%%%.....%%%%............................................................
m .....................................................%%.%%...%%%%%............................................................
m .....................................................%...%...%%%%%%...........................................................
m ........................................................%%....%%..............................................................
m ........................................................%%%...................................................................
m ..............................................................................................................................
m ...............................................................%%.............................................................
m ...........%........................................%%%.....................................................%%%.........%%....
m ...........%%.........................................%.%.....................................................1...............
m ........%..%............................................%.....................................................................
m ........%%..............................................%%.........................................................%......%%..
m .....%...................................................%...%%%...................................................%..........
m .....%..................................................%%..%.%...............................................................
m ..........%%.....................%%....................%%.%%%.................................................................
m ......%...........................%%..................%%%..%..................................................................
m ......%..........................%%..................%%%.....%%.....%..................................%%............%%.......
m ...................................%..................%......%.....%%.%%%..............................%.............%%.......
m ...................................%%%.......................%........%%%%.............................................%%.....
m ..................................%%..........................%%%%....%%%%%..........................................%........
m .................................................................%.......%%%%........................................%%.......
m ...........................................................................%%.....%%%.%%%%%%.....................%%..%%.......
m ..........................................................................%%%......%..%%%%%%.....................%%...........
m ...................................................................%%.....%%%%.%.........%%%......................%%..........
m ..................................................................%%%%.%%%%%%%.%.%%%.%%...%%.......................%%.........
m ....................................................................%%%%%%%%%%....%%%%%...%%.......................%%.........
m .......................................................................%%.%%%%.....%%%%.......................................
m ..........................................................................%%.%%...%%%%%.......................................
m ..........................................................................%...%...%%%%%%......................................
m .............................................................................%%....%%.........................................
m .............................................................................%%%..............................................
m ..............................................................................................................................
m ....................................................................................%%........................................
m ...%%%.........%%...............%........................................%%%..................................................
m .....2..........................%%.........................................%.%................................................
m .............................%..%............................................%................................................
m ..........%......%%..........%%..............................................%%...............................................
m ..........%...............%...................................................%...%%%.........................................
m ..........................%..................................................%%..%.%..........................................
m ...............................%%.....................%%....................%%.%%%............................................
m ...........................%...........................%%..................%%%..%.............................................
m ............%%.............%..........................%%..................%%%.....%%.....%..................................%%
m ............%%..........................................%..................%......%.....%%.%%%..............................%.
m ..............%%........................................%%%.......................%........%%%%...............................
m ............%..........................................%%..........................%%%%....%%%%%..............................
m ............%%........................................................................%.......%%%%............................
m ........%%..%%..................................................................................%%.....%%%.%%%%%%.............
m ........%%.....................................................................................%%%......%..%%%%%%.............
m .........%%.............................................................................%%.....%%%%.%.........%%%.............
m ..........%%...........................................................................%%%%.%%%%%%%.%.%%%.%%...%%.............
m ..........%%.............................................................................%%%%%%%%%%....%%%%%...%%.............
m ............................................................................................%%.%%%%.....%%%%..................
m ...............................................................................................%%.%%...%%%%%..................
m ...............................................................................................%...%...%%%%%%.................
m ..................................................................................................%%....%%....................
m ..................................................................................................%%%.........................
m ..............................................................................................................................
m .........................................................................................................%%...................
m ........................%%%.........%%...............%........................................%%%.............................
m ..........................3..........................%%.........................................%.%...........................
m ..................................................%..%............................................%...........................
m ...............................%......%%..........%%..............................................%%..........................
m ...............................%...............%...................................................%...%%%....................
