rows 128
cols 128
players 8
m %%%%%%%%%%.....%%%%.....%%%%%%%%%%%%%%%%%%......%%.....%%%%%%%%%%%%%%%%%%%.....%%%%.....%%%%%%%%%%%%%%%%%%%.....%%......%%%%%%%%
m %%%%%%%%%%....%%%%%%....%%%%%%%%%%%%..%.........%%%....%%%%.....%..%%.%..%%.....%%.....%%..%.%%..%.....%%%%....%%%.........%..%%
m %%%%%%%%%%..............%%%%%%%%%%%............%%%%.....%%.....................%%%%.....................%%.....%%%%............%
m %%%%%%%%%................%%%%%%%%%%.............%%%.....%%%.....................%%.....................%%%.....%%%.............%
m %%%%%%%%%%..............%%%%%%%%%%%.............%%%.....%%......................%%......................%%.....%%%.............%
m %%%%%%%%%................%%%%%%%%%..............%%%.....%%%.....................%%.....................%%%.....%%%..............
m %%%%%%%%%................%%%%%%%%%.......%%....%%%%..%.%%%%.....%%.....%..%.%%.%%%%.%%.%..%.....%%.....%%%%.%..%%%%....%%.......
m %%%%%%%%%%....%%..%%....%%%%%%%%%%.....%%%......%%%%%%%%%%%.....%%......%%%%%%%%%%%%%%%%%%......%%.....%%%%%%%%%%%......%%%.....
m %%%%%%%%%%....%%%%%%....%%%%%%%%%%%.....%%......%%%%%%%%%%.....%%%.....%%%%%%%%%%%%%%%%%%%%.....%%%.....%%%%%%%%%%......%%.....%
m %%%.%..%%%.....%%%%.....%%%..%.%%%%....%%%%....%.%..%%%%%%%....%%.%......%.....%%%%.....%......%.%%....%%%%%%%..%.%....%%%%....%
m ..............%%%%%%...................%%%......................................%%......................................%%%.....
m ...........%%%%%%%%%%%%.................%%%..4.................................%%%%.................................7..%%%......
m ...........%%%%%%%%%%%%.................%%......................................%%......................................%%......
m ...........%%%%%%%%%%%%.................%%.....................................%%%%.....................................%%......
m .%.....%%.%%%%%%%%%%%%%%.%%.....%....%.%%%%..%..%..............%%.%.....%.%....%%%%....%.%.....%.%%..............%..%..%%%%.%...
m %%.....%%%%%%%%%%%%%%%%%%%%.....%%%%%%%%%%%%%%%%%%......%%......%%.....%%%.....%%%%.....%%%.....%%......%%......%%%%%%%%%%%%%%%%
m %%......%%%%%%%%%%%%%%%%%%......%%%%%%%%%%%%%%%%%%......%%%.....%%......%%......%%......%%......%%.....%%%......%%%%%%%%%%%%%%%%
m %%......%%%%%%%%%%%%%%%%%%......%%%%%%%%%%%%%%%%%%......%%%.....%%......%%......%%......%%......%%.....%%%......%%%%%%%%%%%%%%%%
m %%.....%%%%%%%%%%%%%%%%%%%%.....%%%%%%%%%%%%%%%%%%......%%......%%.....%%%.....%%%%.....%%%.....%%......%%......%%%%%%%%%%%%%%%%
m .%.....%%.%%%%%%%%%%%%%%.%%.....%....%.%%%%..%..%..............%%.%.....%.%....%%%%....%.%.....%.%%..............%..%..%%%%.%...
m ...........%%%%%%%%%%%%.................%%.....................................%%%%.....................................%%......
m ...........%%%%%%%%%%%%.................%%......................................%%......................................%%......
m ...........%%%%%%%%%%%%.................%%%..6.................................%%%%.................................5..%%%......
m ..............%%%%%%...................%%%......................................%%......................................%%%.....
m %%%.%..%%%.....%%%%.....%%%..%.%%%%....%%%%....%.%..%%%%%%%....%%.%......%.....%%%%.....%......%.%%....%%%%%%%..%.%....%%%%....%
m %%%%%%%%%%....%%%%%%....%%%%%%%%%%%.....%%......%%%%%%%%%%.....%%%.....%%%%%%%%%%%%%%%%%%%%.....%%%.....%%%%%%%%%%......%%.....%
m %%%%%%%%%%....%%..%%....%%%%%%%%%%.....%%%......%%%%%%%%%%%.....%%......%%%%%%%%%%%%%%%%%%......%%.....%%%%%%%%%%%......%%%.....
m %%%%%%%%%................%%%%%%%%%.......%%....%%%%..%.%%%%.....%%.....%..%.%%.%%%%.%%.%..%.....%%.....%%%%.%..%%%%....%%.......
m %%%%%%%%%................%%%%%%%%%..............%%%.....%%%.....................%%.....................%%%.....%%%..............
m %%%%%%%%%%..............%%%%%%%%%%%.............%%%.....%%......................%%......................%%.....%%%.............%
m %%%%%%%%%................%%%%%%%%%%.............%%%.....%%%.....................%%.....................%%%.....%%%.............%
m %%%%%%%%%%..............%%%%%%%%%%%............%%%%.....%%.....................%%%%.....................%%.....%%%%............%
m %%%%%%%%%%....%%%%%%....%%%%%%%%%%%%..%.........%%%....%%%%.....%..%%.%..%%.....%%.....%%..%.%%..%.....%%%%....%%%.........%..%%
m %%%%%%%%%%.....%%%%.....%%%%%%%%%%%%%%%%%%......%%.....%%%%%%%%%%%%%%%%%%%.....%%%%.....%%%%%%%%%%%%%%%%%%%.....%%......%%%%%%%%
m %%%%%...%%.....%%%%.....%%...%%%%%%%%%%%%%%....%%%%....%%%%%%%%%%%%%%%%%%%......%%......%%%%%%%%%%%%%%%%%%%....%%%%....%%%%%%%%%
m %%.............%%%%.............%%%%%%%%%%%....%%%......%%%%%%%%.%.%..%.%%%............%%%.%..%.%.%%%%%%%%......%%%....%%%%%%%%%
m %..............%%%%..............%%%%%%%%%%.............%%%............................................%%%.............%%%%%%%%%
m %.............%%%%%%.............%%%%%%%%%%............%%%%............................................%%%%............%%%%%%%%%
m %%.............%%%%.............%%%%%%%%%%..............%%%............................................%%%..............%%%%%%%%
m %......%.%%...%%%%%%...%%.%......%%%%%%%%%%.............%%%........6..........................5........%%%.............%%%%%%%%%
m %......%%%%%%%%%%%%%%%%%%%%......%%%%%%%%%%.%%%..%%....%%%%....%%%%.%%.%%%..............%%%.%%.%%%%....%%%%....%%..%%%.%%%%%%%%%
m %.....%%%%%%%%%%%%%%%%%%%%%%.....%%%%%%%%%%%%%%%%%......%%%....%%%%%%%%%%%.....%%%%.....%%%%%%%%%%%....%%%......%%%%%%%%%%%%%%%%
m ......%..%.%..%%%%%%..%.%..%......%%%%.%%%%%%%%%%%%.....%%......%%%%%%%%%%%....%%%%....%%%%%%%%%%%......%%.....%%%%%%%%%%%%.%%%%
m ...............%%%%......................%%%%%%%%%%....%..%....%.%%%%%%%%......%%%%......%%%%%%%%.%....%..%....%%%%%%%%%%.......
m ...............%%%%.....................%%%%%%%%%%%............................................................%%%%%%%%%%%......
m ...........0..%%%%%%..1.................%%%%%%%%%%%......3..............................................2......%%%%%%%%%%%......
m ...............%%%%.....................%%%%%%%%%%..............................................................%%%%%%%%%%......
m ..%...%..%.....%%%%.....%..%...%..%%.....%%%%%%%%%%............................................................%%%%%%%%%%.....%%
m %%%%%%%%%.....%%%%%%.....%%%%%%%%%%%.....%%%%%%%%%%%%%.%.%%...%%%%%...%.%................%.%...%%%%%...%%.%.%%%%%%%%%%%%%.....%%
m %%%%%%%%%%.....%%%%.....%%%%%%%%%%%%....%%%%%%%%%%%%%%%%%%%%%%%%%%%%%%%%%%......%%......%%%%%%%%%%%%%%%%%%%%%%%%%%%%%%%%%%....%%
m .%%%%%%%%................%%%%%%%%.%.....%.%%%%.%%%%%%%%%%%%%%%%%%%%%%%%%%%%.....%%.....%%%%%%%%%%%%%%%%%%%%%%%%%%%%.%%%%.%.....%
m .......%%................%%.....................%%%%%%%%%%%%%......%%.%%%%......%%......%%%%.%%......%%%%%%%%%%%%%..............
m .......%%%..............%%%.....................%%%%%%%%%%%............%%%%.....%%.....%%%%............%%%%%%%%%%%..............
m ......%%%%..............%%%%....................%%%%%%%%%%.............%%%%.....%%.....%%%%.............%%%%%%%%%%..............
m .......%%%..............%%%......................%%%%%%%%%%.............%%......%%......%%.............%%%%%%%%%%...............
m %%....%%%%..............%%%%....%%%..%..%..%....%%%%%%%%%%.............%%%%.....%%.....%%%%.............%%%%%%%%%%....%..%..%..%
m %%%%%%%%%%.....%%%%.....%%%%%%%%%%%%%%%%%%%......%%%%%%%%%%.%.%.%......%%%%.....%%.....%%%%......%.%.%.%%%%%%%%%%......%%%%%%%%%
m %%%%%%%%%%.....%%%%.....%%%%%%%%%%%%%%%%%%%..5..%%%%%%%%%%%%%%%%%%......%%......%%......%%......%%%%%%%%%%%%%%%%%%..6..%%%%%%%%%
m %%.%.%%%.%......%%......%.%%%.%.%%%%%%%%%%.%....%%%%%.%.%%%%%%%%%%%.....%%.....%%%%.....%%.....%%%%%%%%%%%.%.%%%%%....%.%%%%%%%%
m %................................%%%.............%%%.....%%%%%%%.%%......%%............%%......%%.%%%%%%%.....%%%.............%%
m %................................%%%.............%%%....%%%%%%%....................................%%%%%%%....%%%.............%%
m %................................%%%.............%%......%%%%%%....................................%%%%%%......%%.............%%
m %................................%%%............%%%.....%%%%%%%....................................%%%%%%%.....%%%............%%
m %.......%%....%....%....%%.......%%%....%%.%....%%%......%%%..........................................%%%......%%%....%.%%....%%
m %%....%%%%....%%%%%%....%%%%....%%%.....%%%.....%%%.....%%%.....%%%%%%%%.%.....%%%%.....%.%%%%%%%%.....%%%.....%%%.....%%%.....%
m %.....%%%......%%%%......%%%.....%%%....%%%%....%%%......%%%....%%%%%%%%%%......%%......%%%%%%%%%%....%%%......%%%....%%%%....%%
m %........%....%....%....%........%%.....%%%%....%%%.......%%....%%%%%%%%%%......%%......%%%%%%%%%%....%%.......%%%....%%%%.....%
m %%..............................%%%%...1.%%%.....%%%............%%%%%%%%%%%....%..%....%%%%%%%%%%%............%%%.....%%%.0...%%
m %%..............................%%%.....%%%%.....%%%............%%%%%%%%%%%............%%%%%%%%%%%............%%%.....%%%%.....%
m %................................%%.....%%%%.....%%.............%%%%%%%%%%%............%%%%%%%%%%%.............%%.....%%%%.....%
m %%..............................%%%%.....%%%....%%%%............%%%%%%%%%%%............%%%%%%%%%%%............%%%%....%%%.....%%
m %.....%.%......%..%......%.%.....%%.....%%%%.....%%%%%.%%.......%%%%%%%%%%..............%%%%%%%%%%.......%%.%%%%%.....%%%%.....%
m %......%%.....%%%%%%.....%%......%%%....%%%%....%%%%%%%%%%%......%%%%%%%%%%%.%......%.%%%%%%%%%%%......%%%%%%%%%%%....%%%%....%%
m %%.....%%%.....%%%%.....%%%.....%%%%....%%%......%%%%%%%%%%%....%%%%%%%%%%%%%%%%%%%%%%%%%%%%%%%%%%....%%%%%%%%%%%......%%%....%%
m .%....%%%.....%....%.....%%%....%..%......%.......%.%%.%%..%.......%%%%.%%%%%%%%%%%%%%%%%%.%%%%.......%..%%.%%.%.......%......%.
m .......%%................%%.............................................%%%%%%%%%%%%%%%%%%......................................
m ......%%%................%%%.............................................%%%%%%%%%%%%%%%%.......................................
m ......%%%................%%%............................................%%%%%%%%%%%%%%%%%%......................................
m .......%%................%%..............................................%%%%%%%%%%%%%%%%.......................................
m %.%...%%%%.%.%%%..%%%.%.%%%%...%.%.......%%%..............%.....%..%.....%%%%%%%%%%%%%%%%.....%..%.....%..............%%%.......
m %%%%%%%%%%%%%%%%%%%%%%%%%%%%%%%%%%%......%%%.....%%%%%%%%%%.....%%%......%%%%%%%%%%%%%%%%......%%%.....%%%%%%%%%%.....%%%......%
m %%%%%%%%%%%%%%%%%%%%%%%%%%%%%%%%%%%......%%%.....%%%%%%%%%%.....%%%......%%%%%%%%%%%%%%%%......%%%.....%%%%%%%%%%.....%%%......%
m %.%...%%%%.%.%%%..%%%.%.%%%%...%.%.......%%%..............%.....%..%.....%%%%%%%%%%%%%%%%.....%..%.....%..............%%%.......
m .......%%................%%..............................................%%%%%%%%%%%%%%%%.......................................
m ......%%%................%%%............................................%%%%%%%%%%%%%%%%%%......................................
m ......%%%................%%%.............................................%%%%%%%%%%%%%%%%.......................................
m .......%%................%%.............................................%%%%%%%%%%%%%%%%%%......................................
m .%....%%%.....%....%.....%%%....%..%......%.......%.%%.%%..%.......%%%%.%%%%%%%%%%%%%%%%%%.%%%%.......%..%%.%%.%.......%......%.
m %%.....%%%.....%%%%.....%%%.....%%%%....%%%......%%%%%%%%%%%....%%%%%%%%%%%%%%%%%%%%%%%%%%%%%%%%%%....%%%%%%%%%%%......%%%....%%
m %......%%.....%%%%%%.....%%......%%%....%%%%....%%%%%%%%%%%......%%%%%%%%%%%.%......%.%%%%%%%%%%%......%%%%%%%%%%%....%%%%....%%
m %.....%.%......%..%......%.%.....%%.....%%%%.....%%%%%.%%.......%%%%%%%%%%..............%%%%%%%%%%.......%%.%%%%%.....%%%%.....%
m %%..............................%%%%.....%%%....%%%%............%%%%%%%%%%%............%%%%%%%%%%%............%%%%....%%%.....%%
m %................................%%.....%%%%.....%%.............%%%%%%%%%%%............%%%%%%%%%%%.............%%.....%%%%.....%
m %%..............................%%%.....%%%%.....%%%............%%%%%%%%%%%............%%%%%%%%%%%............%%%.....%%%%.....%
m %%..............................%%%%...3.%%%.....%%%............%%%%%%%%%%%....%..%....%%%%%%%%%%%............%%%.....%%%.2...%%
m %........%....%....%....%........%%.....%%%%....%%%.......%%....%%%%%%%%%%......%%......%%%%%%%%%%....%%.......%%%....%%%%.....%
m %.....%%%......%%%%......%%%.....%%%....%%%%....%%%......%%%....%%%%%%%%%%......%%......%%%%%%%%%%....%%%......%%%....%%%%....%%
m %%....%%%%....%%%%%%....%%%%....%%%.....%%%.....%%%.....%%%.....%%%%%%%%.%.....%%%%.....%.%%%%%%%%.....%%%.....%%%.....%%%.....%
m %.......%%....%....%....%%.......%%%....%%.%....%%%......%%%..........................................%%%......%%%....%.%%....%%
m %................................%%%............%%%.....%%%%%%%....................................%%%%%%%.....%%%............%%
m %................................%%%.............%%......%%%%%%....................................%%%%%%......%%.............%%
m %................................%%%.............%%%....%%%%%%%....................................%%%%%%%....%%%.............%%
m %................................%%%.............%%%.....%%%%%%%.%%......%%............%%......%%.%%%%%%%.....%%%.............%%
m %%.%.%%%.%......%%......%.%%%.%.%%%%%%%%%%.%....%%%%%.%.%%%%%%%%%%%.....%%.....%%%%.....%%.....%%%%%%%%%%%.%.%%%%%....%.%%%%%%%%
m %%%%%%%%%%.....%%%%.....%%%%%%%%%%%%%%%%%%%..7..%%%%%%%%%%%%%%%%%%......%%......%%......%%......%%%%%%%%%%%%%%%%%%..4..%%%%%%%%%
m %%%%%%%%%%.....%%%%.....%%%%%%%%%%%%%%%%%%%......%%%%%%%%%%.%.%.%......%%%%.....%%.....%%%%......%.%.%.%%%%%%%%%%......%%%%%%%%%
m %%....%%%%..............%%%%....%%%..%..%..%....%%%%%%%%%%.............%%%%.....%%.....%%%%.............%%%%%%%%%%....%..%..%..%
m .......%%%..............%%%......................%%%%%%%%%%.............%%......%%......%%.............%%%%%%%%%%...............
m ......%%%%..............%%%%....................%%%%%%%%%%.............%%%%.....%%.....%%%%.............%%%%%%%%%%..............
m .......%%%..............%%%.....................%%%%%%%%%%%............%%%%.....%%.....%%%%............%%%%%%%%%%%..............
m .......%%................%%.....................%%%%%%%%%%%%%......%%.%%%%......%%......%%%%.%%......%%%%%%%%%%%%%..............
m .%%%%%%%%................%%%%%%%%.%.....%.%%%%.%%%%%%%%%%%%%%%%%%%%%%%%%%%%.....%%.....%%%%%%%%%%%%%%%%%%%%%%%%%%%%.%%%%.%.....%
m %%%%%%%%%%.....%%%%.....%%%%%%%%%%%%....%%%%%%%%%%%%%%%%%%%%%%%%%%%%%%%%%%......%%......%%%%%%%%%%%%%%%%%%%%%%%%%%%%%%%%%%....%%
m %%%%%%%%%.....%%%%%%.....%%%%%%%%%%%.....%%%%%%%%%%%%%.%.%%...%%%%%...%.%................%.%...%%%%%...%%.%.%%%%%%%%%%%%%.....%%
m ..%...%..%.....%%%%.....%..%...%..%%.....%%%%%%%%%%............................................................%%%%%%%%%%.....%%
m ...............%%%%.....................%%%%%%%%%%..............................................................%%%%%%%%%%......
m ...........2..%%%%%%..3.................%%%%%%%%%%%......1..............................................0......%%%%%%%%%%%......
m ...............%%%%.....................%%%%%%%%%%%............................................................%%%%%%%%%%%......
m ...............%%%%......................%%%%%%%%%%....%..%....%.%%%%%%%%......%%%%......%%%%%%%%.%....%..%....%%%%%%%%%%.......
m ......%..%.%..%%%%%%..%.%..%......%%%%.%%%%%%%%%%%%.....%%......%%%%%%%%%%%....%%%%....%%%%%%%%%%%......%%.....%%%%%%%%%%%%.%%%%
m %.....%%%%%%%%%%%%%%%%%%%%%%.....%%%%%%%%%%%%%%%%%......%%%....%%%%%%%%%%%.....%%%%.....%%%%%%%%%%%....%%%......%%%%%%%%%%%%%%%%
m %......%%%%%%%%%%%%%%%%%%%%......%%%%%%%%%%.%%%..%%....%%%%....%%%%.%%.%%%..............%%%.%%.%%%%....%%%%....%%..%%%.%%%%%%%%%
m %......%.%%...%%%%%%...%%.%......%%%%%%%%%%.............%%%........4..........................7........%%%.............%%%%%%%%%
m %%.............%%%%.............%%%%%%%%%%..............%%%............................................%%%..............%%%%%%%%
m %.............%%%%%%.............%%%%%%%%%%............%%%%............................................%%%%............%%%%%%%%%
m %..............%%%%..............%%%%%%%%%%.............%%%............................................%%%.............%%%%%%%%%
m %%.............%%%%.............%%%%%%%%%%%....%%%......%%%%%%%%.%.%..%.%%%............%%%.%..%.%.%%%%%%%%......%%%....%%%%%%%%%
m %%%%%...%%.....%%%%.....%%...%%%%%%%%%%%%%%....%%%%....%%%%%%%%%%%%%%%%%%%......%%......%%%%%%%%%%%%%%%%%%%....%%%%....%%%%%%%%%
