rows 108
cols 144
players 3
m ....%%%.....................%%..........%%...........%...........%....%%%.........%%....%%...........%%....%%................%%.................
m .....%%.....................%%...........%..........%%%.........%%.....%%....1.....%.....%%.........%%%...%%.................%..................
m %...%%%...%...%%.%.%....%....%%%%%.......%....%.%...%%%.%...%....%....%%%%%%%.%...%%%.%.%%..........%%%....%%%%%%.%..%.%%....%%...%...%...%...%%
m %...%%%...%%%%%%%%%%%%%%%...%%%%%%%%%....%%....%%...%%%%%%%%.....%%....%%%%%%%%....%%%%%%%.....%.....%%....%%%%%%%%%%%%%.....%%....%%%%%%%%....%
m .....%%...%%%.%%%%%..%%%%....%%.%%.......%%...%%%...%.%%%.%%%....%%...%%%%%%%%%...%%%%.%%%....%%%...%%%.....%.%.%.%.....%....%%....%%.....%...%%
m ..1.%%%....%.....%..........%%..........%%%....%...........%.............................%%...%%.........2..................%%....%%............
m ....%%%....%%...%%..........%%%.........%%....%%%..........%.............................%%....%%............................%%...%%............
m ....%%%...%%.....%%.........%%...........%%....%%..........%.............................%....%%%...........................%%%...%%%...........
m %....%%....%.....%....%.%...%%%%%.%%%....%%....%%...%%%...%%%..%..%%...%.......%%%.%....%%.....%%...%%.%.%.%%...%%%%..%.%%.%%%%....%%%%%%....%..
m %....%%...%%....%%%....%%....%%%%%%%....%%....%%%%%%%%.....%%%%%%%%%%%%%%....%%%%%%%%....%....%%.....%%%%%%%....%%%%%%%%%%%%%%....%%%%%%%%%%%%%%
m %....%%...%%%.....%....%%...%..%%.%.....%%%.....%%%.%%%...%%%..%.%%.%.%%....%..%..%%.....%%...%%....%%%%.%%.....%.%..%%.%.%%%%....%.%%%.%%%%.%%%
m %....%%....%.............................%..........%%.................%..........%%%.........%%.....%......................%%%.........%%%...%%
m %...%%%...%%............................%%..........%%.................%...........%%..........%.....%......................%%..........%%.....%
m %...%%%...%%.............................%...........%%...............%%...........%%..........%....%%......................%%..........%%....%%
m ....%%%....%%%%%.%.....%%...%.%....%%...%%%%%.%%%...%%%...%.%..%%%....%%%...%%%...%%%%%%%%%...%%....%%%%%%.%%...%......%....%%%%...%....%%%...%%
m .....%%....%%%%%%%%...%%%%%%%%....%%%....%%%%%%%%...%%%%%%%%%%%%%%....%%.....%%...%%%%%%%%%...%%.....%%%%%%%....%%%%%%%%%...%%%%%%%%....%%....%%
m .....%%...%..%.%%%%...%%%.%%.%....%%%...%.....%%%...%%%.%%%.%.%%%%%.....%...%%....%%.%.%%%....%%......%...%%....%%.%...%..1..%%.%%%......%%...%%
m ....%%..........%%%...%%%..........%%..........%%....%%..........%%.........%%..........%%%...%%%..........%%................%%.........%%......
m ....%%..........%%%...%%..........%%%.........%%....%%...........%..........%%...........%%...%%...........%%...............%%..........%%......
m ....%%%.........%%....%%%.........%%%..........%%...%%%..........%%.........%%...........%%....%...........%.................%..........%%......
m .%%%%%%..%%%....%%%.%%%%%.....%%%.%%%..%%.%...%%%....%......%....%....%%%...%%%....%.%%%%%%%%%%%%.%...%...%%....%.%...%...%%%%..........%%%....%
m %%%%%%%%%%%%%....%%%%%%%%...%%%%%%%%%%%%%%.....%%....%....%%.....%....%%%%%%%%.....%%%%%%%%%%%%%%%%%%%%...%%%...%%%...%%%%%%%%%....%%%%%%%.....%
m %.%%.%..%%%%%....%.%%%%%%...%%%%%.%%%%..%%.....%%....%%....%%....%%........%%%....%%.%%.%%%%..%%%.%.......%%%....%.....%%%.%.......%%%%..%%....%
m ...........%.................%%..........%.....%%....%%....%%...%%..........%%%..........%................%%%....%.....%...........%%.........%%
m %.........%%%................%%..........%....%%%...%%....%%....%%..........%%%.........%%%................%.....%%....%..........%%..........%%
m %..........%%...............%%...........%%....%.....%.....%....%%...........%%.........%%.................%....%%%....%%.........%%..........%%
m .....%%....%%.%..%%...%%%...%%....%%%%%%%%....%%%...%%%...%%....%%......%...%%%..%..%....%%...%.%%%%.%.....%%%.%%%%....%%.%.%%.....%...........%
m .....%....%%%%%%%%%...%%%...%%....%%%%%%%%%...%%%....%%....%....%%%....%....%%%%%%%%%....%....%%%%%%%%.....%%%%%%%.....%%%%%%%....%%....%%%...%%
m ....%%%...%.%%%..%%...%%%....%....%.%%%%%.....%%.....%%...%%....%%%...%%%...%.%%..%%%....%.....%%%.%%%%...%%%..%.%%....%%.%%%......%%...%%%...%%
m .....%%...............%%%...%%%...............%%%..........%%0...%%....%................%%%.........%%%..1............%%...........%%...%%%.....
m .....%................%%.....%.................%%..........%%...%%%....%%................%%.........%%%...............%%..........%%....%%......
m 1....%................%%%...%%%................%...........%.....%%....%................%%%..........%%...............%%..........%%....%%%.....
m .%.%%%%.%%...%..%%%...%%.....%%%.%%.%.....%..0%%%....%.....%%.%%%%%....%%..%.%%%%.%...%%%%%%...%%....%%.%%.%%%.%%%..%%%%%....%.....%%%%%%%%.....
m %%%%%%%%%%%%%%%%%%%...%%.....%%%%%%%....%%%%%%%%.....%.....%%%%%%%.....%%%%%%%%%%%%%%%%%%%%%%%%%%....%%%%%%%%%%%%%%%%%%%.....%....%%%%%%%%.....%
m %%%%%%%.%.%%.%..%%....%%....%.%..%%%.....%%%%........%.....%%.%..%.........%%%%.%..%...%%.%%%%%%.....%%%%%%%%...%%%%%.%%%...%%%....%%..%%%.....%
m .....%%.........%%....%%%.........%%.....%...........%.....%%................%......................%%%.....................%%..........%%%.....
m .....%...........%....%%%.........%%....%%...........%%....%%................%%.....................%%%.....................%%..........%%......
m ....%%%.........%%.....%%....2.....%.....%%.........%%%...%%.................%.......................%%.....................%%...........%......
m %...%%%.%...%....%....%%%%%%%.%...%%%.%.%%..........%%%....%%%%%%.%..%.%%....%%...%...%...%...%%%...%%%...%...%%.%.%....%....%%%%%.......%....%.
m %...%%%%%%%%.....%%....%%%%%%%%....%%%%%%%.....%.....%%....%%%%%%%%%%%%%.....%%....%%%%%%%%....%%...%%%...%%%%%%%%%%%%%%%...%%%%%%%%%....%%....%
m %...%.%%%.%%%....%%...%%%%%%%%%...%%%%.%%%....%%%...%%%.....%.%.%.%.....%....%%....%%.....%...%%.....%%...%%%.%%%%%..%%%%....%%.%%.......%%...%%
m ...........%.............................%%...%%.........0..................%%....%%..............2.%%%....%.....%..........%%..........%%%....%
m %..........%.............................%%....%%............................%%...%%................%%%....%%...%%..........%%%.........%%....%%
m %..........%.............................%....%%%...........................%%%...%%%...............%%%...%%.....%%.........%%...........%%....%
m %...%%%...%%%..%..%%...%.......%%%.%....%%.....%%...%%.%.%.%%...%%%%..%.%%.%%%%....%%%%%%....%..%....%%....%.....%....%.%...%%%%%.%%%....%%....%
m %%%%%%.....%%%%%%%%%%%%%%....%%%%%%%%....%....%%.....%%%%%%%....%%%%%%%%%%%%%%....%%%%%%%%%%%%%%%....%%...%%....%%%....%%....%%%%%%%....%%....%%
m %%%.%%%...%%%..%.%%.%.%%....%..%..%%.....%%...%%....%%%%.%%.....%.%..%%.%.%%%%....%.%%%.%%%%.%%%%....%%...%%%.....%....%%...%..%%.%.....%%%.....
m ....%%.................%..........%%%.........%%.....%......................%%%.........%%%...%%%....%%....%.............................%......
m ....%%.................%...........%%..........%.....%......................%%..........%%.....%%...%%%...%%............................%%......
m .....%%...............%%...........%%..........%....%%......................%%..........%%....%%%...%%%...%%.............................%......
m %...%%%...%.%..%%%....%%%...%%%...%%%%%%%%%...%%....%%%%%%.%%...%......%....%%%%...%....%%%...%%....%%%....%%%%%.%.....%%...%.%....%%...%%%%%.%%
m %...%%%%%%%%%%%%%%....%%.....%%...%%%%%%%%%...%%.....%%%%%%%....%%%%%%%%%...%%%%%%%%....%%....%%.....%%....%%%%%%%%...%%%%%%%%....%%%....%%%%%%%
m %...%%%.%%%.%.%%%%%.....%...%%....%%.%.%%%....%%......%...%%....%%.%...%..2..%%.%%%......%%...%%.....%%...%..%.%%%%...%%%.%%.%....%%%...%.....%%
m %....%%..........%%.........%%..........%%%...%%%..........%%................%%.........%%..........%%..........%%%...%%%..........%%..........%
m ....%%...........%..........%%...........%%...%%...........%%...............%%..........%%..........%%..........%%%...%%..........%%%.........%%
m %...%%%..........%%.........%%...........%%....%...........%.................%..........%%..........%%%.........%%....%%%.........%%%..........%
m %....%......%....%....%%%...%%%....%.%%%%%%%%%%%%.%...%...%%....%.%...%...%%%%..........%%%....%.%%%%%%..%%%....%%%.%%%%%.....%%%.%%%..%%.%...%%
m %....%....%%.....%....%%%%%%%%.....%%%%%%%%%%%%%%%%%%%%...%%%...%%%...%%%%%%%%%....%%%%%%%.....%%%%%%%%%%%%%%....%%%%%%%%...%%%%%%%%%%%%%%.....%
m %....%%....%%....%%........%%%....%%.%%.%%%%..%%%.%.......%%%....%.....%%%.%.......%%%%..%%....%%.%%.%..%%%%%....%.%%%%%%...%%%%%.%%%%..%%.....%
m %....%%....%%...%%..........%%%..........%................%%%....%.....%...........%%.........%%...........%.................%%..........%.....%
m %...%%....%%....%%..........%%%.........%%%................%.....%%....%..........%%..........%%%.........%%%................%%..........%....%%
m .....%.....%....%%...........%%.........%%.................%....%%%....%%.........%%..........%%%..........%%...............%%...........%%....%
m %...%%%...%%....%%......%...%%%..%..%....%%...%.%%%%.%.....%%%.%%%%....%%.%.%%.....%...........%.....%%....%%.%..%%...%%%...%%....%%%%%%%%....%%
m %....%%....%....%%%....%....%%%%%%%%%....%....%%%%%%%%.....%%%%%%%.....%%%%%%%....%%....%%%...%%.....%....%%%%%%%%%...%%%...%%....%%%%%%%%%...%%
m .....%%...%%....%%%...%%%...%.%%..%%%....%.....%%%.%%%%...%%%..%.%%....%%.%%%......%%...%%%...%%....%%%...%.%%%..%%...%%%....%....%.%%%%%.....%%
m %..........%%1...%%....%................%%%.........%%%..2............%%...........%%...%%%..........%%...............%%%...%%%...............%%
m %..........%%...%%%....%%................%%.........%%%...............%%..........%%....%%...........%................%%.....%.................%
m ...........%.....%%....%................%%%..........%%...............%%..........%%....%%%.....2....%................%%%...%%%................%
m %....%.....%%.%%%%%....%%..%.%%%%.%...%%%%%%...%%....%%.%%.%%%.%%%..%%%%%....%.....%%%%%%%%......%.%%%%.%%...%..%%%...%%.....%%%.%%.%.....%..1%%
m .....%.....%%%%%%%.....%%%%%%%%%%%%%%%%%%%%%%%%%%....%%%%%%%%%%%%%%%%%%%.....%....%%%%%%%%.....%%%%%%%%%%%%%%%%%%%%...%%.....%%%%%%%....%%%%%%%%
m .....%.....%%.%..%.........%%%%.%..%...%%.%%%%%%.....%%%%%%%%...%%%%%.%%%...%%%....%%..%%%.....%%%%%%%%.%.%%.%..%%....%%....%.%..%%%.....%%%%...
m .....%.....%%................%......................%%%.....................%%..........%%%..........%%.........%%....%%%.........%%.....%......
m .....%%....%%................%%.....................%%%.....................%%..........%%...........%...........%....%%%.........%%....%%......
m ....%%%...%%.................%.......................%%.....................%%...........%..........%%%.........%%.....%%....0.....%.....%%.....
m ....%%%....%%%%%%.%..%.%%....%%...%...%...%...%%%...%%%...%...%%.%.%....%....%%%%%.......%....%.%...%%%.%...%....%....%%%%%%%.%...%%%.%.%%......
m .....%%....%%%%%%%%%%%%%.....%%....%%%%%%%%....%%...%%%...%%%%%%%%%%%%%%%...%%%%%%%%%....%%....%%...%%%%%%%%.....%%....%%%%%%%%....%%%%%%%.....%
m %...%%%.....%.%.%.%.....%....%%....%%.....%...%%.....%%...%%%.%%%%%..%%%%....%%.%%.......%%...%%%...%.%%%.%%%....%%...%%%%%%%%%...%%%%.%%%....%%
m .........1..................%%....%%..............0.%%%....%.....%..........%%..........%%%....%...........%.............................%%...%%
m %............................%%...%%................%%%....%%...%%..........%%%.........%%....%%%..........%.............................%%....%
m %...........................%%%...%%%...............%%%...%%.....%%.........%%...........%%....%%..........%.............................%....%%
m %...%%.%.%.%%...%%%%..%.%%.%%%%....%%%%%%....%..%....%%....%.....%....%.%...%%%%%.%%%....%%....%%...%%%...%%%..%..%%...%.......%%%.%....%%.....%
m .....%%%%%%%....%%%%%%%%%%%%%%....%%%%%%%%%%%%%%%....%%...%%....%%%....%%....%%%%%%%....%%....%%%%%%%%.....%%%%%%%%%%%%%%....%%%%%%%%....%....%%
m ....%%%%.%%.....%.%..%%.%.%%%%....%.%%%.%%%%.%%%%....%%...%%%.....%....%%...%..%%.%.....%%%.....%%%.%%%...%%%..%.%%.%.%%....%..%..%%.....%%...%%
m .....%......................%%%.........%%%...%%%....%%....%.............................%..........%%.................%..........%%%.........%%
m .....%......................%%..........%%.....%%...%%%...%%............................%%..........%%.................%...........%%..........%
m ....%%......................%%..........%%....%%%...%%%...%%.............................%...........%%...............%%...........%%..........%
m ....%%%%%%.%%...%......%....%%%%...%....%%%...%%....%%%....%%%%%.%.....%%...%.%....%%...%%%%%.%%%...%%%...%.%..%%%....%%%...%%%...%%%%%%%%%...%%
m .....%%%%%%%....%%%%%%%%%...%%%%%%%%....%%....%%.....%%....%%%%%%%%...%%%%%%%%....%%%....%%%%%%%%...%%%%%%%%%%%%%%....%%.....%%...%%%%%%%%%...%%
m ......%...%%....%%.%...%..0..%%.%%%......%%...%%.....%%...%..%.%%%%...%%%.%%.%....%%%...%.....%%%...%%%.%%%.%.%%%%%.....%...%%....%%.%.%%%....%%
m %..........%%................%%.........%%..........%%..........%%%...%%%..........%%..........%%....%%..........%%.........%%..........%%%...%%
m ...........%%...............%%..........%%..........%%..........%%%...%%..........%%%.........%%....%%...........%..........%%...........%%...%%
m ...........%.................%..........%%..........%%%.........%%....%%%.........%%%..........%%...%%%..........%%.........%%...........%%....%
m %.%...%...%%....%.%...%...%%%%..........%%%....%.%%%%%%..%%%....%%%.%%%%%.....%%%.%%%..%%.%...%%%....%......%....%....%%%...%%%....%.%%%%%%%%%%%
m %%%%%%%...%%%...%%%...%%%%%%%%%....%%%%%%%.....%%%%%%%%%%%%%%....%%%%%%%%...%%%%%%%%%%%%%%.....%%....%....%%.....%....%%%%%%%%.....%%%%%%%%%%%%%
m %.%.......%%%....%.....%%%.%.......%%%%..%%....%%.%%.%..%%%%%....%.%%%%%%...%%%%%.%%%%..%%.....%%....%%....%%....%%........%%%....%%.%%.%%%%..%%
m ..........%%%....%.....%...........%%.........%%...........%.................%%..........%.....%%....%%....%%...%%..........%%%..........%......
m ...........%.....%%....%..........%%..........%%%.........%%%................%%..........%....%%%...%%....%%....%%..........%%%.........%%%.....
m ...........%....%%%....%%.........%%..........%%%..........%%...............%%...........%%....%.....%.....%....%%...........%%.........%%......
m %%%%.%.....%%%.%%%%....%%.%.%%.....%...........%.....%%....%%.%..%%...%%%...%%....%%%%%%%%....%%%...%%%...%%....%%......%...%%%..%..%....%%...%.
m %%%%%%.....%%%%%%%.....%%%%%%%....%%....%%%...%%.....%....%%%%%%%%%...%%%...%%....%%%%%%%%%...%%%....%%....%....%%%....%....%%%%%%%%%....%....%%
m %%.%%%%...%%%..%.%%....%%.%%%......%%...%%%...%%....%%%...%.%%%..%%...%%%....%....%.%%%%%.....%%.....%%...%%....%%%...%%%...%.%%..%%%....%.....%
m ....%%%..0............%%...........%%...%%%..........%%...............%%%...%%%...............%%%..........%%2...%%....%................%%%.....
m ....%%%...............%%..........%%....%%...........%................%%.....%.................%%..........%%...%%%....%%................%%.....
m .....%%...............%%..........%%....%%%.....0....%................%%%...%%%................%...........%.....%%....%................%%%.....
m %....%%.%%.%%%.%%%..%%%%%....%.....%%%%%%%%......%.%%%%.%%...%..%%%...%%.....%%%.%%.%.....%..2%%%....%.....%%.%%%%%....%%..%.%%%%.%...%%%%%%...%
m %....%%%%%%%%%%%%%%%%%%%.....%....%%%%%%%%.....%%%%%%%%%%%%%%%%%%%%...%%.....%%%%%%%....%%%%%%%%.....%.....%%%%%%%.....%%%%%%%%%%%%%%%%%%%%%%%%%
m .....%%%%%%%%...%%%%%.%%%...%%%....%%..%%%.....%%%%%%%%.%.%%.%..%%....%%....%.%..%%%.....%%%%........%.....%%.%..%.........%%%%.%..%...%%.%%%%%%
m ....%%%.....................%%..........%%%..........%%.........%%....%%%.........%%.....%...........%.....%%................%..................
