rows 112
cols 112
players 8
m %%%%.....%%%..........%%%.....%%%%%.%%%%%.%%%%%..%...%.%......%%%......%%%%......%%%......%.%...%..%%%%%.%%%%%.%
m %%%%.....%%%%........%%%%.....%%%%%%%%%%%%%%%%%%%%%%%%%%.....%%%%......%%%%......%%%%.....%%%%%%%%%%%%%%%%%%%%%%
m %%%%%.....%%..........%%.....%%%%%%%%%%%%%%%%%%%%%%%%%%%.....%%%%.....%%%%%%.....%%%%.....%%%%%%%%%%%%%%%%%%%%%%
m %%%.........%........%.........%%%....%.....%...%.%.%.%%%....%...%....%%%%%%....%...%....%%%.%.%.%...%.....%....
m .......................................0...............3..............%%%%%%..............2...............1.....
m .......................................................................%%%%.....................................
m .......................................................................%%%%.....................................
m .....................................................................%%%%%%%%...................................
m %..%.....%%%..........%%%.....%..%%%%.%%%%%%%%%......%%%........%%%..%%%%%%%%..%%%........%%%......%%%%%%%%%.%%%
m %%%%%.....%%..........%%.....%%%%%%%%%%%%%%%%%%%%%%%%%%%%.....%%%%%%%%%%%%%%%%%%%%%%.....%%%%%%%%%%%%%%%%%%%%%%%
m %%%%......%%..........%%......%%%%%%%%%%%%%%%%%%%%%%%%%%......%%%%%%%%%%%%%%%%%%%%%%......%%%%%%%%%%%%%%%%%%%%%%
m %%%%......%%..........%%......%%%%%%%%%%%%%%%%%%%%%%%%%%......%%%%%%%%%%%%%%%%%%%%%%......%%%%%%%%%%%%%%%%%%%%%%
m %%%%%.....%%..........%%.....%%%%%%%%%%%%%%%%%%%%%%%%%%%%.....%%%%%%%%%%%%%%%%%%%%%%.....%%%%%%%%%%%%%%%%%%%%%%%
m %..%.....%%%..........%%%.....%..%%%%.%%%%%%%%%......%%%........%%%..%%%%%%%%..%%%........%%%......%%%%%%%%%.%%%
m .....................................................................%%%%%%%%...................................
m .......................................................................%%%%.....................................
m .......................................................................%%%%.....................................
m .......................................2...............1..............%%%%%%..............0...............3.....
m %%%.........%........%.........%%%....%.....%...%.%.%.%%%....%...%....%%%%%%....%...%....%%%.%.%.%...%.....%....
m %%%%%.....%%..........%%.....%%%%%%%%%%%%%%%%%%%%%%%%%%%.....%%%%.....%%%%%%.....%%%%.....%%%%%%%%%%%%%%%%%%%%%%
m %%%%.....%%%%........%%%%.....%%%%%%%%%%%%%%%%%%%%%%%%%%.....%%%%......%%%%......%%%%.....%%%%%%%%%%%%%%%%%%%%%%
m %%%%.....%%%..........%%%.....%%%%%.%%%%%.%%%%%..%...%.%......%%%......%%%%......%%%......%.%...%..%%%%%.%%%%%.%
m ..........%1..........0%.............%%%%....................%.%%%..............%%%.%....................%%%%...
m ..........%%..........%%..............%%..................................................................%%....
m .........%%%%........%%%%.............%%%................................................................%%%....
m 5........%%%..........%%%........6...%%%..................................................................%%%...
m .%.......%%%%........%%%%.......%....%%%..........%%%..%%%..............................%%%..%%%..........%%%...
m ..%%%....%%%..........%%%....%%%......%%%....%%%3%%%%%%%%%.......%.....%..%.....%.......%%%%%%%%%2%%%....%%%....
m .%%%.....%%%..........%%%.....%%%.....%%%.....%%%%%%%%%%%%....%%%%7...%%%%%%...4%%%%....%%%%%%%%%%%%.....%%%....
m .%.%.....%%%%........%%%%.....%.%....%%.......%..%%%%%%%%......%%%....%%%%%%....%%%......%%%%%%%%..%.......%%...
m .........%%%..........%%%............................%%%%.....%%%.....%%%%%%.....%%%.....%%%%...................
m .........%%%%........%%%%.............................%%%%.....%%%.....%%%%.....%%%.....%%%%....................
m ..........%%%........%%%..............................%%%%.....%%......%%%%......%%.....%%%%....................
m ..........%%%........%%%..............................%%%%.....%%%.....%%%%.....%%%.....%%%%....................
m .%.......%%%%........%%%%.......%.%%..%%.....%%%.%....%%%.....%%%......%%%%......%%%.....%%%....%.%%%.....%%..%%
m %%%%%....%%%..........%%%....%%%%%%2%%%%%....%%%%......%4......%%%.....%%%%.....%%%......7%......%%%%....%%%%%3%
m %%%%%.....%%..........%%.....%%%%%%%%%%%%....%%%%%.....%%......%%......%%%%......%%......%%.....%%%%%....%%%%%%%
m %%%%......5%%........%%6......%%%%%..%.%%.....%%%%....%%%.....%%%.....%%%%%%.....%%%.....%%%....%%%%.....%%.%..%
m .%%%.....%%%%........%%%%.....%%%............%.%%%......%.....%%%.....%%%%%%.....%%%.....%......%%%.%...........
m .%%%.....%%%..........%%%.....%%%.............................%%%%....%%%%%%....%%%%............................
m ..%%......%%..........%%......%%..............................%%%.....%%%%%%.....%%%............................
m .%%%.....%%%..........%%%.....%%%.............................%%%.....%%%%%%.....%%%............................
m .%%%......%%..........%%......%%%....%%%.%.....................%%.....%%%%%%.....%%.....................%.%%%...
m ..%%%.....%%%........%%%.....%%%......%%%.....%%%......%%..%.%%%%.....%%%%%%.....%%%%.%..%%......%%%.....%%%....
m .%%%.....%%%%........%%%%.....%%%....%%%%%....%%%%.....%%%%%%%%%%.6...%%%%%%...5.%%%%%%%%%%.....%%%%....%%%%%...
m .%%%%....%.%%........%%.%....%%%%.....%%%%.....%%%....%%%%%%%%%%%%....%%%%%%....%%%%%%%%%%%%....%%%.....%%%%....
m ..%%%........................%%%.....%.%.%....%%%.....%..%%..%%%%......%%%%......%%%%..%%..%.....%%%....%.%.%...
m ........3................2.....................%%.............%%%.....%%%%%%.....%%%.............%%.............
m ...............................................%6%.............%%.....%%%%%%.....%%.............%5%.............
m ..............................................%%%%............%%%.....%%%%%%.....%%%............%%%%............
m ................%%............................%%%.........2...%%%%....%%%%%%....%%%%...3.........%%%............
m ....%%..%%.%....%%....%.%%..%%........%%.%%.%%%%%%....%%.%....%%%%.....%%%%.....%%%%....%.%%....%%%%%%.%%.%%....
m ..%%%%%%%%%%....%%....%%%%%%%%%%.....%%%%%%%%%%%%......%%.....%%%%.....%%%%.....%%%%.....%%......%%%%%%%%%%%%...
m ..%%%...%%%.....%%.....%%%...%%%.....%%%%%%%%%%%%.....%%%.....%%%.....%%%%%%.....%%%.....%%%.....%%%%%%%%%%%%...
m .%%%..........................%%%....%%.%......%%.......%.......%......%..%......%.......%.......%%......%.%%...
m .%%............................%%...............................................................................
m ..%............................%................................................................................
m ..%............................%................................................................................
m .%%%..........................%%%...6........................................................................5..
m .%%%......%............%......%%%.....%%..%.%%..%%..%%%%%%%%..%%......%....%......%%..%%%%%%%%..%%..%%.%..%%....
m ..%%.....%%............%%.....%%.......%%%%%%%2%%%%%%%%%%%%%%%%%%.....%%%%%%.....%%%%%%%%%%%%%%%%%%3%%%%%%%.....
m .%%............................%%.....%%%%%%%%%%%%%%%%%%%%%%%5%%%.....%%%%%%.....%%%6%%%%%%%%%%%%%%%%%%%%%%%....
m ......................................%%%....%%..%%%%.%..%.%...%.%..............%.%...%.%..%.%%%%..%%....%%%....
m ................................................................................................................
m ................................................................................................................
m ................................................................................................................
m %%%%............%%............%%%%..............................................................................
m %%%%............%%............%%%%..............................................................................
m ................................................................................................................
m ................................................................................................................
m ................................................................................................................
m ......................................%%%....%%..%%%%.%..%.%...%.%..............%.%...%.%..%.%%%%..%%....%%%....
m .%%............................%%.....%%%%%%%%%%%%%%%%%%%%%%%7%%%.....%%%%%%.....%%%4%%%%%%%%%%%%%%%%%%%%%%%....
m ..%%.....%%............%%.....%%.......%%%%%%%0%%%%%%%%%%%%%%%%%%.....%%%%%%.....%%%%%%%%%%%%%%%%%%1%%%%%%%.....
m .%%%......%............%......%%%.....%%..%.%%..%%..%%%%%%%%..%%......%....%......%%..%%%%%%%%..%%..%%.%..%%....
m .%%%..........................%%%...4........................................................................7..
m ..%............................%................................................................................
m ..%............................%................................................................................
m .%%............................%%...............................................................................
m .%%%..........................%%%....%%.%......%%.......%.......%......%..%......%.......%.......%%......%.%%...
m ..%%%...%%%.....%%.....%%%...%%%.....%%%%%%%%%%%%.....%%%.....%%%.....%%%%%%.....%%%.....%%%.....%%%%%%%%%%%%...
m ..%%%%%%%%%%....%%....%%%%%%%%%%.....%%%%%%%%%%%%......%%.....%%%%.....%%%%.....%%%%.....%%......%%%%%%%%%%%%...
m ....%%..%%.%....%%....%.%%..%%........%%.%%.%%%%%%....%%.%....%%%%.....%%%%.....%%%%....%.%%....%%%%%%.%%.%%....
m ................%%............................%%%.........0...%%%%....%%%%%%....%%%%...1.........%%%............
m ..............................................%%%%............%%%.....%%%%%%.....%%%............%%%%............
m ...............................................%4%.............%%.....%%%%%%.....%%.............%7%.............
m ........1................0.....................%%.............%%%.....%%%%%%.....%%%.............%%.............
m ..%%%........................%%%.....%.%.%....%%%.....%..%%..%%%%......%%%%......%%%%..%%..%.....%%%....%.%.%...
m .%%%%....%.%%........%%.%....%%%%.....%%%%.....%%%....%%%%%%%%%%%%....%%%%%%....%%%%%%%%%%%%....%%%.....%%%%....
m .%%%.....%%%%........%%%%.....%%%....%%%%%....%%%%.....%%%%%%%%%%.4...%%%%%%...7.%%%%%%%%%%.....%%%%....%%%%%...
m ..%%%.....%%%........%%%.....%%%......%%%.....%%%......%%..%.%%%%.....%%%%%%.....%%%%.%..%%......%%%.....%%%....
m .%%%......%%..........%%......%%%....%%%.%.....................%%.....%%%%%%.....%%.....................%.%%%...
m .%%%.....%%%..........%%%.....%%%.............................%%%.....%%%%%%.....%%%............................
m ..%%......%%..........%%......%%..............................%%%.....%%%%%%.....%%%............................
m .%%%.....%%%..........%%%.....%%%.............................%%%%....%%%%%%....%%%%............................
m .%%%.....%%%%........%%%%.....%%%............%.%%%......%.....%%%.....%%%%%%.....%%%.....%......%%%.%...........
m %%%%......7%%........%%4......%%%%%..%.%%.....%%%%....%%%.....%%%.....%%%%%%.....%%%.....%%%....%%%%.....%%.%..%
m %%%%%.....%%..........%%.....%%%%%%%%%%%%....%%%%%.....%%......%%......%%%%......%%......%%.....%%%%%....%%%%%%%
m %%%%%....%%%..........%%%....%%%%%%0%%%%%....%%%%......%6......%%%.....%%%%.....%%%......5%......%%%%....%%%%%1%
m .%.......%%%%........%%%%.......%.%%..%%.....%%%.%....%%%.....%%%......%%%%......%%%.....%%%....%.%%%.....%%..%%
m ..........%%%........%%%..............................%%%%.....%%%.....%%%%.....%%%.....%%%%....................
m ..........%%%........%%%..............................%%%%.....%%......%%%%......%%.....%%%%....................
m .........%%%%........%%%%.............................%%%%.....%%%.....%%%%.....%%%.....%%%%....................
m .........%%%..........%%%............................%%%%.....%%%.....%%%%%%.....%%%.....%%%%...................
m .%.%.....%%%%........%%%%.....%.%....%%.......%..%%%%%%%%......%%%....%%%%%%....%%%......%%%%%%%%..%.......%%...
m .%%%.....%%%..........%%%.....%%%.....%%%.....%%%%%%%%%%%%....%%%%5...%%%%%%...6%%%%....%%%%%%%%%%%%.....%%%....
m ..%%%....%%%..........%%%....%%%......%%%....%%%1%%%%%%%%%.......%.....%..%.....%.......%%%%%%%%%0%%%....%%%....
m .%.......%%%%........%%%%.......%....%%%..........%%%..%%%..............................%%%..%%%..........%%%...
m 7........%%%..........%%%........4...%%%..................................................................%%%...
m .........%%%%........%%%%.............%%%................................................................%%%....
m ..........%%..........%%..............%%..................................................................%%....
m ..........%3..........2%.............%%%%....................%.%%%..............%%%.%....................%%%%...
