rows 64
cols 80
players 2
m .........................%%%..............%%.....................%%%%...........
m %.%...%%%%%.%%%....%%....%%%%.........%.%%%%.....%%%..%%%%%%.....%%%%....%%.%..%
m %%%%%%%%%%%%%%%%%%%%%....%%%%.....%%%%%%%%%%%.....%%%%%%%%%%%.....%%%.....%%%%%%
m %%%%%%%%%%%%%%%%%%%%.....%%%%....%%%%%%%%%%%%....%%%%%%%%%%%......%%%.....%%%%%%
m .%..%.%%%..%%..%%.%%%.....%%.....%.%...%.%..%........%.%.%%%.....%.%.....%%.%..%
m ..........................%%..............................%%....................
m ..........................%%%............................%%%%...................
m ..........................%%%............................%%%%...................
m ..........................%%..............................%%....................
m .%..%.%%%..%%..%%.%%%.....%%.....%.%...%.%..%........%.%.%%%.....%.%.....%%.%..%
m %%%%%%%%%%%%%%%%%%%%.....%%%%....%%%%%%%%%%%%....%%%%%%%%%%%......%%%.....%%%%%%
m %%%%%%%%%%%%%%%%%%%%%....%%%%.....%%%%%%%%%%%.....%%%%%%%%%%%.....%%%.....%%%%%%
m %.%...%%%%%.%%%....%%....%%%%.........%.%%%%.....%%%..%%%%%%.....%%%%....%%.%..%
m .........................%%%..............%%.....................%%%%...........
m .........................%%%%.............%%%.....................%%............
m .........................%%%.............%%%%.....................%%%...........
m .........................%%%..............%%%....................%%%%...........
m ....%...%.%...%%%.%%.%%.%%%%.....%..%..%.%%%%%%.%.%%.%%%%%.......%%%.....%%%%.%%
m %%%%%%%%%%%%%%%%%%%%%%%%%%%%......%%%%%%%%%%%%%%%%%%%%%%%%%%%....%%%.....%%%%%%%
m %%%%%%%%%%%%%%%%%%%%%%%%%%%%%....%%%%%%%%%%%%%%%%%%%%%%%%%%%%....%%%%.....%%%%%%
m .%%.%%%%%%%..%%..%%%%.%%.%.%......%%%.%%.%%%.....%.%.%.%%%%%%.....%%%......%%%..
m .................%%%.............%%%..............................%%%...........
m ..................%%%............%%%%............................%%%............
m ..................%%..............%%..............................%%%...........
m .............1....%%.............%%%..............................%%%...........
m .%.........%.....%%%%.....%.%.....%%%.....%%%.%..%%..%.%...%......%%%...........
m ..%%.....%%%%%%%%%%%.....%%%.....%%%......%%%%%%%%%%%%%%%%%%%.....%%%.....%%....
m .%%%%.....%%%%%%%%%%......%%%.....%%.....%%%%%%%%%%%%%%%%%%%.....%%%%....%%%....
m .........%%%%%.%%..%.....%%......%%%.....%.%.....%%%%%.%..%.......%%%.....%%%...
m ..........%%......................%%.............%%%%............%%%%....%%%%...
m ..........%%%....................%%%.............%%%%............%%%%.....%%....
m ..........%%......................%%%............%%%.............%%%%....%%%%...
m .........%%%%.....................%%%............%%%.............%%%......%%%...
m ..%.......%%%.%.....%%.%.%%%%%%%.%%%%.%%.%.%.....%%%%......%%%...%%%%%%.%%%%%...
m ..%%%....%%%%%%%%%%%%%%%%%%%%%%%%%%%%%%%%%%%%....%%%.....%%%%%%%%%%%%%%%%%%%....
m .%%%%.....%%%%%%%%%%%%%%%%%%%%%%%%%%%%%%%%%%%.....%%......%%%%%%%%%%%%%%%%%%%...
m ..%%%....%%%%...%%%%.%...%%%%...%.%...%.....%.....%%%....%.%.......%..%..%%.%...
m ..%%..............................................%%............................
m ..%%%.............................................%%............................
m ..%%%.............................................%%............................
m ..%%..............................................%%............................
m ..%%%....%%%%...%%%%.%...%%%%...%.%...%.....%.....%%%....%.%.......%..%..%%.%...
m .%%%%.....%%%%%%%%%%%%%%%%%%%%%%%%%%%%%%%%%%%.....%%......%%%%%%%%%%%%%%%%%%%...
m ..%%%....%%%%%%%%%%%%%%%%%%%%%%%%%%%%%%%%%%%%....%%%.....%%%%%%%%%%%%%%%%%%%....
m ..%.......%%%.%.....%%.%.%%%%%%%.%%%%.%%.%.%.....%%%%......%%%...%%%%%%.%%%%%...
m .........%%%%.....................%%%............%%%.............%%%......%%%...
m ..........%%......................%%%............%%%.............%%%%....%%%%...
m ..........%%%....................%%%.............%%%%............%%%%.....%%....
m ..........%%......................%%.............%%%%............%%%%....%%%%...
m .........%%%%%.%%..%.....%%......%%%.....%.%.....%%%%%.%..%.......%%%.....%%%...
m .%%%%.....%%%%%%%%%%......%%%.....%%.....%%%%%%%%%%%%%%%%%%%.....%%%%....%%%....
m ..%%.....%%%%%%%%%%%.....%%%.....%%%......%%%%%%%%%%%%%%%%%%%.....%%%.....%%....
m .%.........%.....%%%%.....%.%.....%%%.....%%%.%..%%..%.%...%......%%%...........
m .............0....%%.............%%%..............................%%%...........
m ..................%%..............%%..............................%%%...........
m ..................%%%............%%%%............................%%%............
m .................%%%.............%%%..............................%%%...........
m .%%.%%%%%%%..%%..%%%%.%%.%.%......%%%.%%.%%%.....%.%.%.%%%%%%.....%%%......%%%..
m %%%%%%%%%%%%%%%%%%%%%%%%%%%%%....%%%%%%%%%%%%%%%%%%%%%%%%%%%%....%%%%.....%%%%%%
m %%%%%%%%%%%%%%%%%%%%%%%%%%%%......%%%%%%%%%%%%%%%%%%%%%%%%%%%....%%%.....%%%%%%%
m ....%...%.%...%%%.%%.%%.%%%%.....%..%..%.%%%%%%.%.%%.%%%%%.......%%%.....%%%%.%%
m .........................%%%..............%%%....................%%%%...........
m .........................%%%.............%%%%.....................%%%...........
m .........................%%%%.............%%%.....................%%............
