rows 96
cols 96
players 8
m .........................%%%%%%..........%%%%%%....................................%%...........
m .........................%%%%%%..........%%%%%%.................................................
m ...%.......%%.......%....%%%%%%..........%%%%%%....%.......%%.......%......%.%.....%%.....%.%...
m ..%%.....%%%%....%%%.....%%%%%%%........%%%%%%%.....%%%....%%%%.....%%......%%%....%%....%%%....
m .%%%......%%.....%%%.....%%%%%%%........%%%%%%%.....%%%.....%%......%%%.....%%%....%%....%%%....
m .%.%........%.....%%.........%%%........%%%.........%%.....%........%.%....%..%..........%..%...
m ...................................................................................%%...........
m .................................%%%%%%.........................................................
m .................................%%%%%%.........................................................
m .................................%%%%%%............................................%%...........
m .................................%%%%%%............................................%%...........
m .................................%%%%%%.........................................................
m .................................%%%%%%.........................................................
m ...................................................................................%%...........
m .%.%........%.....%%.........%%%........%%%.........%%.....%........%.%....%..%..........%..%...
m .%%%......%%.....%%%.....%%%%%%%........%%%%%%%.....%%%.....%%......%%%.....%%%....%%....%%%....
m ..%%.....%%%%....%%%.....%%%%%%%........%%%%%%%.....%%%....%%%%.....%%......%%%....%%....%%%....
m ...%.......%%.......%....%%%%%%..........%%%%%%....%.......%%.......%......%.%.....%%.....%.%...
m .........................%%%%%%..........%%%%%%.................................................
m .........................%%%%%%..........%%%%%%....................................%%...........
m .........................%%%%%%..........%%%%%%.................................................
m ................3......................................2...........................%%...........
m ..%%........%......%.%%%........................%%%.%......%........%%.......%%....%%....%%.....
m ..%%.....%%%%....%%%%%%%........................%%%%%%%....%%%%.....%%.....%%%.....%%.....%%%...
m ..%%..5...%%%....%%%%%%%........................%%%%%%%....%%%...6..%%.....%%%%..........%%%%...
m .%%%%....%%%......%%%%%.....%..............%.....%%%%%......%%%....%%%%....%................%...
m .................%%%%%%%.....%%%........%%%.....%%%%%%%.........................................
m .................%%%%%%......%%%........%%%......%%%%%%.....................2..............3....
m .................%%%.%%......%%..........%%......%%.%%%.........................................
m ........................4......................7................................................
m ..%.%......%.%%%........................................%%%.%......%.%.......%%..........%%.....
m ..%%%....%%%%%%%........................................%%%%%%%....%%%.....%%%............%%%...
m ..%%......%%%%%%........................................%%%%%%......%%.....%%%%..........%%%%...
m ...%.....%%%%%%......%%%....%%.%........%.%%....%%%......%%%%%%.....%......%%%%....%%....%%%%...
m .........%%%%%%%....%%%.....%%%..........%%%.....%%%....%%%%%%%.................................
m .........%%%%%%.....%%%......%%..........%%......%%%.....%%%%%%.................................
m .........%%%%.%.....%.%......%............%......%.%.....%.%%%%.................................
m ................................................................................................
m .%%%%%%%........................................................%%%%%%%.....%%%..........%%%....
m .%%%%%%%.............0............................1.............%%%%%%%....%%%5..........6%%%...
m .%%%%%%%........................................................%%%%%%%.....%%.....%%.....%%....
m .%%%%%%%......%%....%..............................%....%%......%%%%%%%....%.%%..........%%.%...
m .%%%%%%%....%%%.....%%%%....%%%%........%%%%....%%%%.....%%%....%%%%%%%.........................
m .%%%%%%%.....%%%....%%%%.....%%..........%%.....%%%%....%%%.....%%%%%%%.........................
m .%%%%%%%............%.........%%........%%.........%............%%%%%%%.........................
m ................................................................................................
m ........................................................................%%%..................%%%
m ........................................................................%%%%%%.....%%.....%%%%%%
m ........................................................................%%%%%%.....%%.....%%%%%%
m ....%.%.....%%%.....%%%.....%..%........%..%.....%%%.....%%%.....%.%.....%%%%%............%%%%%.
m .....%%%....%%%...4..%%......%%..........%%......%%..7...%%%....%%%......%%%%%%..........%%%%%%.
m ....%%%%....%%%%.....%%%....%%%..........%%%....%%%.....%%%%....%%%%.....%%%%%%..........%%%%%%.
m ....%.2%....%%.%.....%.%.....%%%........%%%.....%.%.....%.%%....%3.%........%%%..........%%%....
m ................................................................................................
m ................................................................................%%.%%.%%........
m ................................................................................%%%%%%%%........
m .................................................................................%%%%%%.........
m .....%......%.........%%%.%.%%%.%..%%..%.%%%.%.%%%.........%......%......%%.....%%%%%%%%.....%%.
m .....%......%.........%%%.%.%%%.%..%%..%.%%%.%.%%%.........%......%......%%.....%%%%%%%%.....%%.
m .................................................................................%%%%%%.........
m ................................................................................%%%%%%%%........
m ................................................................................%%.%%.%%........
m ................................................................................................
m ....%.0%....%%.%.....%.%.....%%%........%%%.....%.%.....%.%%....%1.%........%%%..........%%%....
m ....%%%%....%%%%.....%%%....%%%..........%%%....%%%.....%%%%....%%%%.....%%%%%%..........%%%%%%.
m .....%%%....%%%...6..%%......%%..........%%......%%..5...%%%....%%%......%%%%%%..........%%%%%%.
m ....%.%.....%%%.....%%%.....%..%........%..%.....%%%.....%%%.....%.%.....%%%%%............%%%%%.
m ........................................................................%%%%%%.....%%.....%%%%%%
m ........................................................................%%%%%%.....%%.....%%%%%%
m ........................................................................%%%..................%%%
m ................................................................................................
m .%%%%%%%............%.........%%........%%.........%............%%%%%%%.........................
m .%%%%%%%.....%%%....%%%%.....%%..........%%.....%%%%....%%%.....%%%%%%%.........................
m .%%%%%%%....%%%.....%%%%....%%%%........%%%%....%%%%.....%%%....%%%%%%%.........................
m .%%%%%%%......%%....%..............................%....%%......%%%%%%%....%.%%..........%%.%...
m .%%%%%%%........................................................%%%%%%%.....%%.....%%.....%%....
m .%%%%%%%.............2............................3.............%%%%%%%....%%%7..........4%%%...
m .%%%%%%%........................................................%%%%%%%.....%%%..........%%%....
m ................................................................................................
m .........%%%%.%.....%.%......%............%......%.%.....%.%%%%.................................
m .........%%%%%%.....%%%......%%..........%%......%%%.....%%%%%%.................................
m .........%%%%%%%....%%%.....%%%..........%%%.....%%%....%%%%%%%.................................
m ...%.....%%%%%%......%%%....%%.%........%.%%....%%%......%%%%%%.....%......%%%%....%%....%%%%...
m ..%%......%%%%%%........................................%%%%%%......%%.....%%%%..........%%%%...
m ..%%%....%%%%%%%........................................%%%%%%%....%%%.....%%%............%%%...
m ..%.%......%.%%%........................................%%%.%......%.%.......%%..........%%.....
m ........................6......................5................................................
m .................%%%.%%......%%..........%%......%%.%%%.........................................
m .................%%%%%%......%%%........%%%......%%%%%%.....................0..............1....
m .................%%%%%%%.....%%%........%%%.....%%%%%%%.........................................
m .%%%%....%%%......%%%%%.....%..............%.....%%%%%......%%%....%%%%....%................%...
m ..%%..7...%%%....%%%%%%%........................%%%%%%%....%%%...4..%%.....%%%%..........%%%%...
m ..%%.....%%%%....%%%%%%%........................%%%%%%%....%%%%.....%%.....%%%.....%%.....%%%...
m ..%%........%......%.%%%........................%%%.%......%........%%.......%%....%%....%%.....
m ................1......................................0...........................%%...........
m .........................%%%%%%..........%%%%%%.................................................
