rows 84
cols 126
players 7
m ...%%....%%......................%%...%%......................%%.....%................%%%...%%.......................%%.......
m ...%%...%%%...%%%....%%......%%.%%%....%%....%.%..%%%%%..%....%%....%%....%...%%%%%...%%.....%%................%%%.%%%%.%%%.%.
m ..%%%...%%....%%%...%%%....%%%%%%%....%%.....%%%%%%%%%%%%%%...%%....%%....%%%%%%%%%....%.....%%%%%%%.....%%...%%%%%%%%%%%%%%%.
m ..%%.....%%...%%%.....%....%%%%%%%.....%%.....%%..%%%%..%.....%%.....%%....%%..%..%....%....%%%%.........%....%...%%%.%.%%%...
m ..%%%..........%......................%%...........%..........%%%.........%%%..........%%...%%%...............................
m ..%%%.........%%.......................%...........%%.........%%%..........%..........%%%...%%%...............................
m ...%%..........%......................%%%.........%%%.........%%%.........%%...........%%....%................................
m %.%%%...%.%%%.%%%%.%%...%.%%%...%.%%.%%%%....%%%%%%%....%.6....%%%%%%.%.%%%%.....%...%%%%....%%.....%...%...%%%..%4...%......%
m %%%%%....%%%%%%%%%%%%%%%%%%%....%%%%%%%%%...%%%%%%%%.....%%...%%%%%%%%%%%%%1....%%%%%%%%3....%.....%%...%%%%%%%%%%%%%%%...%%%%
m %%%%.....%%%.%%%.%..%...%%%%%....%%.%%......%..%.%%%.....%%...%.%.%%%%%.%..%%...%%%%..%%%...%%%....%%...1%%%%%%%%%%%......%%%%
m 3.%%......................%%....%%.............3...%%....%%.....................%%%..........%%....%%......................%%.
m ...%......................%%....%5%................%.....%.......................%%..........%%....%%.....................%%%.
m ..%%......................%%.....%................%%%...%%.......................%%..........%%....%%......................%%.
m ...%%....%.%..%%%%%..%....%%....%%....%...%%%%%...%%.....%%................%%%.%%%%.%%%.%....%%...%%%...%%%....%%......%%.%%%.
m ..%%.....%%%%%%%%%%%%%%...%%....%%....%%%%%%%%%....%.....%%%%%%%.....%%...%%%%%%%%%%%%%%%...%%%...%%....%%%...%%%....%%%%%%%..
m ...%%.....%%..%%%%..%.....%%.....%%....%%..%..%....%....%%%%.........%....%...%%%.%.%%%.....%%.....%%...%%%.....%....%%%%%%%..
m ..%%...........%..........%%%.........%%%..........%%...%%%.................................%%%..........%....................
m ...%...........%%.........%%%..........%..........%%%...%%%.................................%%%.........%%....................
m ..%%%.........%%%.........%%%.........%%...........%%....%...................................%%..........%....................
m .%%%%....%%%%%%%....%.3....%%%%%%.%.%%%%.....%...%%%%....%%.....%...%...%%%..%1...%......%%.%%%...%.%%%.%%%%.%%...%.%%%...%.%%
m %%%%%...%%%%%%%%.....%%...%%%%%%%%%%%%%5....%%%%%%%%0....%.....%%...%%%%%%%%%%%%%%%...%%%%%%%%%....%%%%%%%%%%%%%%%%%%%....%%%%
m %%......%..%.%%%.....%%...%.%.%%%%%.%..%%...%%%%..%%%...%%%....%%...5%%%%%%%%%%%......%%%%%%%%.....%%%.%%%.%..%...%%%%%....%%.
m ...........0...%%....%%.....................%%%..........%%....%%......................%%.0.%%......................%%....%%..
m ...............%.....%.......................%%..........%%....%%.....................%%%....%......................%%....%2%.
m ..............%%%...%%.......................%%..........%%....%%......................%%...%%......................%%.....%..
m ..%...%%%%%...%%.....%%................%%%.%%%%.%%%.%....%%...%%%...%%%....%%......%%.%%%....%%....%.%..%%%%%..%....%%....%%..
m ..%%%%%%%%%....%.....%%%%%%%.....%%...%%%%%%%%%%%%%%%...%%%...%%....%%%...%%%....%%%%%%%....%%.....%%%%%%%%%%%%%%...%%....%%..
m ...%%..%..%....%....%%%%.........%....%...%%%.%.%%%.....%%.....%%...%%%.....%....%%%%%%%.....%%.....%%..%%%%..%.....%%.....%%.
m ..%%%..........%%...%%%.................................%%%..........%......................%%...........%..........%%%.......
m ...%..........%%%...%%%.................................%%%.........%%.......................%...........%%.........%%%.......
m ..%%...........%%....%...................................%%..........%......................%%%.........%%%.........%%%.......
m %%%%.....%...%%%%....%%.....%...%...%%%..%5...%......%%.%%%...%.%%%.%%%%.%%...%.%%%...%.%%.%%%%....%%%%%%%....%.0....%%%%%%.%.
m %%%2....%%%%%%%%4....%.....%%...%%%%%%%%%%%%%%%...%%%%%%%%%....%%%%%%%%%%%%%%%%%%%....%%%%%%%%%...%%%%%%%%.....%%...%%%%%%%%%%
m %..%%...%%%%..%%%...%%%....%%...2%%%%%%%%%%%......%%%%%%%%.....%%%.%%%.%..%...%%%%%....%%.%%......%..%.%%%.....%%...%.%.%%%%%.
m ........%%%..........%%....%%......................%%.4.%%......................%%....%%.............4...%%....%%.............
m .........%%..........%%....%%.....................%%%....%......................%%....%6%................%.....%..............
m .........%%..........%%....%%......................%%...%%......................%%.....%................%%%...%%..............
m ...%%%.%%%%.%%%.%....%%...%%%...%%%....%%......%%.%%%....%%....%.%..%%%%%..%....%%....%%....%...%%%%%...%%.....%%.............
m ..%%%%%%%%%%%%%%%...%%%...%%....%%%...%%%....%%%%%%%....%%.....%%%%%%%%%%%%%%...%%....%%....%%%%%%%%%....%.....%%%%%%%.....%%.
m ..%...%%%.%.%%%.....%%.....%%...%%%.....%....%%%%%%%.....%%.....%%..%%%%..%.....%%.....%%....%%..%..%....%....%%%%.........%..
m ....................%%%..........%......................%%...........%..........%%%.........%%%..........%%...%%%.............
m ....................%%%.........%%.......................%...........%%.........%%%..........%..........%%%...%%%.............
m .....................%%..........%......................%%%.........%%%.........%%%.........%%...........%%....%..............
m %%%..%2...%......%%.%%%...%.%%%.%%%%.%%...%.%%%...%.%%.%%%%....%%%%%%%....%.4....%%%%%%.%.%%%%.....%...%%%%....%%.....%...%...
m %%%%%%%%%%%...%%%%%%%%%....%%%%%%%%%%%%%%%%%%%....%%%%%%%%%...%%%%%%%%.....%%...%%%%%%%%%%%%%6....%%%%%%%%1....%.....%%...%%%%
m %%%%%%%%......%%%%%%%%.....%%%.%%%.%..%...%%%%%....%%.%%......%..%.%%%.....%%...%.%.%%%%%.%..%%...%%%%..%%%...%%%....%%...6%%%
m ...............%%.1.%%......................%%....%%.............1...%%....%%.....................%%%..........%%....%%.......
m ..............%%%....%......................%%....%3%................%.....%.......................%%..........%%....%%.......
m ...............%%...%%......................%%.....%................%%%...%%.......................%%..........%%....%%.......
m ...%%......%%.%%%....%%....%.%..%%%%%..%....%%....%%....%...%%%%%...%%.....%%................%%%.%%%%.%%%.%....%%...%%%...%%%.
m ..%%%....%%%%%%%....%%.....%%%%%%%%%%%%%%...%%....%%....%%%%%%%%%....%.....%%%%%%%.....%%...%%%%%%%%%%%%%%%...%%%...%%....%%%.
m ....%....%%%%%%%.....%%.....%%..%%%%..%.....%%.....%%....%%..%..%....%....%%%%.........%....%...%%%.%.%%%.....%%.....%%...%%%.
m ....................%%...........%..........%%%.........%%%..........%%...%%%.................................%%%..........%..
m .....................%...........%%.........%%%..........%..........%%%...%%%.................................%%%.........%%..
m ....................%%%.........%%%.........%%%.........%%...........%%....%...................................%%..........%..
m .%%...%.%%%...%.%%.%%%%....%%%%%%%....%.1....%%%%%%.%.%%%%.....%...%%%%....%%.....%...%...%%%..%6...%......%%.%%%...%.%%%.%%%%
m %%%%%%%%%%....%%%%%%%%%...%%%%%%%%.....%%...%%%%%%%%%%%%%3....%%%%%%%%5....%.....%%...%%%%%%%%%%%%%%%...%%%%%%%%%....%%%%%%%%%
m ..%...%%%%%....%%.%%......%..%.%%%.....%%...%.%.%%%%%.%..%%...%%%%..%%%...%%%....%%...3%%%%%%%%%%%......%%%%%%%%.....%%%.%%%.%
m ........%%....%%.............5...%%....%%.....................%%%..........%%....%%......................%%.5.%%..............
m ........%%....%0%................%.....%.......................%%..........%%....%%.....................%%%....%..............
m ........%%.....%................%%%...%%.......................%%..........%%....%%......................%%...%%..............
m %..%....%%....%%....%...%%%%%...%%.....%%................%%%.%%%%.%%%.%....%%...%%%...%%%....%%......%%.%%%....%%....%.%..%%%%
m %%%%%...%%....%%....%%%%%%%%%....%.....%%%%%%%.....%%...%%%%%%%%%%%%%%%...%%%...%%....%%%...%%%....%%%%%%%....%%.....%%%%%%%%%
m ..%.....%%.....%%....%%..%..%....%....%%%%.........%....%...%%%.%.%%%.....%%.....%%...%%%.....%....%%%%%%%.....%%.....%%..%%%%
m ........%%%.........%%%..........%%...%%%.................................%%%..........%......................%%...........%..
m ........%%%..........%..........%%%...%%%.................................%%%.........%%.......................%...........%%.
m ........%%%.........%%...........%%....%...................................%%..........%......................%%%.........%%%.
m ..%.5....%%%%%%.%.%%%%.....%...%%%%....%%.....%...%...%%%..%3...%......%%.%%%...%.%%%.%%%%.%%...%.%%%...%.%%.%%%%....%%%%%%%..
m ...%%...%%%%%%%%%%%%%0....%%%%%%%%2....%.....%%...%%%%%%%%%%%%%%%...%%%%%%%%%....%%%%%%%%%%%%%%%%%%%....%%%%%%%%%...%%%%%%%%..
m ...%%...%.%.%%%%%.%..%%...%%%%..%%%...%%%....%%...0%%%%%%%%%%%......%%%%%%%%.....%%%.%%%.%..%...%%%%%....%%.%%......%..%.%%%..
m ...%%.....................%%%..........%%....%%......................%%.2.%%......................%%....%%.............2...%%.
m ...%.......................%%..........%%....%%.....................%%%....%......................%%....%4%................%..
m ..%%.......................%%..........%%....%%......................%%...%%......................%%.....%................%%%.
m ...%%................%%%.%%%%.%%%.%....%%...%%%...%%%....%%......%%.%%%....%%....%.%..%%%%%..%....%%....%%....%...%%%%%...%%..
m ...%%%%%%%.....%%...%%%%%%%%%%%%%%%...%%%...%%....%%%...%%%....%%%%%%%....%%.....%%%%%%%%%%%%%%...%%....%%....%%%%%%%%%....%..
m ..%%%%.........%....%...%%%.%.%%%.....%%.....%%...%%%.....%....%%%%%%%.....%%.....%%..%%%%..%.....%%.....%%....%%..%..%....%..
m ..%%%.................................%%%..........%......................%%...........%..........%%%.........%%%..........%%.
m ..%%%.................................%%%.........%%.......................%...........%%.........%%%..........%..........%%%.
m ...%...................................%%..........%......................%%%.........%%%.........%%%.........%%...........%%.
m ...%%.....%...%...%%%..%0...%......%%.%%%...%.%%%.%%%%.%%...%.%%%...%.%%.%%%%....%%%%%%%....%.2....%%%%%%.%.%%%%.....%...%%%%.
m ...%.....%%...%%%%%%%%%%%%%%%...%%%%%%%%%....%%%%%%%%%%%%%%%%%%%....%%%%%%%%%...%%%%%%%%.....%%...%%%%%%%%%%%%%4....%%%%%%%%6.
m ..%%%....%%...4%%%%%%%%%%%......%%%%%%%%.....%%%.%%%.%..%...%%%%%....%%.%%......%..%.%%%.....%%...%.%.%%%%%.%..%%...%%%%..%%%.
m ...%%....%%......................%%.6.%%......................%%....%%.............6...%%....%%.....................%%%.......
m ...%%....%%.....................%%%....%......................%%....%1%................%.....%.......................%%.......
