# map type: blank
# random seed: -1937477145
# hill distance  35, 24  34, 48  48,112   9,  2  22, 90  60, 70  74,134  47,136  73,  4  61, 46  86, 92  87, 68  21,114   8, 26
#        35, 24       0      27      93      92      93      75      97      68      72      92     110      97     106      69 
#        34, 48      27       0     106      75      68      50     110      81      85      69      85      72      81      50 
#        48,112      93     106       0      97      92      68      92      27      75      93      72      97      69     110 
#         9,  2      92      75      97       0      93     110      92      72      69      97     106      93      68      27 
#        22, 90      93      68      92      93       0      72      97      75     110      97      69      92      27     106 
#        60, 70      75      50      68     110      72       0     106      81      81      27      50      69      85      85 
#        74,134      97     110      92      92      97     106       0      69      27      93      68      93      72      75 
#        47,136      68      81      27      72      75      81      69       0      50     106      85     110      50      85 
#        73,  4      72      85      75      69     110      81      27      50       0      68      81     106      85      50 
#        61, 46      92      69      93      97      97      27      93     106      68       0      75      92     110      72 
#        86, 92     110      85      72     106      69      50      68      85      81      75       0      27      50      81 
#        87, 68      97      72      97      93      92      69      93     110     106      92      27       0      75      68 
#        21,114     106      81      69      68      27      85      72      50      85     110      50      75       0      81 
#         8, 26      69      50     110      27     106      85      75      85      50      72      81      68      81       0 
players 7
rows 91
cols 154
m ...%%%%%.....%%%%...........%%..........%%............%%........%%%......%%.................%%%%%%%.........%%..............%%............%%..%%%%........
m ..%%%%%%%%%%%%%............%%%%.........%%............%%........%%%%%%%%%%%.....................%%%%.......%%%.............%%.............%%%%%%..........
m .%%%%...%%%%%%...........%%%%%%........%%%...........%%%.............%%%%.........................%.........%%.............%%..............%%%%...........
m %%%.....................%%%...%%%%%%%%%%%.........%%%%%%..........................%%%.......................%%..............%...............%%%...........
m %%......................%......%%%%%%%%%%........%%%%%%%.........................%%%%%.....................%%%..............%................%%..........%
m %...................................................................................%%%....................%%%..............%.................%%.........%
m .....................................................................................%%%...................%%.................................%%%.......%%
m ...........................................................%...........................%%.................%%%..................................%%%%%...%%.
m ...................%%.....2................%...............%%...........................%%%...............%%..........................%........%%%%%%%%%%.
m ..0................%%......................%%..............%%............................%%%.............%%%.....................%%%%%%........%%%...%%%..
m ...................%%%.....................%%..............%%.............................%%%%...........%%..........%%..........%%%...........%%.....%%%.
m ...................%%%%%%%.................%%..............%%.........%%.......%%..........%%%%.........%%%..........%...........%%............%%......%%.
m ...................%%%%%%%%%%%%%...........%%.............%%...........%%.....%%............%%%.......%%%%...........%..........%%%............%.......%%%
m %......%%.................%%%%%%%.........%%..............%%............%%..%%%%...........%%%%%.....%%%%...........%%..........%%............%%........%%
m %%%%%%%%%.....................%%%%.......%%%.............%%.............%%%%%%............%%%%%%%%%%%%%............%%%%.........%%............%%........%%
m ...%%%%.........................%.........%%.............%%..............%%%%............%%%%...%%%%%%...........%%%%%%........%%%...........%%%..........
m ................%%%.......................%%..............%...............%%%...........%%%.....................%%%...%%%%%%%%%%%.........%%%%%%..........
m ...............%%%%%.....................%%%..............%................%%..........%%%......................%......%%%%%%%%%%........%%%%%%%..........
m ..................%%%....................%%%..............%.................%%.........%%.................................................................
m ...................%%%...................%%.................................%%%.......%%..................................................................
m .....................%%.................%%%..................................%%%%%...%%............................................................%......
m ......................%%%...............%%..........................%........%%%%%%%%%%....................%%.....3................%...............%%.....
m .......................%%%.............%%%.....................%%%%%%........%%%...%%%....1................%%......................%%..............%%.....
m ........................%%%%...........%%..........%%..........%%%...........%%.....%%%....................%%%.....................%%..............%%.....
m ....%%.......%%..........%%%%.........%%%..........%...........%%............%%......%%....................%%%%%%%.................%%..............%%.....
m .....%%.....%%............%%%.......%%%%...........%..........%%%............%.......%%%...................%%%%%%%%%%%%%...........%%.............%%......
m ......%%..%%%%...........%%%%%.....%%%%...........%%..........%%............%%........%%%......%%.................%%%%%%%.........%%..............%%......
m ......%%%%%%............%%%%%%%%%%%%%............%%%%.........%%............%%........%%%%%%%%%%%.....................%%%%.......%%%.............%%.......
m .......%%%%............%%%%...%%%%%%...........%%%%%%........%%%...........%%%.............%%%%.........................%.........%%.............%%.......
m ........%%%...........%%%.....................%%%...%%%%%%%%%%%.........%%%%%%..........................%%%.......................%%..............%.......
m .........%%..........%%%......................%......%%%%%%%%%%........%%%%%%%.........................%%%%%.....................%%%..............%.......
m ..........%%.........%%...................................................................................%%%....................%%%..............%.......
m ..........%%%.......%%.....................................................................................%%%...................%%.......................
m ...........%%%%%...%%............................................................%...........................%%.................%%%.......................
m ..%........%%%%%%%%%%....................%%.....4................%...............%%...........................%%%...............%%........................
m %%%........%%%...%%%....2................%%......................%%..............%%............................%%%.............%%%.....................%%%
m ...........%%.....%%%....................%%%.....................%%..............%%.............................%%%%...........%%..........%%..........%%%
m ...........%%......%%....................%%%%%%%.................%%..............%%.........%%.......%%..........%%%%.........%%%..........%...........%%.
m ...........%.......%%%...................%%%%%%%%%%%%%...........%%.............%%...........%%.....%%............%%%.......%%%%...........%..........%%%.
m ..........%%........%%%......%%.................%%%%%%%.........%%..............%%............%%..%%%%...........%%%%%.....%%%%...........%%..........%%..
m ..........%%........%%%%%%%%%%%.....................%%%%.......%%%.............%%.............%%%%%%............%%%%%%%%%%%%%............%%%%.........%%..
m .........%%%.............%%%%.........................%.........%%.............%%..............%%%%............%%%%...%%%%%%...........%%%%%%........%%%..
m ......%%%%%%..........................%%%.......................%%..............%...............%%%...........%%%.....................%%%...%%%%%%%%%%%...
m .....%%%%%%%.........................%%%%%.....................%%%..............%................%%..........%%%......................%......%%%%%%%%%%...
m ........................................%%%....................%%%..............%.................%%.........%%...........................................
m .........................................%%%...................%%.................................%%%.......%%............................................
m ...............%...........................%%.................%%%..................................%%%%%...%%.............................................
m ...............%%...........................%%%...............%%..........................%........%%%%%%%%%%....................%%.....5................%
m %..............%%............................%%%.............%%%.....................%%%%%%........%%%...%%%....3................%%......................%
m %..............%%.............................%%%%...........%%..........%%..........%%%...........%%.....%%%....................%%%.....................%
m %..............%%.........%%.......%%..........%%%%.........%%%..........%...........%%............%%......%%....................%%%%%%%.................%
m %.............%%...........%%.....%%............%%%.......%%%%...........%..........%%%............%.......%%%...................%%%%%%%%%%%%%...........%
m ..............%%............%%..%%%%...........%%%%%.....%%%%...........%%..........%%............%%........%%%......%%.................%%%%%%%.........%%
m .............%%.............%%%%%%............%%%%%%%%%%%%%............%%%%.........%%............%%........%%%%%%%%%%%.....................%%%%.......%%%
m .............%%..............%%%%............%%%%...%%%%%%...........%%%%%%........%%%...........%%%.............%%%%.........................%.........%%
m ..............%...............%%%...........%%%.....................%%%...%%%%%%%%%%%.........%%%%%%..........................%%%.......................%%
m ..............%................%%..........%%%......................%......%%%%%%%%%%........%%%%%%%.........................%%%%%.....................%%%
m ..............%.................%%.........%%...................................................................................%%%....................%%%
m ................................%%%.......%%.....................................................................................%%%...................%%.
m .................................%%%%%...%%............................................................%...........................%%.................%%%.
m ........................%........%%%%%%%%%%....................%%.....6................%...............%%...........................%%%...............%%..
m ...................%%%%%%........%%%...%%%....4................%%......................%%..............%%............................%%%.............%%%..
m .......%%..........%%%...........%%.....%%%....................%%%.....................%%..............%%.............................%%%%...........%%...
m .......%...........%%............%%......%%....................%%%%%%%.................%%..............%%.........%%.......%%..........%%%%.........%%%...
m .......%..........%%%............%.......%%%...................%%%%%%%%%%%%%...........%%.............%%...........%%.....%%............%%%.......%%%%....
m ......%%..........%%............%%........%%%......%%.................%%%%%%%.........%%..............%%............%%..%%%%...........%%%%%.....%%%%.....
m .....%%%%.........%%............%%........%%%%%%%%%%%.....................%%%%.......%%%.............%%.............%%%%%%............%%%%%%%%%%%%%.......
m ...%%%%%%........%%%...........%%%.............%%%%.........................%.........%%.............%%..............%%%%............%%%%...%%%%%%........
m ..%%%...%%%%%%%%%%%.........%%%%%%..........................%%%.......................%%..............%...............%%%...........%%%...................
m ..%......%%%%%%%%%%........%%%%%%%.........................%%%%%.....................%%%..............%................%%..........%%%....................
m ..............................................................%%%....................%%%..............%.................%%.........%%.....................
m ...............................................................%%%...................%%.................................%%%.......%%......................
m .....................................%...........................%%.................%%%..................................%%%%%...%%.......................
m ....0................%...............%%...........................%%%...............%%..........................%........%%%%%%%%%%....................%%.
m .....................%%..............%%............................%%%.............%%%.....................%%%%%%........%%%...%%%....5................%%.
m .....................%%..............%%.............................%%%%...........%%..........%%..........%%%...........%%.....%%%....................%%%
m %%%%.................%%..............%%.........%%.......%%..........%%%%.........%%%..........%...........%%............%%......%%....................%%%
m %%%%%%%%%%...........%%.............%%...........%%.....%%............%%%.......%%%%...........%..........%%%............%.......%%%...................%%%
m ....%%%%%%%.........%%..............%%............%%..%%%%...........%%%%%.....%%%%...........%%..........%%............%%........%%%......%%.............
m ........%%%%.......%%%.............%%.............%%%%%%............%%%%%%%%%%%%%............%%%%.........%%............%%........%%%%%%%%%%%.............
m ..........%.........%%.............%%..............%%%%............%%%%...%%%%%%...........%%%%%%........%%%...........%%%.............%%%%...............
m ....................%%..............%...............%%%...........%%%.....................%%%...%%%%%%%%%%%.........%%%%%%..........................%%%...
m ...................%%%..............%................%%..........%%%......................%......%%%%%%%%%%........%%%%%%%.........................%%%%%..
m ...................%%%..............%.................%%.........%%...................................................................................%%%.
m ...................%%.................................%%%.......%%.....................................................................................%%%
m %.................%%%..................................%%%%%...%%............................................................%...........................%
m %%%...............%%..........................%........%%%%%%%%%%....................%%.....1................%...............%%...........................
m .%%%.............%%%.....................%%%%%%........%%%...%%%....6................%%......................%%..............%%...........................
m ..%%%%...........%%..........%%..........%%%...........%%.....%%%....................%%%.....................%%..............%%...........................
m ...%%%%.........%%%..........%...........%%............%%......%%....................%%%%%%%.................%%..............%%.........%%.......%%.......
m ....%%%.......%%%%...........%..........%%%............%.......%%%...................%%%%%%%%%%%%%...........%%.............%%...........%%.....%%........
