# map type: cell maze
# random seed: 2026099491
# players 4
# area 19591, 4897 (70.0^2) per player
# cell width: 1.45381816353
# cell size: 12.2682704928
# openness: 0.239111841607
# maze type growing
# vert_shear
# horz_mirror
# final parameters
# area: 19200
# grid size: (2, 2)
# tile size: (48, 100) 2.08333333333
# map size: (96, 200) 2.08333333333
# hill distance  90, 67  42, 67  42,132  90,132
#        90, 67       0      70     113      83 
#        42, 67      70       0      83     113 
#        42,132     113      83       0      70 
#        90,132      83     113      70       0 
players 4
rows 96
cols 200
m ............%%.........%%%...........%%..........................................................%%%%%%..........................................................%%...........%%%.........%%............
m ............%...........%%............%%...%%%%...................................................%%%%...................................................%%%%...%%............%%...........%............
m ...........%%...........%..............%%%%%%%%................%...................................%%...................................%................%%%%%%%%..............%...........%%...........
m %.........%%............%....................................%%%%%....................................................................%%%%%....................................%............%%.........%
m %%%%%....%%.............%.................................%%%%%%.%%..................................................................%%.%%%%%%.................................%.............%%....%%%%%
m ..%%%%%%%%.............%%..............................%%%%%................................................................................%%%%%..............................%%.............%%%%%%%%..
m ......%%%%.............%%...........................%%%%%......................................................................................%%%%%...........................%%.............%%%%......
m ........%%.............%%...........................%%............................................................................................%%...........................%%.............%%........
m .........%%............%............................................%%%..........................................................%%%............................................%............%%.........
m ..........%............%...........................................%%%%%%%....................................................%%%%%%%...........................................%............%..........
m ..........%%...........%...........................................%%...%%%%%%.....%%%............................%%%.....%%%%%%...%%...........................................%...........%%..........
m ...........%..........%%...........................................%........%%%%%%%%%..............................%%%%%%%%%........%...........................................%%..........%...........
m ......................%%..........................................%%...........%%%%..................................%%%%...........%%..........................................%%......................
m ......................%%..........................................%..................................................................%..........................................%%......................
m ..................................................................%..................................................................%..................................................................
m .................................................................%%..................................................................%%.................................................................
m .................................................................%....................................................................%.................................................................
m .................................................%%%%%..........%%....................................................................%%..........%%%%%.................................................
m ...............................%%%%%%%..%%%%%%%%%%%%%%..........%%....................................................................%%..........%%%%%%%%%%%%%%..%%%%%%%...............................
m ...........................%%%%%%%...%%%%%%%%%..................%......................................................................%..................%%%%%%%%%...%%%%%%%...........................
m .......%...................%..........%%%..................%%%%%%......................................................................%%%%%%..................%%%..........%...................%.......
m .......%.................................................%%%%%%..........................................................................%%%%%%.................................................%.......
m .......%%......................................................................................................................................................................................%%.......
m ........%......................................................................................................................................................................................%........
m ...................................................................................................%%...................................................................................................
m .......................%.........................................................................%%%%%%.........................................................................%.......................
m .......................%.....................................................%.................%%%%..%%%%.................%.....................................................%.......................
m .......................%...................................................%%%%%%%............%%%......%%%............%%%%%%%...................................................%.......................
m .......................%..................................................%%...%%%%%%%......%%%..........%%%......%%%%%%%...%%..................................................%.......................
m .......................%...........................................................%%%%%%%%%%..............%%%%%%%%%%...........................................................%.......................
m .......................................................................................%%%%..................%%%%.......................................................................................
m ..........................................%%................................................................................................................%%..........................................
m ..........................................%%%%%.........................%%....................................................%%.........................%%%%%..........................................
m ..............................................%%%%%%....................%%....................................................%%....................%%%%%%..............................................
m .................................................%%%%%..................%%....................................................%%..................%%%%%.................................................
m ...%%...............................................%%...................%....................................................%...................%%...............................................%%...
m %%%%%................................................%%..................%%..................................................%%..................%%................................................%%%%%
m %%....................................................%%%................%%..................................................%%................%%%....................................................%%
m .............%..........................................%%%%..............%..................................................%..............%%%%..........................................%.............
m .............%%...........................................%%..............%%................................................%%..............%%...........................................%%.............
m .............%%..................%........................................%%.............%....................%.............%%........................................%..................%%.............
m ..............%..................%.........................................%.............%%..................%%.............%.........................................%..................%..............
m ..............%%.................%.................................0.......%%.............%%................%%.............%%.......2.................................%.................%%..............
m ...............%................%%.........................................%%%.............%%%............%%%.............%%%.........................................%%................%...............
m ...............%%..............%%%%.........................................%%%%.............%%..........%%.............%%%%.........................................%%%%..............%%...............
m ...............%%%%..........%%%..%%...........................................%%%............%%........%%............%%%...........................................%%..%%%..........%%%%...............
m ..............%%..%%%%.....%%%.....%%..........................................................%%%....%%%..........................................................%%.....%%%.....%%%%..%%..............
m .............%%......%%%%%%%........%%..........................................................%%%..%%%..........................................................%%........%%%%%%%......%%.............
m ............%%.........%%%...........%%..........................................................%%%%%%..........................................................%%...........%%%.........%%............
m ............%...........%%............%%...%%%%...................................................%%%%...................................................%%%%...%%............%%...........%............
m ...........%%...........%..............%%%%%%%%................%...................................%%...................................%................%%%%%%%%..............%...........%%...........
m %.........%%............%....................................%%%%%....................................................................%%%%%....................................%............%%.........%
m %%%%%....%%.............%.................................%%%%%%.%%..................................................................%%.%%%%%%.................................%.............%%....%%%%%
m ..%%%%%%%%.............%%..............................%%%%%................................................................................%%%%%..............................%%.............%%%%%%%%..
m ......%%%%.............%%...........................%%%%%......................................................................................%%%%%...........................%%.............%%%%......
m ........%%.............%%...........................%%............................................................................................%%...........................%%.............%%........
m .........%%............%............................................%%%..........................................................%%%............................................%............%%.........
m ..........%............%...........................................%%%%%%%....................................................%%%%%%%...........................................%............%..........
m ..........%%...........%...........................................%%...%%%%%%.....%%%............................%%%.....%%%%%%...%%...........................................%...........%%..........
m ...........%..........%%...........................................%........%%%%%%%%%..............................%%%%%%%%%........%...........................................%%..........%...........
m ......................%%..........................................%%...........%%%%..................................%%%%...........%%..........................................%%......................
m ......................%%..........................................%..................................................................%..........................................%%......................
m ..................................................................%..................................................................%..................................................................
m .................................................................%%..................................................................%%.................................................................
m .................................................................%....................................................................%.................................................................
m .................................................%%%%%..........%%....................................................................%%..........%%%%%.................................................
m ...............................%%%%%%%..%%%%%%%%%%%%%%..........%%....................................................................%%..........%%%%%%%%%%%%%%..%%%%%%%...............................
m ...........................%%%%%%%...%%%%%%%%%..................%......................................................................%..................%%%%%%%%%...%%%%%%%...........................
m .......%...................%..........%%%..................%%%%%%......................................................................%%%%%%..................%%%..........%...................%.......
m .......%.................................................%%%%%%..........................................................................%%%%%%.................................................%.......
m .......%%......................................................................................................................................................................................%%.......
m ........%......................................................................................................................................................................................%........
m ...................................................................................................%%...................................................................................................
m .......................%.........................................................................%%%%%%.........................................................................%.......................
m .......................%.....................................................%.................%%%%..%%%%.................%.....................................................%.......................
m .......................%...................................................%%%%%%%............%%%......%%%............%%%%%%%...................................................%.......................
m .......................%..................................................%%...%%%%%%%......%%%..........%%%......%%%%%%%...%%..................................................%.......................
m .......................%...........................................................%%%%%%%%%%..............%%%%%%%%%%...........................................................%.......................
m .......................................................................................%%%%..................%%%%.......................................................................................
m ..........................................%%................................................................................................................%%..........................................
m ..........................................%%%%%.........................%%....................................................%%.........................%%%%%..........................................
m ..............................................%%%%%%....................%%....................................................%%....................%%%%%%..............................................
m .................................................%%%%%..................%%....................................................%%..................%%%%%.................................................
m ...%%...............................................%%...................%....................................................%...................%%...............................................%%...
m %%%%%................................................%%..................%%..................................................%%..................%%................................................%%%%%
m %%....................................................%%%................%%..................................................%%................%%%....................................................%%
m .............%..........................................%%%%..............%..................................................%..............%%%%..........................................%.............
m .............%%...........................................%%..............%%................................................%%..............%%...........................................%%.............
m .............%%..................%........................................%%.............%....................%.............%%........................................%..................%%.............
m ..............%..................%.........................................%.............%%..................%%.............%.........................................%..................%..............
m ..............%%.................%.................................1.......%%.............%%................%%.............%%.......3.................................%.................%%..............
m ...............%................%%.........................................%%%.............%%%............%%%.............%%%.........................................%%................%...............
m ...............%%..............%%%%.........................................%%%%.............%%..........%%.............%%%%.........................................%%%%..............%%...............
m ...............%%%%..........%%%..%%...........................................%%%............%%........%%............%%%...........................................%%..%%%..........%%%%...............
m ..............%%..%%%%.....%%%.....%%..........................................................%%%....%%%..........................................................%%.....%%%.....%%%%..%%..............
m .............%%......%%%%%%%........%%..........................................................%%%..%%%..........................................................%%........%%%%%%%......%%.............
