# random seed 7177107317394456079
# players 2
# area 23018
# cell width: 1.49326323013
# cell size: 7
# openness: 0.131603532023
# grid size: (1, 2)
# tile size: (130, 88) 0.676923076923
# map size: (130, 176) 1.35384615385
# horz shear step: 1
# horz_shear
# maze type recursive backtracker
# final openness 0.131603532023
# map_type cell_maze
# random_seed 7177107317394456079
players 2
rows 130
cols 176
m ..........................%%..........%%.......%%%...%%.....%%%..%%%...........%..........................%%........%%...%%%....%%........%%%.......%%%.%%%.............%......%
m ...........................%..........%%.......%%%....%%...%%%....%%%..........%.........%................%%.........%.%%%.................%%......%%%....%%............%%....%%
m .....%%%...................%..........%........%%......%%.%%%......%%%%%.......%........%%.....%%.........%%.........%%%%.................%%%.....%%%......%%%..........%%....%%
m %%%%%%%%...................%%........%%........%%.......%%%%...................%........%.......%.........%%...........%..................%%.....%%%.........%%..............%%%
m %%%%............%%.........%%.........%........%%........%%....................%.......%%.......%.........%%%%.........%%........%.......%%......%%...........%%..............%%
m %.............%%%..........%%..................%%..........................%%%%%%.....%%........%...........%%%%%.......%........%%.....%%......%%%...........%%%.............%%
m ............%%%............%..................%%%.........................%%%%..%%....%.........%.......................%%......%%......%.......%%..............%%%...........%%
m %.........%%%............%%%................%%%..........................%%......%..............%........................%.....%%...............%%...............%%%.........%%%
m %%........%%...........%%%%%%.............%%%...................%%.......%%.....................%..............................%%..............%%.................%%.........%%%
m %%%..................%%%....%%..........%%%%...................%%%%%.....%%.....................%..............................%%..............%%.......%...................%%..
m .%%%.........................%%.........%%%.........%%.........%%%%%%%...%.....................................................%%........%....%%........%..................%%...
m ..%%%........................%%........%%%%.........%%........%%....%%%%%%....................................................%%........%%%...%%........%.................%%....
m ...%%%..%%%%..................%%.....%%%.%%%........%%......%%%%......%%%%...............%%.........%%%%%............%........%........%%%....%%........%................%%.....
m ....%%%%%%%%%%%%%%%%%..........%%...%%.....%%%.......%%%%%%%%%%.........%%.....%%%.......%..........%%%%%%........%%%%.......%%.......%%%......%%.......%%%%%%%%%........%%.....
m .....%%.....%%%%%%%%%...............%.......%%%.......%%%%%..............%%......%%.....%%..............%%%.......%%.........%........%%........%........%%%%%%%%%.......%%.....
m ....%%%.............%%........................%%.......%.................%%%......%%%...%%...............%%%......%%........%%........%.........%%...............%.......%%.....
m .....%...............%..............................................................%%%%%%................%%......%%........%.........%..........%...............%%......%%.....
m .....%...............%%.....%........................................................%%%...................%.......%........%.........%..........%%...............%%.....%%%....
m .....%................%....%%.........................................................%........%%.........%%.......%%.......%%........%%.........%%...............%%%%%%%%%%%...
m .....%...............................%%..........................%%...................%.........%.........%%.......%%.......%%%.......%%%.........%...................%%%..%%%..
m .....%...............................%%%%%%%%%...................%...................%%.........%%.......%%%%......%%.........%%%.......%%........%%...................%%...%%..
m .....%..............................%%%%%%%%%%%........%%%......%%%..................%...........%......%%.%%%......%..........%%........%.........%...................%%....%%.
m .....%..............................%%.......%%%%%%..%%%%%%%%%%%%%%%........%........%%..........%%....%%...%%%.....%%%%........%..................%%.....%%%..........%......%%
m %...%%%......%%%%%%%%..............%%...........%%%%%%%.....%%%....%%%...%%%%........%%.........%%....%%.....%%%.......%........%..................%%.%%%%%%%%%........%.......%
m %...%%%.......%%%%..%%%......%%%%%%%%...............%........%%.....%%%%%%%%.........%%........%%.............%%%...............%...................%%%%.....%%........%.......%
m .....%%%.......%%.....%%%..%%%%%%%%%.........................%%.......%%.............%%........%%..............%%...............%...................%%........%%.......%........
m ......%%.......%%.......%%%%%......%%........................%%......................%........%%...............%%..............%%.........%%........%.........%%......%%........
m ................%........%%.........%........................%%.....................%%........%................%%............%%%..........%.........%..........%......%%%.......
m ................%...................%%.......................%%.....................%%........%................%%..........%%%...........%%.........%%........%%......%%%%%%%...
m ................%....................%%...%%%................%%.....................%.........%...............%%%%%......%%%.........%%%%%..........%%........%.......%%....%%..
m ................%..........................%%%.......%......%%...............%.....%%.........%%.......%%%...%%%%%%%%%%%%%%.........%%%%.%%.........%%........%.......%......%..
m .....%%........%%%.......%..................%%%....%%%.....%%.......%%%......%%%%%%%%........%%.......%%%...........%%%%%%................%........%%........%%.......%......%%.
m ......%%%.....%%.......%%%...................%%%%%%%%.....%%........%%%.......%%%%%%%%.......%%.......%%...............%%%................%%......%%.........%........%.......%%
m %......%%%..%%%.......%%%.................................%%........%%..............%%%......%%.........................%%.................%%%%%%%%%........%%........%.......%%
m %%.......%%%%%........%%..................................%%........%%...............%%......%%............................................%%%%%%%%.........%%.......%%........%
m %%........%%%.........%...........%%.......................%.........................%%.......%...........................................%%.....%%.........%........%%........%
m %%.........%%........%%.........%%%%%......................%%........................%%.......%%..........................................%%......%..................%%.........
m %%..................%%%............%%%.....%%..............%%........................%%......%%%..............%%..............%%%%........%%......%%................%%..........
m %%................%%%...............%%%%%%%%%%.............%%%............%%%%.......%%%%...%%%..............%%....%%.........%%%%%.......%.......%%............................
m %%...............%%..................%%%%%..%%%..............%%%........%%%%%..........%%%%%%%.......%%%%..%%%.....%%.............%%%.............%%............................
m %%...............%....................%......%%%...............%........%................%%%%.......%%.%%%%%%.......%..............%%....................%......................
m %%...............%....................%.......%%%....%.........%%.......%..................%...............%........%%..............%...................%%%.....................
m %%...............%.........%..........%........%%%%%%%..........%......%%.......%%%%.......%........................%%..............%%........%..........%%%%...................
m %%%%%%%%%%.......%........%%.........%%%............%%..........%%.....%........%%%%%......%........................%%%%............%%........%...........%%%%%......%%%........
m %%%%%%...%%%.....%%%......%%........%%%%%............%..........%%.............%%..%%%.....%%.....................%%%.%%%%%.........%%.......%%..............%%%%%..%%%%%%%.....
m %%%.......%%%.....%%%.....%%%......%%...%%...........%%.........%%............%%....%%......%%..........0....%...%%%.....%%..........%...%%%%%%................%%%%%%....%%%%%%%
m %%..........%.......%......%......%%.....%%%..........%.......%%%%%..........%%......%.......%%.%%%%.........%%%%%........%%.........%%%%%%%..%%.................%%%........%%%%
m %%%........................%..............%%..........%......%%..%%.........%%%..............%%%%%.........................%.........%%%.......%%.................%%..........%%
m .%%%.......................%...............%%..............%%%....%%........%%...............%%............................%%.......%%..........%......%..........%%..........%%
m ..%%%......................%...............%%%.....................%........%................%%............................%%%.......%..........%%...%%%...........%.........%%%
m ...%%%.....................%.................%%....................%%.......%%......%%......%%.........%%%...................%%..................%%%%%.............%%.......%%%.
m ....%%%.....%..............%..................%%%...................%%.......%......%%%.....%%.........%%%%..................%%....................%%.......%%......%......%%%..
m .....%%%....%%.....%.......%...................%%%..................%%...............%%%....%............%%%.................%%.............................%.......%.....%%%...
m ......%......%%%%%%%%%..%%%%%%......%%%.........%%%.................%%................%%%.................%%%.......%.........%.....................................%%...%%%....
m ..............%%....%%%%%%..%%%%..%%%%%..........%%%........%%......%..................%%..................%%%.....%%.........%.........%................................%%.....
m ..............%.......%.......%%%%%................%%......%%......%%..................%....................%%%%%%%%%.........%.........%%%.....................................
m .............%%.................%%..................%%%..%%%.......%%..................%.....................%%%%%%%%.........%........%%%%%....................................
m ....%%.......%%............................%%.......%%%%%%%........%%%.................%%..........%................%%........%%......%%%.%%%.......%.......%%%%................
m %%%%%%%......%%............................%.............%%..........%%%...............%%..........%................%%........%%......%%%...%%%...%%%%%.......%%%%..............
m %%%...%%....%%.............................%..............%%...........%%%....%.........%%.........%%................%%.......%%.......%%.....%%%%%..%%%.........%%............%
m %......%%%%%%.........%....................%...............%.............%%%%%%.........%%........%%%%...............%%......%%........%%......%.......%%........%%...........%%
m ........%%%..........%%....................%...............%%.............%%..%%........%........%%%%%%%.....................%%........%%..............%%.........%%.....%%%%%%%
m ....................%%.....%%.............%%................%%................%%.......%%.......%%....%%%%%...................%........%%..............%%.........%%%%%%%%%...%.
m ..................%%%.......%.......%%%...%%%%%%%%%%........%%%................%.......%%...............%%%...................%%.......%%.............%%%%............%%%.......
m ..................%%........%......%%%%%%%%%%%%%%%%%.........%%%%..............%%......%%.....................................%%.......%%............%%%%%%............%........
m ..................%%........%%...%%%....%%........%%%.......%%%.%%%.............%......%..........................%%..........%%.......%%%...%%.....%%%..%%%...........%........
m .%................%%.........%.%%%.................%%......%%%....%%............%%....%%...........................%..........%%.......%%%....%%...%%%....%%%..........%........
m %%.....%%.........%%.........%%%%.................%%%.....%%%......%%%..........%%....%%.....%%%...................%..........%........%%......%%.%%%......%%%%%.......%........
m %.......%.........%%...........%..................%%.....%%%.........%%..............%%%%%%%%%%%...................%%........%%........%%.......%%%%...................%........
m %.......%.........%%%%.........%%........%.......%%......%%...........%%..............%%%%%%............%%.........%%.........%........%%........%%....................%.......%
m ........%...........%%%%%.......%........%%.....%%......%%%...........%%%.............%%%.............%%%..........%%..................%%..........................%%%%%%.....%%
m ........%.......................%%......%%......%.......%%..............%%%...........%%............%%%............%..................%%%.........................%%%%..%%....%.
m ........%........................%.....%%...............%%...............%%%.........%%%%.........%%%............%%%................%%%..........................%%......%......
m ........%..............................%%..............%%.................%%.........%%%%%........%%...........%%%%%%.............%%%...................%%.......%%.............
m ........%..............................%%..............%%.......%...................%%..%%%..................%%%....%%..........%%%%...................%%%%%.....%%.............
m .......................................%%........%....%%........%..................%%....%%%.........................%%.........%%%.........%%.........%%%%%%%...%..............
m ......................................%%........%%%...%%........%.................%%......%%%........................%%........%%%%.........%%........%%....%%%%%%..............
m .%%.........%%%%%............%........%........%%%....%%........%................%%........%%%..%%%%..................%%.....%%%.%%%........%%......%%%%......%%%%..............
m .%..........%%%%%%........%%%%.......%%.......%%%......%%.......%%%%%%%%%........%%.........%%%%%%%%%%%%%%%%%..........%%...%%.....%%%.......%%%%%%%%%%.........%%.....%%%......
m %%..............%%%.......%%.........%........%%........%........%%%%%%%%%.......%%..........%%.....%%%%%%%%%...............%.......%%%.......%%%%%..............%%......%%.....
m %%...............%%%......%%........%%........%.........%%...............%.......%%.........%%%.............%%........................%%.......%.................%%%......%%%...
m %%................%%......%%........%.........%..........%...............%%......%%..........%...............%..............................................................%%%%
m ...................%.......%........%.........%..........%%...............%%.....%%%.........%...............%%.....%........................................................%%%
m .......%%.........%%.......%%.......%%........%%.........%%...............%%%%%%%%%%%........%................%....%%.........................................................%.
m ........%.........%%.......%%.......%%%.......%%%.........%...................%%%..%%%.......%...............................%%..........................%%...................%.
m ........%%.......%%%%......%%.........%%%.......%%........%%...................%%...%%.......%...............................%%%%%%%%%...................%...................%%.
m .........%......%%.%%%......%..........%%........%.........%...................%%....%%......%..............................%%%%%%%%%%%........%%%......%%%..................%..
m .........%%....%%...%%%.....%%%%........%..................%%.....%%%..........%......%%.....%..............................%%.......%%%%%%..%%%%%%%%%%%%%%%........%........%%.
m ........%%....%%.....%%%.......%........%..................%%.%%%%%%%%%........%.......%%...%%%......%%%%%%%%..............%%...........%%%%%%%.....%%%....%%%...%%%%........%%.
m .......%%.............%%%...............%...................%%%%.....%%........%.......%%...%%%.......%%%%..%%%......%%%%%%%%...............%........%%.....%%%%%%%%.........%%.
m .......%%..............%%...............%...................%%........%%.......%.............%%%.......%%.....%%%..%%%%%%%%%.........................%%.......%%.............%%.
m ......%%...............%%..............%%.........%%........%.........%%......%%..............%%.......%%.......%%%%%......%%........................%%......................%..
m ......%................%%............%%%..........%.........%..........%......%%%.......................%........%%.........%........................%%.....................%%..
m ......%................%%..........%%%...........%%.........%%........%%......%%%%%%%...................%...................%%.......................%%.....................%%..
m ......%...............%%%%%......%%%.........%%%%%..........%%........%.......%%....%%..................%....................%%...%%%................%%.....................%...
m ......%%.......%%%...%%%%%%%%%%%%%%.........%%%%.%%.........%%........%.......%......%..................%..........................%%%.......%......%%...............%.....%%...
m .....%%.......%%%...........%%%%%%................%........%%........%%.......%......%%......%%........%%%.......%..................%%%....%%%.....%%.......%%%......%%%%%%%%...
m .....%%.......%%...............%%%................%%......%%.........%........%.......%%......%%%.....%%.......%%%...................%%%%%%%%.....%%........%%%.......%%%%%%%%..
m .....%%.........................%%.................%%%%%%%%%........%%........%.......%%%......%%%..%%%.......%%%.................................%%........%%..............%%%.
m .....%%............................................%%%%%%%%.........%%.......%%........%%%.......%%%%%........%%..................................%%........%%...............%%.
m ......%...........................................%%.....%%.........%........%%........%%%........%%%.........%...........%%.......................%.........................%%.
m ......%%..........................................%%......%..................%%.........%%.........%%........%%.........%%%%%......................%%........................%%.
m .....%%%..............%%..............%%%%........%%......%%................%%..........%%..................%%%............%%%.....%%..............%%........................%%.
m %...%%%..............%%....%%.........%%%%%.......%.......%%............................%%................%%%...............%%%%%%%%%%.............%%%............%%%%.......%%%
m %%%%%%.......%%%%..%%%.....%%.............%%%.............%%............................%%...............%%..................%%%%%..%%%..............%%%........%%%%%..........%
m .%%%%.......%%.%%%%%%.......%..............%%....................%......................%%...............%....................%......%%%...............%........%...............
m ...%...............%........%%..............%...................%%%.....................%%...............%....................%.......%%%....%.........%%.......%...............
m ...%........................%%..............%%........%..........%%%%...................%%...............%.........%..........%........%%%%%%%..........%......%%.......%%%%....
m ...%........................%%%%............%%........%...........%%%%%......%%%........%%%%%%%%%%.......%........%%.........%%%............%%..........%%.....%........%%%%%...
m ...%%.....................%%%.%%%%%.........%%.......%%..............%%%%%..%%%%%%%.....%%%%%%...%%%.....%%%......%%........%%%%%............%..........%%.............%%..%%%..
m ....%%..........1....%...%%%.....%%..........%...%%%%%%................%%%%%%....%%%%%%%%%%.......%%%.....%%%.....%%%......%%...%%...........%%.........%%............%%....%%..
m .....%%.%%%%.........%%%%%........%%.........%%%%%%%..%%.................%%%........%%%%%%..........%.......%......%......%%.....%%%..........%.......%%%%%..........%%......%..
m .....%%%%%.........................%.........%%%.......%%.................%%..........%%%%%........................%..............%%..........%......%%..%%.........%%%.........
m .....%%............................%%.......%%..........%......%..........%%..........%%.%%%.......................%...............%%..............%%%....%%........%%..........
m .....%%............................%%%.......%..........%%...%%%...........%.........%%%..%%%......................%...............%%%.....................%........%...........
m ....%%.........%%%...................%%..................%%%%%.............%%.......%%%....%%%.....................%.................%%....................%%.......%%......%%..
m ....%%.........%%%%..................%%....................%%.......%%......%......%%%......%%%.....%..............%..................%%%...................%%.......%......%%%.
m ....%............%%%.................%%.............................%.......%.....%%%........%%%....%%.....%.......%...................%%%..................%%...............%%%
m %.................%%%.......%.........%.....................................%%...%%%..........%......%%%%%%%%%..%%%%%%......%%%.........%%%.................%%................%%
m %..................%%%.....%%.........%.........%................................%%...................%%....%%%%%%..%%%%..%%%%%..........%%%........%%......%..................%
m ....................%%%%%%%%%.........%.........%%%...................................................%.......%.......%%%%%................%%......%%......%%..................%
m .....................%%%%%%%%.........%........%%%%%.................................................%%.................%%..................%%%..%%%.......%%..................%
m %..........%................%%........%%......%%%.%%%.......%.......%%%%....................%%.......%%............................%%.......%%%%%%%........%%%.................%
m %..........%................%%........%%......%%%...%%%...%%%%%.......%%%%..............%%%%%%%......%%............................%.............%%..........%%%...............%
m %%.........%%................%%.......%%.......%%.....%%%%%..%%%.........%%............%%%%...%%....%%.............................%..............%%...........%%%....%.........
m %%........%%%%...............%%......%%........%%......%.......%%........%%...........%%%......%%%%%%.........%....................%...............%.............%%%%%%.........
m %........%%%%%%%.....................%%........%%..............%%.........%%.....%%%%%%%........%%%..........%%....................%...............%%.............%%..%%........
m %.......%%....%%%%%...................%........%%..............%%.........%%%%%%%%%...%.....................%%.....%%.............%%................%%................%%.......%
m %...............%%%...................%%.......%%.............%%%%............%%%.........................%%%.......%.......%%%...%%%%%%%%%%........%%%................%.......%
m %.....................................%%.......%%............%%%%%%............%..........................%%........%......%%%%%%%%%%%%%%%%%.........%%%%..............%%......%
