# map type: blank
# random seed: 1420118511
# hill distance   2,  7  28, 95   2, 73  10, 42  28, 29  62, 20  10,108  62, 86  54, 51  36,130  54,117  36, 64
#         2,  7       0      74     100      97      70      71      39      71      74      57      70     111 
#        28, 95      74       0      70      71     100     111      71      57      74      97      70      39 
#         2, 73     100      70       0      39      74      71      97      71      70     111      74      57 
#        10, 42      97      71      39       0      71      68     116      92      57      92     111      68 
#        28, 29      70     100      74      71       0      57      71     111      70      39      74      97 
#        62, 20      71     111      71      68      57       0      92     116      39      68      97      92 
#        10,108      39      71      97     116      71      92       0      68     111      68      57      92 
#        62, 86      71      57      71      92     111     116      68       0      97      92      39      68 
#        54, 51      74      74      70      57      70      39     111      97       0      71     100      71 
#        36,130      57      97     111      92      39      68      68      92      71       0      71     116 
#        54,117      70      70      74     111      74      97      57      39     100      71       0      71 
#        36, 64     111      39      57      68      97      92      92      68      71     116      71       0 
players 6
rows 78
cols 132
m ...........%...........%.......................................%%............%...........%.......................................%%.
m ............%%.........%........................................%%............%%.........%........................................%%
m .......0....%%.........%..........................%%.....................3....%%.........%..........................%%..............
m ............%%........%%..........................%%..........................%%........%%..........................%%..............
m ...........%%%........%.........%%%%%%...........%...........................%%%........%.........%%%%%%...........%................
m .........%%%.%%.......%...............%.........%.......%..................%%%.%%.......%...............%.........%.......%.........
m ......%%%.....%%......%................%%%%%%%.%........%...............%%%.....%%......%................%%%%%%%.%........%.........
m ...%%%%.......%........................%.....%%.........%............%%%%.......%........................%.....%%.........%.........
m ..%%%.........%........................%................%...........%%%.........%........................%................%.........
m .%%%..........%.......................%%................%..........%%%..........%.......................%%................%.........
m %%.%%.........%.............%%........%...4.............%.........%%.%%.........%.............%%........%...1.............%.........
m %...%%........%...........%%%.........%.................%........%%...%%........%...........%%%.........%.................%........%
m .....%........%.........%%%..........%%.................%.......%......%........%.........%%%..........%%.................%.......%.
m ......%......%%.......%%%.............%.............%%%%%%....%%........%......%%.......%%%.............%.............%%%%%%....%%..
m ............%%%......%%...............%%........%%%%%....%....................%%%......%%...............%%........%%%%%....%........
m ...................%%..................%.......%.....................................%%..................%.......%..................
m .......................................%%................................................................%%.........................
m ........................................%%................................................................%%........................
m .........................................%%%...............................................................%%%......................
m .............................%.............%%..................................................%.............%%.....................
m .............................%..............%..................................................%..............%.....................
m ...........%%................%...............%...........%%..................%%................%...............%...........%%.......
m %%%%%....%%%.................%%..............%%........%%%.%......%%%%%....%%%.................%%..............%%........%%%.%......
m ....%%.%%%...................%%..............%%.....%%%.....%%%%%%....%%.%%%...................%%..............%%.....%%%.....%%%%%%
m .....%%%.......................%.............%%...%%%..................%%%.......................%.............%%...%%%.............
m ...................%............%............%%......................................%............%............%%...................
m ...................%%............%...........%.......................................%%............%...........%....................
m ....................%%............%%.........%........................................%%............%%.........%....................
m ......%%.....................1....%%.........%..........................%%.....................4....%%.........%....................
m ......%%..........................%%........%%..........................%%..........................%%........%%....................
m .....%...........................%%%........%.........%%%%%%...........%...........................%%%........%.........%%%%%%......
m ....%.......%..................%%%.%%.......%...............%.........%.......%..................%%%.%%.......%...............%.....
m %%.%........%...............%%%.....%%......%................%%%%%%%.%........%...............%%%.....%%......%................%%%%%
m .%%.........%............%%%%.......%........................%.....%%.........%............%%%%.......%........................%....
m ............%...........%%%.........%........................%................%...........%%%.........%........................%....
m ............%..........%%%..........%.......................%%................%..........%%%..........%.......................%%....
m ............%.........%%.%%.........%.............%%........%...5.............%.........%%.%%.........%.............%%........%...2.
m ............%........%%...%%........%...........%%%.........%.................%........%%...%%........%...........%%%.........%.....
m ............%.......%......%........%.........%%%..........%%.................%.......%......%........%.........%%%..........%%.....
m ........%%%%%%....%%........%......%%.......%%%.............%.............%%%%%%....%%........%......%%.......%%%.............%.....
m ....%%%%%....%....................%%%......%%...............%%........%%%%%....%....................%%%......%%...............%%....
m ...%.....................................%%..................%.......%.....................................%%..................%....
m .............................................................%%................................................................%%...
m ..............................................................%%................................................................%%..
m ...............................................................%%%...............................................................%%%
m %..................................................%.............%%..................................................%.............%
m %..................................................%..............%..................................................%..............
m .%...........%%..................%%................%...............%...........%%..................%%................%..............
m .%%........%%%.%......%%%%%....%%%.................%%..............%%........%%%.%......%%%%%....%%%.................%%.............
m .%%.....%%%.....%%%%%%....%%.%%%...................%%..............%%.....%%%.....%%%%%%....%%.%%%...................%%.............
m .%%...%%%..................%%%.......................%.............%%...%%%..................%%%.......................%............
m .%%......................................%............%............%%......................................%............%...........
m .%.......................................%%............%...........%.......................................%%............%..........
m .%........................................%%............%%.........%........................................%%............%%........
m .%..........................%%.....................2....%%.........%..........................%%.....................5....%%........
m %%..........................%%..........................%%........%%..........................%%..........................%%........
m %.........%%%%%%...........%...........................%%%........%.........%%%%%%...........%...........................%%%........
m %...............%.........%.......%..................%%%.%%.......%...............%.........%.......%..................%%%.%%.......
m %................%%%%%%%.%........%...............%%%.....%%......%................%%%%%%%.%........%...............%%%.....%%......
m .................%.....%%.........%............%%%%.......%........................%.....%%.........%............%%%%.......%.......
m .................%................%...........%%%.........%........................%................%...........%%%.........%.......
m ................%%................%..........%%%..........%.......................%%................%..........%%%..........%.......
m ......%%........%...3.............%.........%%.%%.........%.............%%........%...0.............%.........%%.%%.........%.......
m ....%%%.........%.................%........%%...%%........%...........%%%.........%.................%........%%...%%........%.......
m ..%%%..........%%.................%.......%......%........%.........%%%..........%%.................%.......%......%........%.......
m %%%.............%.............%%%%%%....%%........%......%%.......%%%.............%.............%%%%%%....%%........%......%%.......
m %...............%%........%%%%%....%....................%%%......%%...............%%........%%%%%....%....................%%%......%
m .................%.......%.....................................%%..................%.......%.....................................%%.
m .................%%................................................................%%...............................................
m ..................%%................................................................%%..............................................
m ...................%%%...............................................................%%%............................................
m .......%.............%%..................................................%.............%%...........................................
m .......%..............%..................................................%..............%...........................................
m .......%...............%...........%%..................%%................%...............%...........%%..................%%.........
m .......%%..............%%........%%%.%......%%%%%....%%%.................%%..............%%........%%%.%......%%%%%....%%%..........
m .......%%..............%%.....%%%.....%%%%%%....%%.%%%...................%%..............%%.....%%%.....%%%%%%....%%.%%%............
m .........%.............%%...%%%..................%%%.......................%.............%%...%%%..................%%%..............
m ..........%............%%......................................%............%............%%......................................%..
