# map type: blank
# random seed: 258932940
# hill distance  58, 53  67, 76  58, 23  10, 80  10, 50  10, 20  67, 16  58, 83  67, 46
#        58, 53       0      90      88     106      38     112      98      88      24 
#        67, 76      90       0      98      16     114     116     100      24     100 
#        58, 23      88      98       0     112     106      38      24      88      90 
#        10, 80     106      16     112       0     130     130     114      38     116 
#        10, 50      38     114     106     130       0     130     116     112      16 
#        10, 20     112     116      38     130     130       0      16     106     114 
#        67, 16      98     100      24     114     116      16       0      90     100 
#        58, 83      88      24      88      38     112     106      90       0      98 
#        67, 46      24     100      90     116      16     114     100      98       0 
players 3
rows 69
cols 90
m ..%%.......................%%%..%%.......................%%%..%%.......................%%%
m %%%.........................%%%%%.........................%%%%%.........................%%
m %%%..........................%%%%..........................%%%%..........................%
m %%............................%%............................%%............................
m %%..........%%%.%%%%..........%%..........%%%.%%%%..........%%..........%%%.%%%%..........
m %%........%%%%%%%%............%%........%%%%%%%%............%%........%%%%%%%%............
m %%.....%%%%%..%%%.............%%.....%%%%%..%%%.............%%.....%%%%%..%%%.............
m %%%%%%%%%......%%............%%%%%%%%%%......%%............%%%%%%%%%%......%%............%
m %.%%%%%........%%..........%%%%.%%%%%........%%..........%%%%.%%%%%........%%..........%%%
m ....%%.........%%..........%%.....%%.........%%..........%%.....%%.........%%..........%%.
m ....%%.........%%...0.....%%......%%.........%%...1.....%%......%%.........%%...2.....%%..
m .....%%........%%.........%%.......%%........%%.........%%.......%%........%%.........%%..
m .....%%........%%........%%........%%........%%........%%........%%........%%........%%...
m ......%........%%.......%%%.........%........%%.......%%%.........%........%%.......%%%...
m ......%%.......%%....%%%%%%.........%%.......%%....%%%%%%.........%%.......%%....%%%%%%...
m ......%%.......%%%%%%%%..%%.........%%.......%%%%%%%%..%%.........%%.......%%%%%%%%..%%...
m ......%%........%%%%......%%........%%........%%%%......%%........%%........%%%%......%%..
m ......%%........%%.........%........%%........%%.........%........%%........%%.........%..
m .....%%..........%.........%%......%%..........%.........%%......%%..........%.........%%.
m .....%%..........%..........%%.....%%..........%..........%%.....%%..........%..........%%
m ....%%...........%..........%%....%%...........%..........%%....%%...........%..........%%
m %....%%..........%..........%%%....%%..........%..........%%%....%%..........%..........%%
m ......%%.........%%.........%%......%%.........%%.........%%......%%.........%%.........%%
m .......%..........%%%......%%........%..........%%%......%%........%..........%%%......%%.
m .......%%..........%%%.....%.........%%..........%%%.....%.........%%..........%%%.....%..
m ........%%..........%%................%%..........%%................%%..........%%........
m .........%%.........%%.................%%.........%%.................%%.........%%........
m .........%%.........%%.................%%.........%%.................%%.........%%........
m .........%%.........%%.................%%.........%%.................%%.........%%........
m .........%%.........%%.................%%.........%%.................%%.........%%........
m .........%..........%%.................%..........%%.................%..........%%........
m ........%%..........%%................%%..........%%................%%..........%%........
m .........%%.........%%.................%%.........%%.................%%.........%%........
m .%%.......%%.......%%%.........%%.......%%.......%%%.........%%.......%%.......%%%........
m %%.........%%......%%%........%%.........%%......%%%........%%.........%%......%%%........
m %%..........%........%%.......%%..........%........%%.......%%..........%........%%.......
m %%............................%%............................%%............................
m %%............................%%............................%%............................
m .%.............................%.............................%............................
m .%.............................%.............................%............................
m .%.............................%.............................%............................
m .%.............................%.............................%............................
m .%%.......%%...................%%.......%%...................%%.......%%..................
m .%%...%%%%%%%..................%%...%%%%%%%..................%%...%%%%%%%.................
m .%%%%%%%%...%%.......%%........%%%%%%%%...%%.......%%........%%%%%%%%...%%.......%%.......
m %%%%%........%%.......%%..%%%%%%%%%........%%.......%%..%%%%%%%%%........%%.......%%..%%%%
m .%%...........%........%%%%%%..%%...........%........%%%%%%..%%...........%........%%%%%%.
m ..%%............................%%............................%%..........................
m ..%%............................%%............................%%..........................
m ...%.............................%.............................%..........................
m ...%.............................%.............................%..........................
m ...%%.......%%...................%%.......%%...................%%.......%%................
m ...%%......%%%.........%.........%%......%%%.........%.........%%......%%%.........%......
m ..%%.....%%%...........%%.......%%.....%%%...........%%.......%%.....%%%...........%%.....
m .%%......%%.............%%%....%%......%%.............%%%....%%......%%.............%%%...
m %%.......%%.......%%.....%%%..%%.......%%.......%%.....%%%..%%.......%%.......%%.....%%%..
m %........%%.......%%.......%%%%........%%.......%%.......%%%%........%%.......%%.......%%%
m %........%%.......%%........%%%........%%.......%%........%%%........%%.......%%........%%
m .........%%.......%%...1.....%.........%%.......%%...2.....%.........%%.......%%...0.....%
m %........%%.......%%.........%%........%%.......%%.........%%........%%.......%%.........%
m %%%......%%.......%%..........%%%......%%.......%%..........%%%......%%.......%%..........
m .%%%%....%%.......%%...........%%%%....%%.......%%...........%%%%....%%.......%%..........
m ...%%%...%%.......%%%............%%%...%%.......%%%............%%%...%%.......%%%.........
m .....%%%%%%........%%%.............%%%%%%........%%%.............%%%%%%........%%%........
m .....%%%%.%..........%%%%..........%%%%.%..........%%%%..........%%%%.%..........%%%%.....
m .....%%...............%%%%.........%%...............%%%%.........%%...............%%%%....
m ....%%..................%%%.......%%..................%%%.......%%..................%%%...
m ...%%...........0........%%%.....%%...........1........%%%.....%%...........2........%%%..
m ...%%.....................%%%....%%.....................%%%....%%.....................%%%.
