# map type: cell maze
# random seed: -19088080
# players 5
# area 13956, 2791 (52.8^2) per player
# cell width: 4.41343415862
# cell size: 20.0
# openness: 0.298358593509
# maze type growing
# horz shear step: 1
# horz_shear
# final parameters
# area: 13175
# grid size: (1, 5)
# tile size: (155, 17) 0.109677419355
# map size: (155, 85) 0.548387096774
# hill distance  42, 85  59,116   8, 23  71,123  54, 92   3,154  25, 54  20, 30  76,147  37, 61
#        42, 85       0      94     142      89      19     137      94     123     142      75 
#        59,116      94       0     142      19      75      89     142     137      94     123 
#         8, 23     142     142       0     123     137      75      94      19      94      89 
#        71,123      89      19     123       0      70      70     137     118      75     118 
#        54, 92      19      75     137      70       0     118      89     118     123      70 
#         3,154     137      89      75      70     118       0     123      70      19     118 
#        25, 54      94     142      94     137      89     123       0      75     142      19 
#        20, 30     123     137      19     118     118      70      75       0      89      70 
#        76,147     142      94      94      75     123      19     142      89       0     137 
#        37, 61      75     123      89     118      70     118      19      70     137       0 
players 5
rows 85
cols 155
m ......................%%%%%%%%%%%%%%%%%%%%...........%%%%%%%%%%....................%%%%%%............................................%%%%%.................
m .....................%%%%%%%%%%%%%%%%%%%%%%............%%%%%%.......................%%%%%............................................%%%%%.................
m ...................%%%%%%%%%%%%%%%%%%%%%%%%.............%%%%........................%%%%%.............................................%%%%%................
m ................%%%%%%%%%%%%%%%%%%%..%%%%%..........................................%%%%%.............................................%%%%%...............4
m ..........%%%%%%%%%%%%%%%%..........%%%%%%..........................................%%%%%.............................................%%%%%%...............
m .........%%%%%%%%%%%%%%.............%%%%%...........................................%%%%%...................%%%........................%%%%%%..............
m .........%%%%%%%%%%%%...............%%%%%...........................................%%%%%..................%%%%........................%%%%%%..............
m .........%%%%%%%%%%%................%%%%%...........................................%%%%.................%%%%%%%........................%%%%%%%............
m .........%%%%%%%%%%....0...........%%%%%............................................%%%%..............%%%%%%%%%%%........................%%%%%%............
m ........%%%%%%%%%%.................%%%%%....................%%%....................%%%%%...........%%%%%%%%%%%%%%%........................%%%%%............
m ........%%%%%%%%%..................%%%%....................%%%%%...................%%%%%.....%%%%%%%%%%%%%%%%%%%%%%........................%%%%%...........
m ........%%%%%%%%....................%%%...................%%%%%%%..................%%%%%%%%%%%%%%%%%%%%%%%%%%%%%%%%........................%%%%%...........
m ........%%%%%%%%....................%%%..................%%%%%%%%%.................%%%%%%%%%%%%%%%%%%%%%%.....%%%%%%........................%%%%...........
m .......%%%%%%%%..........................................%%%%%%%%%%%...............%%%%%%%%%%%%%%%%%%%.........%%%%%%........................%%%...........
m .......%%%%%%%..........................................%%%%%%%%%%%%%..............%%%%%%%%%%%%%%%%.............%%%%%%%....................................
m ........%%%%%..........................................%%%%%%%%%%%%%%%............%%%%%%%%%%%%%%%................%%%%%%%...................................
m ........%%%%%.........................................%%%%%%%%%%%%%%%%%%..........%%%%%%%%%%%%%%..................%%%%%%...................................
m .........%%%%%.......................................%%%%%%%%%%%%%%%%%%%%...........%%%%%%%%%%....................%%%%%%...................................
m .........%%%%%......................................%%%%%%%%%%%%%%%%%%%%%%............%%%%%%.......................%%%%%...................................
m ..........%%%%%...................................%%%%%%%%%%%%%%%%%%%%%%%%.............%%%%........................%%%%%...................................
m ..........%%%%%...............0................%%%%%%%%%%%%%%%%%%%..%%%%%..........................................%%%%%...................................
m ..........%%%%%%.........................%%%%%%%%%%%%%%%%..........%%%%%%..........................................%%%%%...................................
m ...........%%%%%%.......................%%%%%%%%%%%%%%.............%%%%%...........................................%%%%%...................%%%.............
m ...........%%%%%%.......................%%%%%%%%%%%%...............%%%%%...........................................%%%%%..................%%%%.............
m ............%%%%%%%.....................%%%%%%%%%%%................%%%%%...........................................%%%%.................%%%%%%%............
m .............%%%%%%.....................%%%%%%%%%%....1...........%%%%%............................................%%%%..............%%%%%%%%%%%...........
m ..............%%%%%....................%%%%%%%%%%.................%%%%%....................%%%....................%%%%%...........%%%%%%%%%%%%%%%..........
m ...............%%%%%...................%%%%%%%%%..................%%%%....................%%%%%...................%%%%%.....%%%%%%%%%%%%%%%%%%%%%%.........
m ...............%%%%%...................%%%%%%%%....................%%%...................%%%%%%%..................%%%%%%%%%%%%%%%%%%%%%%%%%%%%%%%%.........
m ................%%%%...................%%%%%%%%....................%%%..................%%%%%%%%%.................%%%%%%%%%%%%%%%%%%%%%%.....%%%%%%........
m .................%%%..................%%%%%%%%..........................................%%%%%%%%%%%...............%%%%%%%%%%%%%%%%%%%.........%%%%%%.......
m ......................................%%%%%%%..........................................%%%%%%%%%%%%%..............%%%%%%%%%%%%%%%%.............%%%%%%%.....
m .......................................%%%%%..........................................%%%%%%%%%%%%%%%............%%%%%%%%%%%%%%%................%%%%%%%....
m .......................................%%%%%.........................................%%%%%%%%%%%%%%%%%%..........%%%%%%%%%%%%%%..................%%%%%%....
m ........................................%%%%%.......................................%%%%%%%%%%%%%%%%%%%%...........%%%%%%%%%%....................%%%%%%....
m ........................................%%%%%......................................%%%%%%%%%%%%%%%%%%%%%%............%%%%%%.......................%%%%%....
m .........................................%%%%%...................................%%%%%%%%%%%%%%%%%%%%%%%%.............%%%%........................%%%%%....
m .........................................%%%%%...............1................%%%%%%%%%%%%%%%%%%%..%%%%%..........................................%%%%%....
m .........................................%%%%%%.........................%%%%%%%%%%%%%%%%..........%%%%%%..........................................%%%%%....
m ...............%%%........................%%%%%%.......................%%%%%%%%%%%%%%.............%%%%%...........................................%%%%%....
m ..............%%%%........................%%%%%%.......................%%%%%%%%%%%%...............%%%%%...........................................%%%%%....
m ............%%%%%%%........................%%%%%%%.....................%%%%%%%%%%%................%%%%%...........................................%%%%.....
m .........%%%%%%%%%%%........................%%%%%%.....................%%%%%%%%%%....2...........%%%%%............................................%%%%.....
m ......%%%%%%%%%%%%%%%........................%%%%%....................%%%%%%%%%%.................%%%%%....................%%%....................%%%%%.....
m %%%%%%%%%%%%%%%%%%%%%%........................%%%%%...................%%%%%%%%%..................%%%%....................%%%%%...................%%%%%.....
m %%%%%%%%%%%%%%%%%%%%%%........................%%%%%...................%%%%%%%%....................%%%...................%%%%%%%..................%%%%%%%%%%
m %%%%%%%%%%%%.....%%%%%%........................%%%%...................%%%%%%%%....................%%%..................%%%%%%%%%.................%%%%%%%%%%
m %%%%%%%%%.........%%%%%%........................%%%..................%%%%%%%%..........................................%%%%%%%%%%%...............%%%%%%%%%%
m %%%%%%.............%%%%%%%...........................................%%%%%%%..........................................%%%%%%%%%%%%%..............%%%%%%%%%%
m %%%%................%%%%%%%...........................................%%%%%..........................................%%%%%%%%%%%%%%%............%%%%%%%%%%%
m %%%..................%%%%%%...........................................%%%%%.........................................%%%%%%%%%%%%%%%%%%..........%%%%%%%%%%%
m %....................%%%%%%............................................%%%%%.......................................%%%%%%%%%%%%%%%%%%%%...........%%%%%%%%%
m ......................%%%%%............................................%%%%%......................................%%%%%%%%%%%%%%%%%%%%%%............%%%%%%.
m ......................%%%%%.............................................%%%%%...................................%%%%%%%%%%%%%%%%%%%%%%%%.............%%%%..
m ......................%%%%%.............................................%%%%%...............2................%%%%%%%%%%%%%%%%%%%..%%%%%....................
m ......................%%%%%.............................................%%%%%%.........................%%%%%%%%%%%%%%%%..........%%%%%%....................
m ......................%%%%%...................%%%........................%%%%%%.......................%%%%%%%%%%%%%%.............%%%%%.....................
m ......................%%%%%..................%%%%........................%%%%%%.......................%%%%%%%%%%%%...............%%%%%.....................
m ......................%%%%.................%%%%%%%........................%%%%%%%.....................%%%%%%%%%%%................%%%%%.....................
m ......................%%%%..............%%%%%%%%%%%........................%%%%%%.....................%%%%%%%%%%....3...........%%%%%......................
m %....................%%%%%...........%%%%%%%%%%%%%%%........................%%%%%....................%%%%%%%%%%.................%%%%%....................%%
m %%...................%%%%%.....%%%%%%%%%%%%%%%%%%%%%%........................%%%%%...................%%%%%%%%%..................%%%%....................%%%
m %%%..................%%%%%%%%%%%%%%%%%%%%%%%%%%%%%%%%........................%%%%%...................%%%%%%%%....................%%%...................%%%%
m %%%%.................%%%%%%%%%%%%%%%%%%%%%%.....%%%%%%........................%%%%...................%%%%%%%%....................%%%..................%%%%%
m %%%%%%...............%%%%%%%%%%%%%%%%%%%.........%%%%%%........................%%%..................%%%%%%%%..........................................%%%%%
m %%%%%%%..............%%%%%%%%%%%%%%%%.............%%%%%%%...........................................%%%%%%%..........................................%%%%%%
m %%%%%%%%............%%%%%%%%%%%%%%%................%%%%%%%...........................................%%%%%..........................................%%%%%%%
m %%%%%%%%%%..........%%%%%%%%%%%%%%..................%%%%%%...........................................%%%%%.........................................%%%%%%%%
m %%%%%%%%%%%...........%%%%%%%%%%....................%%%%%%............................................%%%%%.......................................%%%%%%%%%
m %%%%%%%%%%%%............%%%%%%.......................%%%%%............................................%%%%%......................................%%%%%%%%%%
m %%%%%%%%%%%%.............%%%%........................%%%%%.............................................%%%%%...................................%%%%%%%%%%%%
m %%%%..%%%%%..........................................%%%%%.............................................%%%%%...............3................%%%%%%%%%%%%%%%
m .....%%%%%%..........................................%%%%%.............................................%%%%%%.........................%%%%%%%%%%%%%%%%.....
m .....%%%%%...........................................%%%%%...................%%%........................%%%%%%.......................%%%%%%%%%%%%%%........
m .....%%%%%...........................................%%%%%..................%%%%........................%%%%%%.......................%%%%%%%%%%%%..........
m .....%%%%%...........................................%%%%.................%%%%%%%........................%%%%%%%.....................%%%%%%%%%%%...........
m ....%%%%%............................................%%%%..............%%%%%%%%%%%........................%%%%%%.....................%%%%%%%%%%....4.......
m ....%%%%%....................%%%....................%%%%%...........%%%%%%%%%%%%%%%........................%%%%%....................%%%%%%%%%%.............
m ....%%%%....................%%%%%...................%%%%%.....%%%%%%%%%%%%%%%%%%%%%%........................%%%%%...................%%%%%%%%%..............
m .....%%%...................%%%%%%%..................%%%%%%%%%%%%%%%%%%%%%%%%%%%%%%%%........................%%%%%...................%%%%%%%%...............
m .....%%%..................%%%%%%%%%.................%%%%%%%%%%%%%%%%%%%%%%.....%%%%%%........................%%%%...................%%%%%%%%...............
m ..........................%%%%%%%%%%%...............%%%%%%%%%%%%%%%%%%%.........%%%%%%........................%%%..................%%%%%%%%................
m .........................%%%%%%%%%%%%%..............%%%%%%%%%%%%%%%%.............%%%%%%%...........................................%%%%%%%.................
m ........................%%%%%%%%%%%%%%%............%%%%%%%%%%%%%%%................%%%%%%%...........................................%%%%%..................
m .......................%%%%%%%%%%%%%%%%%%..........%%%%%%%%%%%%%%..................%%%%%%...........................................%%%%%..................
