# map type: cell maze
# random seed: 953582776
# players 3
# area 8980, 2993 (54.7^2) per player
# cell width: 1.41869219148
# cell size: 7.7373231931
# openness: 0.0195578409348
# maze type backtrack
# horz shear step: 2
# horz_shear
# final parameters
# area: 8775
# grid size: (1, 3)
# tile size: (45, 65) 1.44444444444
# map size: (45, 195) 4.33333333333
# hill distance  31,102  39,134  24,  4  19, 24   1, 37   4, 89  16,167  43,149   9, 69  13, 84  28, 19  34,154
#        31,102       0      69     147     136      94      50      94      80      61      36     122      94 
#        39,134      69       0     122     147     147     111      61      47     122      97     133      61 
#        24,  4     147     122       0      61      61     147      69      97     122     133      47     111 
#        19, 24     136     147      61       0      50     136      94     122     111     122      14     136 
#         1, 37      94     147      61      50       0      94      94     122      69      80      36     136 
#         4, 89      50     111     147     136      94       0     136     122      61      14     122     136 
#        16,167      94      61      69      94      94     136       0      36     147     122      80      50 
#        43,149      80      47      97     122     122     122      36       0     133     108     108      14 
#         9, 69      61     122     122     111      69      61     147     133       0      47      97     147 
#        13, 84      36      97     133     122      80      14     122     108      47       0     108     122 
#        28, 19     122     133      47      14      36     122      80     108      97     108       0     122 
#        34,154      94      61     111     136     136     136      50      14     147     122     122       0 
players 3
rows 45
cols 195
m ...................%%.%%%........%.................%.......................%..........%....%%%.........%%.......%%............%%%..%%%.......%%%.....................%.........%%%%%%............%%
m ..................%%...%%........%...2.............%.......................%.........%%......%%........%%%......%%..............%%%%%.........%%..........%.........%%%.......%%%.............%%%%.
m .................%%.....%........%................%%.......................%%........%........%.........%%%%%%%%%%%%%%...........%%%...........%.........%%%.......%%%%%%....%%...............%....
m ........%........%......%%.......%................%%......................%%%%.......%........%........%%.....%%%..%%%%%..........%...........%%.......%%%.%%%....%%%...%%%.%%.....................
m .......%%%%.....%%.......%.......%%...............%............%%%.......%%..%%%....%%...1....%........%..........................%...........%%......%%.....%%..%%%......%%%......................
m .....%%%.%%%%%.%%........%%......%%.............%%%..........%%%%%%%%%%%%%.....%%%..%.........%........%.........................%%...........%...............%%%%%........%.......................
m ....%%......%%%%..........%%%%%%%%%.......%%%%%%%%..........%%%..%...............%%%%.........%%......%%......................%%%%%..........%%.................%%.........%.......................
m ....%.........%%..........%%%%%%%%%%%.........%%%.........%%%.....................%%%.........%%......%..................%%%%%%%%%%%.........%.............................%.......................
m ...%%..........%....................%%........%%%........%%%......................%%..........%%.....%%..................%%%%......%%.......%%.............................%.......................
m ...%...........%%....................%.........%%........%%..........1...........%%.........%%%.....%%%.................%%.........%%......%%%.............................%.......................
m ..%%...........%%....................%.........%%........%%.....................%%........%%%......%%.........%.........%%.........%%.....%%%....................%........%%..........%%%%%%%......
m %%%.................................%%.........%%........%%.....................%%........%........%%.........%.........%.........%%......%......................%%%.....%%...........%%%...%%%....
m %.....................%%%...........%%.........%%........%%....................%%..................%%.........%%......%%%.........%...............................%%..................%.......%%%%%
m .....................%%%%%...........%%........%%........%%%.............%%...%%....1...............%..........%%...%%%%.........%%...............................%%.................%%.........%%%
m .....................%%..%%..........%%........%%..........%%%.....%%.....%%%%%%....................%..........%%%%%%%...........%...................%%%%%........%%.................%%............
m ..........%..........%....%%%.........%%.......%%............%%%..%%%.......%%%.....................%.........%%%%%%............%%...................%%.%%%........%.................%.............
m ..........%.........%%......%%........%%%......%%..............%%%%%.........%%..........%.........%%%.......%%%.............%%%%...................%%...%%........%...1.............%.............
m ..........%%........%........%.........%%%%%%%%%%%%%%...........%%%...........%.........%%%.......%%%%%%....%%...............%.....................%%.....%........%................%%.............
m .........%%%%.......%........%........%%.....%%%..%%%%%..........%...........%%.......%%%.%%%....%%%...%%%.%%.............................%........%......%%.......%................%%.............
m %.......%%..%%%....%%...0....%........%..........................%...........%%......%%.....%%..%%%......%%%.............................%%%%.....%%.......%.......%%...............%............%%
m %%%%%%%%%.....%%%..%.........%........%.........................%%...........%...............%%%%%........%............................%%%.%%%%%.%%........%%......%%.............%%%..........%%%%
m %...............%%%%.........%%......%%......................%%%%%..........%%.................%%.........%...........................%%......%%%%..........%%%%%%%%%.......%%%%%%%%..........%%%..
m .................%%%.........%%......%..................%%%%%%%%%%%.........%.............................%...........................%.........%%..........%%%%%%%%%%%.........%%%.........%%%....
m .................%%..........%%.....%%..................%%%%......%%.......%%.............................%..........................%%..........%....................%%........%%%........%%%.....
m ....0...........%%.........%%%.....%%%.................%%.........%%......%%%.............................%..........................%...........%%....................%.........%%........%%......
m ...............%%........%%%......%%.........%.........%%.........%%.....%%%....................%........%%..........%%%%%%%........%%...........%%....................%.........%%........%%......
m ...............%%........%........%%.........%.........%.........%%......%......................%%%.....%%...........%%%...%%%....%%%.................................%%.........%%........%%......
m ..............%%..................%%.........%%......%%%.........%...............................%%..................%.......%%%%%%.....................%%%...........%%.........%%........%%......
m ........%%...%%....0...............%..........%%...%%%%.........%%...............................%%.................%%.........%%%.....................%%%%%...........%%........%%........%%%.....
m ..%%.....%%%%%%....................%..........%%%%%%%...........%...................%%%%%........%%.................%%.................................%%..%%..........%%........%%..........%%%...
m .%%%.......%%%.....................%.........%%%%%%............%%...................%%.%%%........%.................%.......................%..........%....%%%.........%%.......%%............%%%.
m %%%.........%%..........%.........%%%.......%%%.............%%%%...................%%...%%........%...0.............%.......................%.........%%......%%........%%%......%%..............%%
m %%...........%.........%%%.......%%%%%%....%%...............%.....................%%.....%........%................%%.......................%%........%........%.........%%%%%%%%%%%%%%...........%
m %...........%%.......%%%.%%%....%%%...%%%.%%.............................%........%......%%.......%................%%......................%%%%.......%........%........%%.....%%%..%%%%%..........
m %...........%%......%%.....%%..%%%......%%%.............................%%%%.....%%.......%.......%%...............%............%%%.......%%..%%%....%%...2....%........%..........................
m %...........%...............%%%%%........%............................%%%.%%%%%.%%........%%......%%.............%%%..........%%%%%%%%%%%%%.....%%%..%.........%........%.........................%
m %..........%%.................%%.........%...........................%%......%%%%..........%%%%%%%%%.......%%%%%%%%..........%%%..%...............%%%%.........%%......%%......................%%%%
m %%.........%.............................%...........................%.........%%..........%%%%%%%%%%%.........%%%.........%%%.....................%%%.........%%......%..................%%%%%%%%%
m .%%.......%%.............................%..........................%%..........%....................%%........%%%........%%%......................%%..........%%.....%%..................%%%%.....
m .%%......%%%.............................%..........................%...........%%....................%.........%%........%%..........2...........%%.........%%%.....%%%.................%%........
m .%%.....%%%....................%........%%..........%%%%%%%........%%...........%%....................%.........%%........%%.....................%%........%%%......%%.........%.........%%........
m %%......%......................%%%.....%%...........%%%...%%%....%%%.................................%%.........%%........%%.....................%%........%........%%.........%.........%.........
m %...............................%%..................%.......%%%%%%.....................%%%...........%%.........%%........%%....................%%..................%%.........%%......%%%.........
m %...............................%%.................%%.........%%%.....................%%%%%...........%%........%%........%%%.............%%...%%....2...............%..........%%...%%%%.........%
m ...................%%%%%........%%.................%%.................................%%..%%..........%%........%%..........%%%.....%%.....%%%%%%....................%..........%%%%%%%...........%
