# map type: cell maze
# random seed: 1447694643
# players 7
# area 24552, 3507 (59.2^2) per player
# cell width: 1.06261570351
# cell size: 7.46856101022
# openness: 0.844124761726
# maze type backtrack
# horz shear step: 3
# horz_shear
# final parameters
# area: 23324
# grid size: (1, 7)
# tile size: (119, 28) 0.235294117647
# map size: (119, 196) 1.64705882353
# hill distance  87,133  36,105  70,189 104, 77   2, 21  53, 49  19,161
#        87,133       0      79      73      73     118     118      79 
#        36,105      79       0     118      79     118      73      73 
#        70,189      73     118       0     118      79      73      79 
#       104, 77      73      79     118       0      73      79     118 
#         2, 21     118     118      79      73       0      79      73 
#        53, 49     118      73      73      79      79       0     118 
#        19,161      79      73      79     118      73     118       0 
players 7
rows 119
cols 196
m ................%........................%................................%%%.....................%....................%%%......%................................%%..............................%..
m ...............%.......................................................%%%.......................%.......................%%%.....................................................................%..
m ...............%.....0.................................................%.........................%.........................%.....................................................................%..
m ....................................................................................%............%..........%%%%%%%..............................................................%%%%...............
m ........%..........................................%................................%...........%..........%%.......................%%%...%..........................................%..............
m .......%%...........................................%%%......%%.....................%......................%...............................%.........................................%%.............
m .......%................%.................%...........%%.......%....................%.....................%%...........................................%%%%%%%%...........%...........%.............
m ......%%...............%%.................%%%..........%........%%..................%.....................%...........................................%%%%%%%%%...........%...........%%............
m ......%...........%%.%%.....................%%.........%.........%%%%%%............%%..............%......%.........%................................%%......................................%......
m .....%%.............%%.................................%...............%............%................................%...%%..........................%%.......................................%.....
m .....%%..........................%.....................%................%%..........%................................%%%%......%%....................%........................................%.....
m ....%%%..........................%%%%%.................%.............................%............................%%%%..............................%%........................................%%....
m .%%%%.%%%............................................................................%..........................%%%................................%%.............%%%%%.......................%.....
m ........%%%%.....................................................................................%............%%%..................................%.................%%%%%...................%%.....
m ...............................................................................................%%............%%...................................%......................%%..................%......
m ......................%........................%%............%%................................%.............%....................%.......%......%%........................%%......%........%%......
m ....................%%%%........................%%..........%%%%........%..................................%%............................%.......%..........%...............%%.....%%.......%.......
m ..................%%%.....................%....................%%%......%................................%%..............................%..................%........................%..............
m ...............%%%.......................%.......................%%%.....................................................................%.................%........................................
m ...............%.........................%.........................%.....................................................................%.................%.....5..................................
m ............................%............%..........%%%%%%%..............................................................%%%%.......................................................................
m ............................%...........%..........%%.......................%%%...%..........................................%......................%..........................................%....
m .....%%.....................%......................%...............................%.........................................%%....................%%...........................................%%%.
m .......%....................%.....................%%...........................................%%%%%%%%...........%...........%....................%................%.................%...........%%
m ........%%..................%.....................%...........................................%%%%%%%%%...........%...........%%..................%%...............%%.................%%%..........%
m .........%%%%%%............%%..............%......%.........%................................%%......................................%............%...........%%.%%.....................%%.........%
m ...............%............%................................%...%%..........................%%.......................................%..........%%.............%%.................................%
m ................%%..........%................................%%%%......%%....................%........................................%..........%%..........................%.....................%
m .............................%............................%%%%..............................%%........................................%%........%%%..........................%%%%%.................%
m .............................%..........................%%%................................%%.............%%%%%.......................%......%%%%.%%%...............................................
m .........................................%............%%%..................................%.................%%%%%...................%%.............%%%%............................................
m .......................................%%............%%...................................%......................%%..................%..............................................................
m .....%%................................%.............%....................%.......%......%%........................%%......%........%%............................%........................%%.......
m ....%%%%........%..................................%%............................%.......%..........%...............%%.....%%.......%...........................%%%%........................%%......
m .......%%%......%................................%%..............................%..................%........................%................................%%%.....................%.............
m .........%%%.....................................................................%.................%.......................................................%%%.......................%..............
m ...........%.....................................................................%.................%.....3.................................................%.........................%..............
m %%%..............................................................%%%%...................................................................................................%............%..........%%%%
m ....................%%%...%..........................................%......................%..........................................%................................%...........%..........%%...
m ...........................%.........................................%%....................%%...........................................%%%......%%.....................%......................%....
m .......................................%%%%%%%%...........%...........%....................%................%.................%...........%%.......%....................%.....................%%....
m ......................................%%%%%%%%%...........%...........%%..................%%...............%%.................%%%..........%........%%..................%.....................%.....
m ....%................................%%......................................%............%...........%%.%%.....................%%.........%.........%%%%%%............%%..............%......%.....
m .....%...%%..........................%%.......................................%..........%%.............%%.................................%...............%............%...........................
m .....%%%%......%%....................%........................................%..........%%..........................%.....................%................%%..........%...........................
m ..%%%%..............................%%........................................%%........%%%..........................%%%%%.................%.............................%..........................
m %%%................................%%.............%%%%%.......................%......%%%%.%%%............................................................................%..........................
m %..................................%.................%%%%%...................%%.............%%%%.....................................................................................%............%%
m ..................................%......................%%..................%.....................................................................................................%%............%%.
m ..................%.......%......%%........................%%......%........%%............................%........................%%............%%................................%.............%..
m .........................%.......%..........%...............%%.....%%.......%...........................%%%%........................%%..........%%%%........%..................................%%...
m .........................%..................%........................%................................%%%.....................%....................%%%......%................................%%.....
m .........................%.................%.......................................................%%%.......................%.......................%%%............................................
m .........................%.................%.....1.................................................%.........................%.........................%............................................
m .........%%%%...................................................................................................%............%..........%%%%%%%.....................................................
m .............%......................%..........................................%................................%...........%..........%%.......................%%%...%.............................
m .............%%....................%%...........................................%%%......%%.....................%......................%...............................%............................
m ..%...........%....................%................%.................%...........%%.......%....................%.....................%%...........................................%%%%%%%%.........
m ..%...........%%..................%%...............%%.................%%%..........%........%%..................%.....................%...........................................%%%%%%%%%.........
m .....................%............%...........%%.%%.....................%%.........%.........%%%%%%............%%..............%......%.........%................................%%.................
m ......................%..........%%.............%%.................................%...............%............%................................%...%%..........................%%.................
m ......................%..........%%..........................%.....................%................%%..........%................................%%%%......%%....................%..................
m ......................%%........%%%..........................%%%%%.................%.............................%............................%%%%..............................%%..................
m ......................%......%%%%.%%%............................................................................%..........................%%%................................%%.............%%%%%.
m %%...................%%.............%%%%.....................................................................................%............%%%..................................%.................%%%
m .%%..................%.....................................................................................................%%............%%...................................%.....................
m ...%%......%........%%............................%........................%%............%%................................%.............%....................%.......%......%%.....................
m ....%%.....%%.......%...........................%%%%........................%%..........%%%%........%..................................%%............................%.......%..........%...........
m .............%................................%%%.....................%....................%%%......%................................%%..............................%..................%...........
m ...........................................%%%.......................%.......................%%%.....................................................................%.................%............
m ...........................................%.........................%.........................%.....................................................................%.................%.....6......
m ........................................................%............%..........%%%%%%%..............................................................%%%%...........................................
m .......................%................................%...........%..........%%.......................%%%...%..........................................%......................%...................
m ........................%%%......%%.....................%......................%...............................%.........................................%%....................%%...................
m ..............%...........%%.......%....................%.....................%%...........................................%%%%%%%%...........%...........%....................%................%...
m ..............%%%..........%........%%..................%.....................%...........................................%%%%%%%%%...........%...........%%..................%%...............%%...
m ................%%.........%.........%%%%%%............%%..............%......%.........%................................%%......................................%............%...........%%.%%.....
m ...........................%...............%............%................................%...%%..........................%%.......................................%..........%%.............%%......
m .....%.....................%................%%..........%................................%%%%......%%....................%........................................%..........%%.....................
m .....%%%%%.................%.............................%............................%%%%..............................%%........................................%%........%%%.....................
m .........................................................%..........................%%%................................%%.............%%%%%.......................%......%%%%.%%%...................
m .....................................................................%............%%%..................................%.................%%%%%...................%%.............%%%%................
m ...................................................................%%............%%...................................%......................%%..................%..................................
m ...................%%............%%................................%.............%....................%.......%......%%........................%%......%........%%............................%.....
m ....................%%..........%%%%........%..................................%%............................%.......%..........%...............%%.....%%.......%...........................%%%%....
m ..............%....................%%%......%................................%%..............................%..................%........................%................................%%%.......
m .............%.......................%%%.....................................................................%.................%.......................................................%%%..........
m .............%.........................%.....................................................................%.................%.....4.................................................%............
m %............%..........%%%%%%%..............................................................%%%%...................................................................................................
m %...........%..........%%.......................%%%...%..........................................%......................%..........................................%................................
m %......................%...............................%.........................................%%....................%%...........................................%%%......%%.....................
m %.....................%%...........................................%%%%%%%%...........%...........%....................%................%.................%...........%%.......%....................
m %.....................%...........................................%%%%%%%%%...........%...........%%..................%%...............%%.................%%%..........%........%%..................
m %..............%......%.........%................................%%......................................%............%...........%%.%%.....................%%.........%.........%%%%%%............%
m %................................%...%%..........................%%.......................................%..........%%.............%%.................................%...............%............
m %................................%%%%......%%....................%........................................%..........%%..........................%.....................%................%%..........
m .%............................%%%%..............................%%........................................%%........%%%..........................%%%%%.................%............................
m .%..........................%%%................................%%.............%%%%%.......................%......%%%%.%%%...........................................................................
m .............%............%%%..................................%.................%%%%%...................%%.............%%%%........................................................................
m ...........%%............%%...................................%......................%%..................%..........................................................................................
m ...........%.............%....................%.......%......%%........................%%......%........%%............................%........................%%............%%.....................
m .......................%%............................%.......%..........%...............%%.....%%.......%...........................%%%%........................%%..........%%%%........%...........
m .....................%%..............................%..................%........................%................................%%%.....................%....................%%%......%...........
m .....................................................%.................%.......................................................%%%.......................%.......................%%%................
m .....................................................%.................%.....2.................................................%.........................%.........................%................
m .....................................%%%%...................................................................................................%............%..........%%%%%%%.........................
m .........................................%......................%..........................................%................................%...........%..........%%.......................%%%...%.
m .........................................%%....................%%...........................................%%%......%%.....................%......................%...............................%
m ...........%%%%%%%%...........%...........%....................%................%.................%...........%%.......%....................%.....................%%................................
m ..........%%%%%%%%%...........%...........%%..................%%...............%%.................%%%..........%........%%..................%.....................%.................................
m .........%%......................................%............%...........%%.%%.....................%%.........%.........%%%%%%............%%..............%......%.........%.......................
m .........%%.......................................%..........%%.............%%.................................%...............%............%................................%...%%.................
m .........%........................................%..........%%..........................%.....................%................%%..........%................................%%%%......%%...........
m ........%%........................................%%........%%%..........................%%%%%.................%.............................%............................%%%%......................
m .......%%.............%%%%%.......................%......%%%%.%%%............................................................................%..........................%%%.........................
m .......%.................%%%%%...................%%.............%%%%.....................................................................................%............%%%...........................
m ......%......................%%..................%.....................................................................................................%%............%%.............................
m .....%%........................%%......%........%%............................%........................%%............%%................................%.............%....................%.......%.
m .....%..........%...............%%.....%%.......%...........................%%%%........................%%..........%%%%........%..................................%%............................%..
