# map type: blank
# random seed: -320720646
# hill distance  32,  1  22,116  38, 31   4, 31  38,134  21, 34  55, 34  55,131   4,151  39, 16  15,101  49,101  21, 51  66,  1  14, 73  56,116  55, 51   4,134   5, 16  48, 73  65,173  21,131  31,173  38,151
#        32,  1       0     111      42      70      77      62      56      93     138      22     133     133      79     108     108     113      77     117      86     106     139     101      43      58 
#        22,116     111       0     113     121      34      97     137      48      57     131      22      86      78     113      63      64     132      40     131     117      86      20      84      55 
#        38, 31      42     113       0      38     117      20      24     133     122      20      93     101      37      70      66     121      45     141      48      74     107     133      83      98 
#         4, 31      70     121      38       0     141      24      20     133      98      48     101      93      45      42      74     113      37     117      20      66      83     133     107     122 
#        38,134      77      34     117     141       0     131     131      20      61      97      56      62     112     117      97      40     118      44     137     103      90      24      50      21 
#        21, 34      62      97      20      24     131       0      44     141     112      40      77     117      21      56      50     137      61     131      34      90      97     117     103     118 
#        55, 34      56     137      24      20     131      44       0     117     118      34     117      77      61      62      90      97      21     131      40      50     103     141      97     112 
#        55,131      93      48     133     133      20     141     117       0      45     113      70      42     122     101     107      20      98      24     121      83      74      38      66      37 
#         4,151     138      57     122      98      61     112     118      45       0     132      79      77     133      58     120      55     133      21      78     118      29      37     111      82 
#        39, 16      22     131      20      48      97      40      34     113     132       0     113     111      57      86      86     131      55     137      64      84     117     121      63      78 
#        15,101     133      22      93     101      56      77     117      70      79     113       0     108      58     133      43      86     138      62     111     139     108      42     106      77 
#        49,101     133      86     101      93      62     117      77      42      77     111     108       0     138     133     139      22      58      56     113      43     106      70     108      79 
#        21, 51      79      78      37      45     112      21      61     122     133      57      58     138       0      77      29     132      82     118      55     111     118      98     120     133 
#        66,  1     108     113      70      42     117      56      62     101      58      86     133     133      77       0     106     111      79      77      22     108      43      93     139     138 
#        14, 73     108      63      66      74      97      50      90     107     120      86      43     139      29     106       0     117     111     103      84     140     147      83     147     118 
#        56,116     113      64     121     113      40     137      97      20      55     131      86      22     132     111     117       0      78      34     131      63      84      48      86      57 
#        55, 51      77     132      45      37     118      61      21      98     133      55     138      58      82      79     111      78       0     112      57      29     120     122     118     133 
#         4,134     117      40     141     117      44     131     131      24      21     137      62      56     118      77     103      34     112       0      97      97      50      20      90      61 
#         5, 16      86     131      48      20     137      34      40     121      78      64     111     113      55      22      84     131      57      97       0      86      63     113     117     132 
#        48, 73     106     117      74      66     103      90      50      83     118      84     139      43     111     108     140      63      29      97      86       0     147     107     147     120 
#        65,173     139      86     107      83      90      97     103      74      29     117     108     106     118      43     147      84     120      50      63     147       0      66     140     111 
#        21,131     101      20     133     133      24     117     141      38      37     121      42      70      98      93      83      48     122      20     113     107      66       0      74      45 
#        31,173      43      84      83     107      50     103      97      66     111      63     106     108     120     139     147      86     118      90     117     147     140      74       0      29 
#        38,151      58      55      98     122      21     118     112      37      82      78      77      79     133     138     118      57     133      61     132     120     111      45      29       0 
players 4
rows 68
cols 200
m ...................%%%%..............%%%%%%%%%%.....................%%%%........%%%%.............%%%%%%.............%%%%%%%%%%%...................%%%%...%%%%.......%%%%........%%%................%%...
m ....................%%%%.............%%%%............................%%%........%%%%..............%%%%%.................%%%%%%%%..................%%%.....%%%%%......%%%%......%%%%...............%%%%..
m ........%............%%%%............%%%.............................%%%.........%%%%%%%...........%%%%%..................%%%%%%.................%%%.......%%%%.......%%%.....%%%%...........%....%%%%%.
m %%%%%%%%%.............%%%............%%%.............................%%%%.......%%%%%%%%............%%%%....................%%%%...........%%%%%%%%%........%%%........%%.....%%%..........%%%.....%%%%%
m %%%%%%%%%%............%%%%.....2.....%%%..................%%..........%%%.....%%%%%%%%%%%............%%%.....................%%%......0...%%%%%%%%%....0........................%..........%%%.......%%%
m %%%%%%%%%%......1......%%%..........%%%%................%%%%..........%%%....%%%%%....%%%...........%%%%%.....................%%%..........%%%%%%%%........................................%%%........%%
m .......%%%.............%%%..........%%%...............%%%%%%%.........%%%%%%%%%%%.....%%%..........%%%%%%%%%%%%%%%............%%%.........................................................%%%...........
m .......%%%..........................%%%.............%%%%%%%%%%.........%%%%%%%%........%%%%.......%%%%%%%%%%%%%%%%%...........%%%.........................................................%%%%..........
m ........%%%.........................%%%............%%%%%%.%%%%%........%%%%%%%.........%%%%%%%...%%%%%%.%%%%%%%%%%%%..............................................................%%%.....%%%%..........
m ........%%%%%.......................%%%...........%%%%%.....%%%%...........%%.........%%%%%%%%%%%%%%%.....%.....%%%%%............................................................%%%%......%%%..........
m ........%%%%%%%....................%%%%...........%%%........%%%%%....................%%%%%%%%%%%%%...............%%%%%..............%%.............%%%%%%%%%....................%%%........%%%.........
m ..........%%%%%%%................%%%%%...........%%%..........%%%%%%.................%%%%....%%%%%.................%%%%%.............%%%............%%%%%%%%%%..................%%%%........%%%.........
m ............%%%%%%............%%%%%%%...........%%%%%..........%%%%%................%%%%.......%%...................%%%%............%%%%...........%%%%%%%%%%%%%.....%%.........%%%%.........%%%........
m ..............%%%%............%%%%%%............%%%%%...........%%%%..........%%%%.%%%%..............................%%%.............%%%%.........%%%%......%%%%%%%%%%%%%........%%%%........%%%%%......
m ...............%%%%...........%%%..............%%%%%%%..........%%%......0....%%%%%%%%%...............................%%%............%%%%%.......%%%%........%%%%%%%%%%%%%%......%%%%........%%%%%%%%%..
m ................%%%%%..........................%%%%%%%%.........%%%..........%%%%%%%%%...............1................%%%..............%%%%%%%%%%%%%..........%%%%%%%%%%%%%.......%%%%........%%%%%%%%%.
m %...............%%%%%%%........................%%%%%%%%%........%%%%........%%%%..%%%%................................%%%%..............%%%%%%%%%%%............%%%.....%%%%........%%%%...........%%%%%%
m %%%.............%%%%%%%%%%%...................%%%%...%%%%.......%%%%........%%%................%%......................%%%%..............%%%%%%%%%%.....................%%%%........%%%%.............%%%
m %%%.................%%%%%%%%..................%%%.....%%%%%......%%%%......%%%%...............%%%%......................%%%%.............%%%%............................%%%........%%%%..............%%
m %%%%..................%%%%%%.................%%%.......%%%%.......%%%.....%%%%...........%....%%%%%.........%............%%%%............%%%.............................%%%.........%%%%%%%...........%
m %%%%....................%%%%...........%%%%%%%%%........%%%........%%.....%%%..........%%%.....%%%%%%%%%%%%%%.............%%%............%%%.............................%%%%.......%%%%%%%%............
m .%%%.....................%%%......2...%%%%%%%%%....2........................%..........%%%.......%%%%%%%%%%%%%............%%%%.....1.....%%%..................%%..........%%%.....%%%%%%%%%%%...........
m %%%%%.....................%%%..........%%%%%%%%........................................%%%........%%%%%%%%%%%%......3......%%%..........%%%%................%%%%..........%%%....%%%%%....%%%...........
m %%%%%%%%%%%%%%............%%%.........................................................%%%..................%%%.............%%%..........%%%...............%%%%%%%.........%%%%%%%%%%%.....%%%..........%
m %%%%%%%%%%%%%%%...........%%%.........................................................%%%%.................%%%..........................%%%.............%%%%%%%%%%.........%%%%%%%%........%%%%.......%%
m %%%.%%%%%%%%%%%%..............................................................%%%.....%%%%..................%%%.........................%%%............%%%%%%.%%%%%........%%%%%%%.........%%%%%%%...%%%
m %.....%.....%%%%%............................................................%%%%......%%%..................%%%%%.......................%%%...........%%%%%.....%%%%...........%%.........%%%%%%%%%%%%%%
m ..............%%%%%..............%%.............%%%%%%%%%....................%%%........%%%.................%%%%%%%....................%%%%...........%%%........%%%%%....................%%%%%%%%%%%%%.
m ...............%%%%%.............%%%............%%%%%%%%%%..................%%%%........%%%...................%%%%%%%................%%%%%...........%%%..........%%%%%%.................%%%%....%%%%%..
m ................%%%%............%%%%...........%%%%%%%%%%%%%.....%%.........%%%%.........%%%....................%%%%%%............%%%%%%%...........%%%%%..........%%%%%................%%%%.......%%...
m .................%%%.............%%%%.........%%%%......%%%%%%%%%%%%%........%%%%........%%%%%....................%%%%............%%%%%%............%%%%%...........%%%%..........%%%%.%%%%.............
m ..................%%%............%%%%%.......%%%%........%%%%%%%%%%%%%%......%%%%........%%%%%%%%%.................%%%%...........%%%..............%%%%%%%..........%%%......2....%%%%%%%%%.............
m .3................%%%..............%%%%%%%%%%%%%..........%%%%%%%%%%%%%.......%%%%........%%%%%%%%%.................%%%%%..........................%%%%%%%%.........%%%..........%%%%%%%%%..............
m ..................%%%%..............%%%%%%%%%%%............%%%.....%%%%........%%%%...........%%%%%%%...............%%%%%%%........................%%%%%%%%%........%%%%........%%%%..%%%%..............
m ...................%%%%..............%%%%%%%%%%.....................%%%%........%%%%.............%%%%%%.............%%%%%%%%%%%...................%%%%...%%%%.......%%%%........%%%................%%...
m ....................%%%%.............%%%%............................%%%........%%%%..............%%%%%.................%%%%%%%%..................%%%.....%%%%%......%%%%......%%%%...............%%%%..
m ........%............%%%%............%%%.............................%%%.........%%%%%%%...........%%%%%..................%%%%%%.................%%%.......%%%%.......%%%.....%%%%...........%....%%%%%.
m %%%%%%%%%.............%%%............%%%.............................%%%%.......%%%%%%%%............%%%%....................%%%%...........%%%%%%%%%........%%%........%%.....%%%..........%%%.....%%%%%
m %%%%%%%%%%............%%%%.....3.....%%%..................%%..........%%%.....%%%%%%%%%%%............%%%.....................%%%......1...%%%%%%%%%....1........................%..........%%%.......%%%
m %%%%%%%%%%......0......%%%..........%%%%................%%%%..........%%%....%%%%%....%%%...........%%%%%.....................%%%..........%%%%%%%%........................................%%%........%%
m .......%%%.............%%%..........%%%...............%%%%%%%.........%%%%%%%%%%%.....%%%..........%%%%%%%%%%%%%%%............%%%.........................................................%%%...........
m .......%%%..........................%%%.............%%%%%%%%%%.........%%%%%%%%........%%%%.......%%%%%%%%%%%%%%%%%...........%%%.........................................................%%%%..........
m ........%%%.........................%%%............%%%%%%.%%%%%........%%%%%%%.........%%%%%%%...%%%%%%.%%%%%%%%%%%%..............................................................%%%.....%%%%..........
m ........%%%%%.......................%%%...........%%%%%.....%%%%...........%%.........%%%%%%%%%%%%%%%.....%.....%%%%%............................................................%%%%......%%%..........
m ........%%%%%%%....................%%%%...........%%%........%%%%%....................%%%%%%%%%%%%%...............%%%%%..............%%.............%%%%%%%%%....................%%%........%%%.........
m ..........%%%%%%%................%%%%%...........%%%..........%%%%%%.................%%%%....%%%%%.................%%%%%.............%%%............%%%%%%%%%%..................%%%%........%%%.........
m ............%%%%%%............%%%%%%%...........%%%%%..........%%%%%................%%%%.......%%...................%%%%............%%%%...........%%%%%%%%%%%%%.....%%.........%%%%.........%%%........
m ..............%%%%............%%%%%%............%%%%%...........%%%%..........%%%%.%%%%..............................%%%.............%%%%.........%%%%......%%%%%%%%%%%%%........%%%%........%%%%%......
m ...............%%%%...........%%%..............%%%%%%%..........%%%......1....%%%%%%%%%...............................%%%............%%%%%.......%%%%........%%%%%%%%%%%%%%......%%%%........%%%%%%%%%..
m ................%%%%%..........................%%%%%%%%.........%%%..........%%%%%%%%%...............0................%%%..............%%%%%%%%%%%%%..........%%%%%%%%%%%%%.......%%%%........%%%%%%%%%.
m %...............%%%%%%%........................%%%%%%%%%........%%%%........%%%%..%%%%................................%%%%..............%%%%%%%%%%%............%%%.....%%%%........%%%%...........%%%%%%
m %%%.............%%%%%%%%%%%...................%%%%...%%%%.......%%%%........%%%................%%......................%%%%..............%%%%%%%%%%.....................%%%%........%%%%.............%%%
m %%%.................%%%%%%%%..................%%%.....%%%%%......%%%%......%%%%...............%%%%......................%%%%.............%%%%............................%%%........%%%%..............%%
m %%%%..................%%%%%%.................%%%.......%%%%.......%%%.....%%%%...........%....%%%%%.........%............%%%%............%%%.............................%%%.........%%%%%%%...........%
m %%%%....................%%%%...........%%%%%%%%%........%%%........%%.....%%%..........%%%.....%%%%%%%%%%%%%%.............%%%............%%%.............................%%%%.......%%%%%%%%............
m .%%%.....................%%%......3...%%%%%%%%%....3........................%..........%%%.......%%%%%%%%%%%%%............%%%%.....0.....%%%..................%%..........%%%.....%%%%%%%%%%%...........
m %%%%%.....................%%%..........%%%%%%%%........................................%%%........%%%%%%%%%%%%......2......%%%..........%%%%................%%%%..........%%%....%%%%%....%%%...........
m %%%%%%%%%%%%%%............%%%.........................................................%%%..................%%%.............%%%..........%%%...............%%%%%%%.........%%%%%%%%%%%.....%%%..........%
m %%%%%%%%%%%%%%%...........%%%.........................................................%%%%.................%%%..........................%%%.............%%%%%%%%%%.........%%%%%%%%........%%%%.......%%
m %%%.%%%%%%%%%%%%..............................................................%%%.....%%%%..................%%%.........................%%%............%%%%%%.%%%%%........%%%%%%%.........%%%%%%%...%%%
m %.....%.....%%%%%............................................................%%%%......%%%..................%%%%%.......................%%%...........%%%%%.....%%%%...........%%.........%%%%%%%%%%%%%%
m ..............%%%%%..............%%.............%%%%%%%%%....................%%%........%%%.................%%%%%%%....................%%%%...........%%%........%%%%%....................%%%%%%%%%%%%%.
m ...............%%%%%.............%%%............%%%%%%%%%%..................%%%%........%%%...................%%%%%%%................%%%%%...........%%%..........%%%%%%.................%%%%....%%%%%..
m ................%%%%............%%%%...........%%%%%%%%%%%%%.....%%.........%%%%.........%%%....................%%%%%%............%%%%%%%...........%%%%%..........%%%%%................%%%%.......%%...
m .................%%%.............%%%%.........%%%%......%%%%%%%%%%%%%........%%%%........%%%%%....................%%%%............%%%%%%............%%%%%...........%%%%..........%%%%.%%%%.............
m ..................%%%............%%%%%.......%%%%........%%%%%%%%%%%%%%......%%%%........%%%%%%%%%.................%%%%...........%%%..............%%%%%%%..........%%%......3....%%%%%%%%%.............
m .2................%%%..............%%%%%%%%%%%%%..........%%%%%%%%%%%%%.......%%%%........%%%%%%%%%.................%%%%%..........................%%%%%%%%.........%%%..........%%%%%%%%%..............
m ..................%%%%..............%%%%%%%%%%%............%%%.....%%%%........%%%%...........%%%%%%%...............%%%%%%%........................%%%%%%%%%........%%%%........%%%%..%%%%..............
