# random seed 4329951076657990393
# players 4
# area 10000, 2500 (50.0^2) per player
# cell width: 1.83506299396
# cell size: 7
# openness: 0.15
# grid size: (1, 4)
# tile size: (52, 45) 0.865384615385
# map size: (52, 180) 3.46153846154
# horz_rotate
# horz_copy
# maze type recursive backtracker
# final openness 0.15
# map_type cell_maze
# random_seed 4329951076657990393
players 4
rows 52
cols 180
m ..%%%.......%%........%%......%%.........................%%%......%%..................%%%...%%%.......%%........%%......%%.........................%%%......%%..................%%%.
m ...%%%.....%%%.....1...%%....%%......................%%%%%%........%%..................%%....%%%.....%%%.....2...%%....%%......................%%%%%%........%%..................%%.
m ....%%%..%%%%%%........%%....%%......................%%............%%..................%......%%%..%%%%%%........%%....%%......................%%............%%..................%..
m .....%%%%%%..%%.......%%%.....%%....................%%.............%%%................%%.......%%%%%%..%%.......%%%.....%%....................%%.............%%%................%%..
m ......%%%.....%%......%%......%%............%......%%...............%%%%........................%%%.....%%......%%......%%............%......%%...............%%%%..................
m ......%%.......%%.....%%......%%........%%%%%%%...%%%.......%%........%%........................%%.......%%.....%%......%%........%%%%%%%...%%%.......%%........%%..................
m .....%%........%%......%%......%%......%%%%%%%%...%%........%%........%%..........%............%%........%%......%%......%%......%%%%%%%%...%%........%%........%%..........%.......
m .....%%........%%......%%......%%.....%%%..%%%%...%%%.......%%.........%%........%%............%%........%%......%%......%%.....%%%..%%%%...%%%.......%%.........%%........%%.......
m ...%%%.........%%.......%%...........%%%...%%%%....%%.......%%.........%%.......%%%..........%%%.........%%.......%%...........%%%...%%%%....%%.......%%.........%%.......%%%.......
m ..%%%..........%%.......%%...........%%.....%%%.....%%......%%.........%%.......%%..........%%%..........%%.......%%...........%%.....%%%.....%%......%%.........%%.......%%........
m %%%............%%.......%%%..........%%......%%.....%%......%%.........%%%......%.........%%%............%%.......%%%..........%%......%%.....%%......%%.........%%%......%.........
m %%.............%%.......%%%..........%.......%%......%.......%%........%..................%%.............%%.......%%%..........%.......%%......%.......%%........%..................
m %%.......%%....%%%.......%%..........%.......%%..............%%%..........................%%.......%%....%%%.......%%..........%.......%%..............%%%..........................
m %........%%.....%%.......%%.........%%.......%%...............%%%%%......................%%........%%.....%%.......%%.........%%.......%%...............%%%%%......................%
m %.......%%......%%........%%........%%.......%%%.............%%%%%%......................%%.......%%......%%........%%........%%.......%%%.............%%%%%%......................%
m %%......%%......%%........%%........%%%......%%%%..%%%......%%%..%%.............%%%%.....%%%......%%......%%........%%........%%%......%%%%..%%%......%%%..%%.............%%%%.....%
m %%......%%......%%.........%%........%%%.....%%%%%%%%%%%...%%%...%%...........%%%%%%%.....%%......%%......%%.........%%........%%%.....%%%%%%%%%%%...%%%...%%...........%%%%%%%.....
m .%%..%%%%%......%%.........%%%........%%.......%%%%..%%%%%%%%.....%%.......%%%%%...........%%..%%%%%......%%.........%%%........%%.......%%%%..%%%%%%%%.....%%.......%%%%%..........
m .%%%%%%%%%%.....%%.........%%%........%%...............%%%%%......%%.......%%%.............%%%%%%%%%%.....%%.........%%%........%%...............%%%%%......%%.......%%%............
m ..%%%....%%%....%%..........%%........%%.................%%........%%.....%%................%%%....%%%....%%..........%%........%%.................%%........%%.....%%..............
m ..%.......%%%...%%..........%%........%%...........................%%....%%%................%.......%%%...%%..........%%........%%...........................%%....%%%..............
m ...........%%....%%%%%.......%%.......%%..........................%%.....%%%.........................%%....%%%%%.......%%.......%%..........................%%.....%%%..............
m ..................%%%%%......%%.......%%.........................%%.........................................%%%%%......%%.......%%.........................%%.......................
m .....................%%.......%%......%%..................%%....%%.............................................%%.......%%......%%..................%%....%%........................
m ......................%%......%%......%%..................%%....%%................%%%%..........................%%......%%......%%..................%%....%%................%%%%....
m ......................%%%.....%%%.....%..................%%%.....%%.............%%%%%%%.........................%%%.....%%%.....%..................%%%.....%%.............%%%%%%%...
m ...%%%%%%%.............%%.....%%%..................%.....%%%.....%%%.........................%%%%%%%.............%%.....%%%..................%.....%%%.....%%%......................
m ....%%%%................%%....%%..................%%......%%......%%..........................%%%%................%%....%%..................%%......%%......%%......................
m ........................%%....%%..................%%......%%.......%%.............................................%%....%%..................%%......%%.......%%.....................
m .......................%%.........................%%.......%%......%%%%%.........................................%%.........................%%.......%%......%%%%%..................
m ..............%%%.....%%..........................%%.......%%.......%%%%%....%%.........................%%%.....%%..........................%%.......%%.......%%%%%....%%...........
m ..............%%%....%%...........................%%........%%..........%%...%%%.......%................%%%....%%...........................%%........%%..........%%...%%%.......%..
m ..............%%.....%%........%%.................%%........%%..........%%....%%%....%%%................%%.....%%........%%.................%%........%%..........%%....%%%....%%%..
m ............%%%.......%%......%%%%%...............%%........%%%.........%%.....%%%%%%%%%%.............%%%.......%%......%%%%%...............%%........%%%.........%%.....%%%%%%%%%%.
m ..........%%%%%.......%%.....%%%%%%%%..%%%%.......%%........%%%.........%%......%%%%%..%%...........%%%%%.......%%.....%%%%%%%%..%%%%.......%%........%%%.........%%......%%%%%..%%.
m .....%%%%%%%...........%%...%%%...%%%%%%%%%%%.....%%%........%%.........%%......%%......%%.....%%%%%%%...........%%...%%%...%%%%%%%%%%%.....%%%........%%.........%%......%%......%%
m %.....%%%%.............%%..%%%......%%%..%%%%......%%%........%%........%%......%%......%%%.....%%%%.............%%..%%%......%%%..%%%%......%%%........%%........%%......%%......%%
m %......................%%%%%%.............%%%.......%%........%%........%%......%%.......%%......................%%%%%%.............%%%.......%%........%%........%%......%%.......%
m %......................%%%%%...............%%.......%%.........%%.......%%.....%%........%%......................%%%%%...............%%.......%%.........%%.......%%.....%%........%
m ..........................%%%..............%%.......%..........%%.......%%%....%%.......%%..........................%%%..............%%.......%..........%%.......%%%....%%.......%%
m ..................%........%%.......%......%%.......%..........%%%.......%%.............%%..................%........%%.......%......%%.......%..........%%%.......%%.............%%
m .........%......%%%.........%%......%%.....%%......%%..........%%%.......%%............%%%.........%......%%%.........%%......%%.....%%......%%..........%%%.......%%............%%%
m ........%%.......%%.........%%......%%.....%%%.....%%...........%%.......%%..........%%%..........%%.......%%.........%%......%%.....%%%.....%%...........%%.......%%..........%%%..
m .......%%%.......%%.........%%.......%%....%%%%...%%%...........%%.......%%.........%%%..........%%%.......%%.........%%.......%%....%%%%...%%%...........%%.......%%.........%%%...
m .......%%........%%.........%%.......%%%...%%%%..%%%.....%%......%%......%%........%%............%%........%%.........%%.......%%%...%%%%..%%%.....%%......%%......%%........%%.....
m .......%..........%%........%%........%%...%%%%%%%%......%%......%%......%%........%%............%..........%%........%%........%%...%%%%%%%%......%%......%%......%%........%%.....
m ..................%%........%%.......%%%...%%%%%%%........%%......%%.....%%.......%%........................%%........%%.......%%%...%%%%%%%........%%......%%.....%%.......%%......
m ..................%%%%...............%%......%............%%......%%......%%.....%%%........................%%%%...............%%......%............%%......%%......%%.....%%%......
m ..%%................%%%.............%%....................%%.....%%%.......%%..%%%%%%.......%%................%%%.............%%....................%%.....%%%.......%%..%%%%%%.....
m ..%..................%%............%%......................%%....%%........%%%%%%..%%%......%..................%%............%%......................%%....%%........%%%%%%..%%%....
m .%%..................%%........%%%%%%......................%%....%%...0.....%%%.....%%%....%%..................%%........%%%%%%......................%%....%%...3.....%%%.....%%%...
m .%%%..................%%......%%%.........................%%......%%........%%.......%%%...%%%..................%%......%%%.........................%%......%%........%%.......%%%..
