# map type: cell maze
# random seed: -1835165799
# players 5
# area 7761, 1552 (39.4^2) per player
# cell width: 1.16369916073
# cell size: 8.68349835225
# openness: 0.268721899501
# maze type growing
# horz shear step: 3
# horz_shear
# final parameters
# area: 7000
# grid size: (1, 5)
# tile size: (40, 35) 0.875
# map size: (40, 175) 4.375
# hill distance   9, 10  29,102   1,115  21, 32  33, 45  13,137  17, 80  25,150  37,172   5, 67
#         9, 10       0     114      90      34      59      68      90      59      25      65 
#        29,102     114       0      25      90      65      51      34      68      90      51 
#         1,115      90      25       0     114      90      34      59      59      65      68 
#        21, 32      34      90     114       0      25      90      68      65      51      51 
#        33, 45      59      65      90      25       0     114      59      90      68      34 
#        13,137      68      51      34      90     114       0      65      25      51      90 
#        17, 80      90      34      59      68      59      65       0      90     114      25 
#        25,150      59      68      59      65      90      25      90       0      34     114 
#        37,172      25      90      65      51      68      51     114      34       0      90 
#         5, 67      65      51      68      51      34      90      25     114      90       0 
players 5
rows 40
cols 175
m ........%%%.........................%.......%%%%%............%%.........%..........%%........................%%.........%%%..........%%........................................
m .........%.........................%%.......................%...........%..........%%........................%.....3.....%%..........%.........................................
m .........%%...........%%...........%.....................................%..........%........................%.......................%...................%...........%....%%%%.
m .........%%%..........%%..........%%.....................................%..........%........................%.......................%..............%%%%%%...........%%%%%%%...
m ...........%%........%...................................................%..........%%.......................%......................%%..........%%%%%....%............%%.......
m ............%%......%........%.....................................3......%%.......%%%%%%%%.................%%...........%%.........%%...................%............%........
m .............%%....%.........%.............................................%%....%%......%%%................%%..........%%..........%....................%............%........
m .....%........%%..%.........%%..............................................%%%.%%........................%%%%%%%%....%%%...........%....................%............%........
m ....%%.........%%%..........%%................................................%%%.........................%.......%%%%%............%%.........%..........%%....................
m ....%.....0.....%%..........%..................................................%.........................%%.......................%...........%..........%%....................
m ....%.......................%...................%...........%....%%%%..........%%...........%%...........%.....................................%..........%....................
m ....%.......................%..............%%%%%%...........%%%%%%%............%%%..........%%..........%%.....................................%..........%....................
m ....%......................%%..........%%%%%....%............%%..................%%........%...................................................%..........%%...................
m ...%%...........%%.........%%...................%............%....................%%......%........%.....................................0......%%.......%%%%%%%%..............
m ...%%..........%%..........%....................%............%.....................%%....%.........%.............................................%%....%%......%%%.............
m .%%%%%%%%....%%%...........%....................%............%.............%........%%..%.........%%..............................................%%%.%%.......................
m .%.......%%%%%............%%.........%..........%%........................%%.........%%%..........%%................................................%%%........................
m %%.......................%...........%..........%%........................%.....2.....%%..........%..................................................%.........................
m %.....................................%..........%........................%.......................%...................%...........%....%%%%..........%%...........%%...........
m %.....................................%..........%........................%.......................%..............%%%%%%...........%%%%%%%............%%%..........%%..........%
m ......................................%..........%%.......................%......................%%..........%%%%%....%............%%..................%%........%.............
m ................................2......%%.......%%%%%%%%.................%%...........%%.........%%...................%............%....................%%......%........%.....
m ........................................%%....%%......%%%................%%..........%%..........%....................%............%.....................%%....%.........%.....
m .........................................%%%.%%........................%%%%%%%%....%%%...........%....................%............%.............%........%%..%.........%%.....
m ...........................................%%%.........................%.......%%%%%............%%.........%..........%%........................%%.........%%%..........%%.....
m ............................................%.........................%%.......................%...........%..........%%........................%.....4.....%%..........%......
m .............%...........%....%%%%..........%%...........%%...........%.....................................%..........%........................%.......................%......
m ........%%%%%%...........%%%%%%%............%%%..........%%..........%%.....................................%..........%........................%.......................%......
m ....%%%%%....%............%%..................%%........%...................................................%..........%%.......................%......................%%......
m .............%............%....................%%......%........%.....................................4......%%.......%%%%%%%%.................%%...........%%.........%%......
m .............%............%.....................%%....%.........%.............................................%%....%%......%%%................%%..........%%..........%.......
m .............%............%.............%........%%..%.........%%..............................................%%%.%%........................%%%%%%%%....%%%...........%.......
m ..%..........%%........................%%.........%%%..........%%................................................%%%.........................%.......%%%%%............%%.......
m ..%..........%%........................%.....1.....%%..........%..................................................%.........................%%.......................%.........
m ...%..........%........................%.......................%...................%...........%....%%%%..........%%...........%%...........%..................................
m ...%..........%........................%.......................%..............%%%%%%...........%%%%%%%............%%%..........%%..........%%..................................
m ...%..........%%.......................%......................%%..........%%%%%....%............%%..................%%........%................................................
m ....%%.......%%%%%%%%.................%%...........%%.........%%...................%............%....................%%......%........%.....................................1..
m .....%%....%%......%%%................%%..........%%..........%....................%............%.....................%%....%.........%........................................
m ......%%%.%%........................%%%%%%%%....%%%...........%....................%............%.............%........%%..%.........%%........................................
