# map type: cell maze
# random seed: -504084879
# players 3
# area 14483, 4827 (69.5^2) per player
# cell width: 1.08085357719
# cell size: 7.54254622641
# openness: 0.124868289618
# maze type growing
# horz shear step: 1
# horz_shear
# final parameters
# area: 14364
# grid size: (1, 3)
# tile size: (84, 57) 0.678571428571
# map size: (84, 171) 2.03571428571
# hill distance  52,157  80, 43  24,100
#        52,157       0     149     149 
#        80, 43     149       0     149 
#        24,100     149     149       0 
players 3
rows 84
cols 171
m .......%%........%%%%...............%%%%%%%..................%..........%%.......................%.........%........%.............%%....................%%%........%%......
m .......%%.........%%............%%%%......%%%%...........................%.........%%............%.........%........%%.%%%........%%.............%%%.%%%..........%........
m ........%..........%..............%...........%..........................%...........%%...........%........%........%%%..%%.......%%.........%%%%%.%%%..........%%.........
m .........%.........%..............%%..........%..........................%%............%..........%........%.......%%.....%.......%%........%%.................%%..........
m %........%..........%..............%...........%%%%%%%%%..................%%...........%%%........%........%%.....%%.......%......%%.......%...................%...........
m %.........%..........%.............%..........%%...........................%.............%%%......%........%%....%%........%%..............%..................%............
m ..........%%..........%............%..........%..................%.........%................%%%...%..............%..........%%............%..................%............%
m %..........%..........%............%..........%..................%.........%%.................%%%%%...............%..........%%...........%.................%.............%
m %%.......%%%..........%%...........%.........%%..................%..........%...................%%%%%%%%..........%..........%%%...........%...............%...............
m .%%....%%%.%...........%...........%%............................%..........%........%..........%%.....%...........%........%%.............%.........%....%................
m ...%%%%....%%..........%............%%..........................%%..........%........%%.........%..................%.......%%.......................%......................
m ....%.......%..........%..............%%%................%......%%..........%.........%........%..........................%........................%.................%.....
m ............%%........%%................................%........%%.........%..........%......%%..................................................%..................%.....
m .............%.......%%................................%..........%........%%..........%%.....%.........%%.......................................%%..................%.....
m .............%%.....%%.........%..................%%...%%.........%........%%...........%%...%..........%%.......................................%%.................%%%....
m ...................%%..........%.................%%.....%........%%.........%............%%%%%.........%%...........................%%...........%%................%%%%%%..
m %%.................%...........%................%%......%........%.........%%............%%%%%.........%............................%%...........%.................%%...%%%
m .%%%%..............%...........%...............%%.......%........%........%%%................%%.......%%........%........%%..........%..........%%............%.....%......
m ...%%..............%...........%%.............%%.........%.......%........%%..................%.......%..........%....%%%%%%..........%.......%%%............%......%%.....
m .....%%%...........%............%..........%%%%..........%......%%.......%%....................%....%%%..........%.%%%%.....%%.........%...%%%%.............%........%.....
m ........%...........%..........%%%%%......%%.............%......%.......%%.....................%%%%%.%%..........%%%%........%.........%%%%%................%........%.....
m ........%...........%..........%...%%%%%.%%..............%%.....%......%%........%%%...........%......%%.........%%.....................%..................%%.........%....
m .........%..........%..................%%%..............%%.....%%.....%%.........%%............%.......%%......%%%.........................................%%.........%....
m %........%.........%%%..................%%.............%%.......%%...%%.........%%.............%........%%.%%%%%%%%........................................%..........%%%%%
m %.........%.......%%..%%................%%............%%.........%...%%%.......%%..............%....1....%%%......%..........%.............................%..........%%%%%
m %...............%%......................%%...........%%..........%.....%%......%...............%..................%%.......%%%........................%%%%%..........%%....
m .%..............%%......................%%.........%%%...........%......%%....%...............%%...................%....%%%........................%%%....%.........%%.....
m .%..............%%......................%%........%%.............%.......%%..%%...............%%...................%%%%%%........%........................%.........%......
m ..%.............%%....................%%%........%%.............%%........%%%%...............%%%%%%%..................%..........%%.......................%.........%......
m ..%%.%%%........%%.............%%%.%%%..........%...............%%.........%%............%%%%......%%%%...........................%.........%%............%.........%......
m ..%%%..%%.......%%.........%%%%%.%%%..........%%.................%..........%..............%...........%..........................%...........%%...........%........%......
m .%%.....%.......%%........%%.................%%...................%.........%..............%%..........%..........................%%............%..........%........%......
m %%.......%......%%.......%...................%...........%........%..........%..............%...........%%%%%%%%%..................%%...........%%%........%........%%.....
m %........%%..............%..................%............%.........%..........%.............%..........%%...........................%.............%%%......%........%%....%
m ..........%%............%..................%............%..........%%..........%............%..........%..................%.........%................%%%...%..............%
m %..........%%...........%.................%.............%%..........%..........%............%..........%..................%.........%%.................%%%%%...............
m %..........%%%...........%...............%...............%%.......%%%..........%%...........%.........%%..................%..........%...................%%%%%%%%..........
m .%........%%.............%.........%....%.................%%....%%%.%...........%...........%%............................%..........%........%..........%%.....%..........
m .%.......%%.......................%.........................%%%%....%%..........%............%%..........................%%..........%........%%.........%.................
m ........%........................%.................%.........%.......%..........%..............%%%................%......%%..........%.........%........%..................
m ................................%..................%.................%%........%%................................%........%%.........%..........%......%%..................
m ...............................%%..................%..................%.......%%................................%..........%........%%..........%%.....%.........%%........
m ...............................%%.................%%%.................%%.....%%.........%..................%%...%%.........%........%%...........%%...%..........%%........
m ..................%%...........%%................%%%%%%.....................%%..........%.................%%.....%........%%.........%............%%%%%.........%%.........
m ..................%%...........%.................%%...%%%%%.................%...........%................%%......%........%.........%%............%%%%%.........%..........
m .......%%..........%..........%%............%.....%.......%%%%..............%...........%...............%%.......%........%........%%%................%%.......%%........%.
m ....%%%%%%..........%.......%%%............%......%%........%%..............%...........%%.............%%.........%.......%........%%..................%.......%..........%
m .%%%%.....%%.........%...%%%%.............%........%..........%%%...........%............%..........%%%%..........%......%%.......%%....................%....%%%..........%
m %%%........%.........%%%%%................%........%.............%...........%..........%%%%%......%%.............%......%.......%%.....................%%%%%.%%..........%
m %.....................%..................%%.........%............%...........%..........%...%%%%%.%%..............%%.....%......%%........%%%...........%......%%.........%
m .........................................%%.........%.............%..........%..................%%%..............%%.....%%.....%%.........%%............%.......%%......%%%
m %........................................%..........%%%%%%........%.........%%%..................%%.............%%.......%%...%%.........%%.............%........%%.%%%%%%%
m %..........%.............................%..........%%%%%%.........%.......%%..%%................%%............%%.........%...%%%.......%%..............%....2....%%%......
m %%.......%%%........................%%%%%..........%%....%...............%%......................%%...........%%..........%.....%%......%...............%..................
m .%....%%%........................%%%....%.........%%......%..............%%......................%%.........%%%...........%......%%....%...............%%..................
m .%%%%%%........%........................%.........%.......%..............%%......................%%........%%.............%.......%%..%%...............%%..................
m ....%..........%%.......................%.........%........%.............%%....................%%%........%%.............%%........%%%%...............%%%%%%%..............
m ................%.........%%............%.........%........%%.%%%........%%.............%%%.%%%..........%...............%%.........%%............%%%%......%%%%...........
m ................%...........%%...........%........%........%%%..%%.......%%.........%%%%%.%%%..........%%.................%..........%..............%...........%..........
m ................%%............%..........%........%.......%%.....%.......%%........%%.................%%...................%.........%..............%%..........%..........
m .................%%...........%%%........%........%%.....%%.......%......%%.......%...................%...........%........%..........%..............%...........%%%%%%%%%.
m ..................%.............%%%......%........%%....%%........%%..............%..................%............%.........%..........%.............%..........%%.........
m ........%.........%................%%%...%..............%..........%%............%..................%............%..........%%..........%............%..........%..........
m ........%.........%%.................%%%%%...............%..........%%...........%.................%.............%%..........%..........%............%..........%..........
m ........%..........%...................%%%%%%%%..........%..........%%%...........%...............%...............%%.......%%%..........%%...........%.........%%..........
m ........%..........%........%..........%%.....%...........%........%%.............%.........%....%.................%%....%%%.%...........%...........%%....................
m .......%%..........%........%%.........%..................%.......%%.......................%.........................%%%%....%%..........%............%%...................
m %......%%..........%.........%........%..........................%........................%.................%.........%.......%..........%..............%%%................
m ........%%.........%..........%......%%..................................................%..................%.................%%........%%................................%
m .........%........%%..........%%.....%.........%%.......................................%%..................%..................%.......%%................................%.
m .........%........%%...........%%...%..........%%.......................................%%.................%%%.................%%.....%%.........%..................%%...%%
m ........%%.........%............%%%%%.........%%...........................%%...........%%................%%%%%%.....................%%..........%.................%%.....%
m ........%.........%%............%%%%%.........%............................%%...........%.................%%...%%%%%.................%...........%................%%......%
m ........%........%%%................%%.......%%........%........%%..........%..........%%............%.....%.......%%%%..............%...........%...............%%.......%
m %.......%........%%..................%.......%..........%....%%%%%%..........%.......%%%............%......%%........%%..............%...........%%.............%%.........
m %......%%.......%%....................%....%%%..........%.%%%%.....%%.........%...%%%%.............%........%..........%%%...........%............%..........%%%%..........
m %......%.......%%.....................%%%%%.%%..........%%%%........%.........%%%%%................%........%.............%...........%..........%%%%%......%%.............
m %%.....%......%%........%%%...........%......%%.........%%.....................%..................%%.........%............%...........%..........%...%%%%%.%%..............
m %.....%%.....%%.........%%............%.......%%......%%%.........................................%%.........%.............%..........%..................%%%..............%
m .......%%...%%.........%%.............%........%%.%%%%%%%%........................................%..........%%%%%%........%.........%%%..................%%.............%%
m ........%...%%%.......%%..............%....0....%%%......%..........%.............................%..........%%%%%%.........%.......%%..%%................%%............%%.
m ........%.....%%......%...............%..................%%.......%%%........................%%%%%..........%%....%...............%%......................%%...........%%..
m ........%......%%....%...............%%...................%....%%%........................%%%....%.........%%......%..............%%......................%%.........%%%...
m ........%.......%%..%%...............%%...................%%%%%%........%........................%.........%.......%..............%%......................%%........%%.....
