# random seed -7249113293858359631
# players 4
# area 8000, 2000 (44.7^2) per player
# cell width: 2.53612643019
# cell size: 8
# openness: 0.05
# grid size: (2, 2)
# tile size: (22, 88) 4.0
# map size: (44, 176) 16.0
# vert_copy
# horz_copy
# maze type recursive backtracker
# final openness 0.05
# map_type cell_maze
# random_seed -7249113293858359631
players 4
rows 44
cols 176
m ....%%.......%%%%%%%%%..........%%.....%%%.........%%%......................................%%.......%%%%%%%%%..........%%.....%%%.........%%%..................................
m ....%%%.....%%%%....%...........%%%....%%%.........%%%%........................%%...........%%%.....%%%%....%...........%%%....%%%.........%%%%........................%%.......
m ....%%%%..%%%%%.................%%%.....%%..........%%%%...........0.........%%%%...........%%%%..%%%%%.................%%%.....%%..........%%%%...........2.........%%%%.......
m .....%%..%%%%...................%%%..................%%%%%%%%%%%..........%%%%%%%%...........%%..%%%%...................%%%..................%%%%%%%%%%%..........%%%%%%%%......
m ..........%%...................%%%....................%%%%%%%%%%%.......%%%%%%%%%%%...............%%...................%%%....................%%%%%%%%%%%.......%%%%%%%%%%%.....
m ................................%......................%%%%%%%%%%%......%%%%....%%%%....................................%......................%%%%%%%%%%%......%%%%....%%%%....
m ........................%.................%%%%%........%%%.....%%%%%%%%%%%.......%%%%...........................%.................%%%%%........%%%.....%%%%%%%%%%%.......%%%%...
m .......................%%%...............%%%%%%........%%.......%%%%%%%%%%........%%%%.........................%%%...............%%%%%%........%%.......%%%%%%%%%%........%%%%..
m .......................%%%.............%%%%%%%%%.......%%........%%%%%%%%%.........%%..........................%%%.............%%%%%%%%%.......%%........%%%%%%%%%.........%%...
m ...................%%%%%%...........%%%%%%...%%%......%%%...............%%.................................%%%%%%...........%%%%%%...%%%......%%%...............%%..............
m .............%%%%%%%%%%%%%..........%%%%......%%%.....%%%%..............%%%..........................%%%%%%%%%%%%%..........%%%%......%%%.....%%%%..............%%%.............
m ............%%%%%%%%%%%%%%..........%%%.......%%%......%%%%.............%%%.........................%%%%%%%%%%%%%%..........%%%.......%%%......%%%%.............%%%.............
m ............%%%%%.......%%.........%%%.........%%%......%%%%.............%%.........................%%%%%.......%%.........%%%.........%%%......%%%%.............%%.............
m ...........%%%..........%%%.......%%%%.........%%%.......%%%%%...........%%%.......................%%%..........%%%.......%%%%.........%%%.......%%%%%...........%%%............
m ....%%..................%%%.....%%%%%..........%%%........%%%%%..........%%%%%%.............%%..................%%%.....%%%%%..........%%%........%%%%%..........%%%%%%.........
m ...%%%...................%%%..%%%%%............%%..........%%%%%..........%%%%%%%..........%%%...................%%%..%%%%%............%%..........%%%%%..........%%%%%%%.......
m ...%%....................%%%%%%%%%...........%%%%...........%%%%%............%%%%%.........%%....................%%%%%%%%%...........%%%%...........%%%%%............%%%%%......
m ..%%%........................%%%%.........%%%%%%%%............%%%%%%%%.........%%%%.......%%%........................%%%%.........%%%%%%%%............%%%%%%%%.........%%%%.....
m .%%%%.........................%%%........%%%%%%%%%%............%%%%%%%%.........%%%%.....%%%%.........................%%%........%%%%%%%%%%............%%%%%%%%.........%%%%....
m ..%%%.........................%%%........%%%....%%%%............%%%%%%...........%%.......%%%.........................%%%........%%%....%%%%............%%%%%%...........%%.....
m ...%%..........................%%........%%%.....%%%%......................................%%..........................%%........%%%.....%%%%...................................
m ...%%%.........%%%%%%%.........%%%......%%%.......%%%%.....................................%%%.........%%%%%%%.........%%%......%%%.......%%%%..................................
m ....%%.......%%%%%%%%%..........%%.....%%%.........%%%......................................%%.......%%%%%%%%%..........%%.....%%%.........%%%..................................
m ....%%%.....%%%%....%...........%%%....%%%.........%%%%........................%%...........%%%.....%%%%....%...........%%%....%%%.........%%%%........................%%.......
m ....%%%%..%%%%%.................%%%.....%%..........%%%%...........1.........%%%%...........%%%%..%%%%%.................%%%.....%%..........%%%%...........3.........%%%%.......
m .....%%..%%%%...................%%%..................%%%%%%%%%%%..........%%%%%%%%...........%%..%%%%...................%%%..................%%%%%%%%%%%..........%%%%%%%%......
m ..........%%...................%%%....................%%%%%%%%%%%.......%%%%%%%%%%%...............%%...................%%%....................%%%%%%%%%%%.......%%%%%%%%%%%.....
m ................................%......................%%%%%%%%%%%......%%%%....%%%%....................................%......................%%%%%%%%%%%......%%%%....%%%%....
m ........................%.................%%%%%........%%%.....%%%%%%%%%%%.......%%%%...........................%.................%%%%%........%%%.....%%%%%%%%%%%.......%%%%...
m .......................%%%...............%%%%%%........%%.......%%%%%%%%%%........%%%%.........................%%%...............%%%%%%........%%.......%%%%%%%%%%........%%%%..
m .......................%%%.............%%%%%%%%%.......%%........%%%%%%%%%.........%%..........................%%%.............%%%%%%%%%.......%%........%%%%%%%%%.........%%...
m ...................%%%%%%...........%%%%%%...%%%......%%%...............%%.................................%%%%%%...........%%%%%%...%%%......%%%...............%%..............
m .............%%%%%%%%%%%%%..........%%%%......%%%.....%%%%..............%%%..........................%%%%%%%%%%%%%..........%%%%......%%%.....%%%%..............%%%.............
m ............%%%%%%%%%%%%%%..........%%%.......%%%......%%%%.............%%%.........................%%%%%%%%%%%%%%..........%%%.......%%%......%%%%.............%%%.............
m ............%%%%%.......%%.........%%%.........%%%......%%%%.............%%.........................%%%%%.......%%.........%%%.........%%%......%%%%.............%%.............
m ...........%%%..........%%%.......%%%%.........%%%.......%%%%%...........%%%.......................%%%..........%%%.......%%%%.........%%%.......%%%%%...........%%%............
m ....%%..................%%%.....%%%%%..........%%%........%%%%%..........%%%%%%.............%%..................%%%.....%%%%%..........%%%........%%%%%..........%%%%%%.........
m ...%%%...................%%%..%%%%%............%%..........%%%%%..........%%%%%%%..........%%%...................%%%..%%%%%............%%..........%%%%%..........%%%%%%%.......
m ...%%....................%%%%%%%%%...........%%%%...........%%%%%............%%%%%.........%%....................%%%%%%%%%...........%%%%...........%%%%%............%%%%%......
m ..%%%........................%%%%.........%%%%%%%%............%%%%%%%%.........%%%%.......%%%........................%%%%.........%%%%%%%%............%%%%%%%%.........%%%%.....
m .%%%%.........................%%%........%%%%%%%%%%............%%%%%%%%.........%%%%.....%%%%.........................%%%........%%%%%%%%%%............%%%%%%%%.........%%%%....
m ..%%%.........................%%%........%%%....%%%%............%%%%%%...........%%.......%%%.........................%%%........%%%....%%%%............%%%%%%...........%%.....
m ...%%..........................%%........%%%.....%%%%......................................%%..........................%%........%%%.....%%%%...................................
m ...%%%.........%%%%%%%.........%%%......%%%.......%%%%.....................................%%%.........%%%%%%%.........%%%......%%%.......%%%%..................................
