# map type: cell maze
# random seed: -829389148
# players 2
# area 9022, 4511 (67.2^2) per player
# cell width: 2.49644804508
# cell size: 8.8340851043
# openness: 0.0660757563152
# maze type growing
# horz shear step: 1
# horz_shear
# final parameters
# area: 8800
# grid size: (1, 2)
# tile size: (80, 55) 0.6875
# map size: (80, 110) 1.375
# hill distance  41, 56   1,  1
#        41, 56       0     147 
#         1,  1     147       0 
players 2
rows 80
cols 110
m .......%%%.....................%%%%%%%...........%%%%%%%............%%..........%%%%%%%%%.....................
m .0.....%%%.....................%%%................%%%%%.............%%%........%%%%..%%%%%....................
m .......%%%....................%%%..................%%%%.............%%%........%%%%....%%%%...................
m .......%%%...................%%%.....................%%%............%%%%.......%%%%.....%%%%..................
m ......%%%%...........%......%%%......................%%%..........%%%%%%%.......%%%......%%%%%................
m %%%%%%%%%...........%%%%%%.%%%%.........%%%...........%%%%......%%%%%%%%%.......%%%.......%%%%...........%%%%%
m %%%%%%%%..........%%%%%%%%%%%%..........%%%...........%%%%%%.%%%%%%%..%%%.......%%%........%%%...........%%%%%
m %%%%%%..........%%%%%%.%%%%%%%..........%%...........%%%%%%%%%%%%%.....%%%.......%%.........%%..........%%%%%%
m ...............%%%%%.......%%...........%%...........%%%..%%%%%%.......%%%.......%%%........%%%.......%%%%....
m ...............%%%.....................%%%..........%%%%....%%%%.......%%%.......%%%.......%%%%.....%%%%%%....
m ................%......................%%%..........%%%......%%%........%%%......%%%......%%%.....%%%%%%......
m ......................................%%%%%.........%%.......%%%........%%%......%%%.....%%%......%%%%........
m ..............................%%........%%%%......%%%%........%%........%%%.............%%%........%..........
m ..............................%%%........%%%%...%%%%%.........%%%........%%%............%%....................
m ..............%%%............%%%%%........%%%%%%%%%%...........%%........%%%%.................................
m ..............%%%............%%%%%.........%%%%%%%.............%%%.......%%%%%................................
m ..............%%%%..........%%%%%%%.........%%%%...............%%%........%%%%................................
m .....%%.........%%%........%%%.%%%%..........%.................%%%..........%%................................
m ...%%%%..........%%%......%%%...%%%%...................%%......%%%..........%%%...............................
m ..%%%%%...........%%%.....%%.....%%%%.................%%%%%%...%%..........%%%%....................%%%........
m .%%%%%%...........%%%.............%%%%...............%%%%%%%%%%%%..........%%%............%%.......%%%%%......
m %%%%%.............%%...............%%%%.............%%%%%%%%%%%%%..........%%%...........%%%........%%%%%%....
m %%...............%%%................%%%%%%%%%.....%%%%%.....%%%%...........%%............%%%..........%%%%%%%%
m %................%%%.................%%%%%%%%%%%%%%%%%.......%%%..........%%%...........%%%............%%%%%%%
m .................%%%................%%%%%%%%%%%%%%%%%........%%%%.........%%...........%%%%............%%%%%%%
m .................%%................%%%%......%%%%%%%........%%%%%........%%%...........%%%%%..........%%%%%%..
m ................%%%........%%%%...%%%%.......%%%%.........%%%%%%%%.......%%%..........%%%%%%%.........%%%%....
m ................%%%........%%%%%%%%%%........%%%.........%%%%%%%%%%..................%%%%%%%%........%%%%.....
m ................%%%.........%%%%%%%%.........%%%........%%%%%....%%%.................%%%..%%%%......%%%%......
m ..............%%%%%%%..........%%%%..........%%%........%%%.......%%................%%%.....%%%....%%%%.......
m ..............%%%%%%%%%..........%%%..........%........%%%.........................%%%.......%%%..%%%%........
m .............%%%...%%%%%.........%%%..................%%%......................%%%%%%%........%%%%%%%.........
m ............%%%......%%%..........%%.................%%%%......................%%%%%%..........%%%%%..........
m ...........%%%%...................%%%%%%............%%%%..........%%..........%%%%%%...........%%%%%..........
m .%%........%%%...................%%%%%%%%%%.........%%%%.........%%%.........%%%...............%%%%%%.........
m .%%%.......%%%..................%%%%.%%%%%%.........%%%%%%.......%%%........%%%...............%%%%%%%%........
m %%%........%%%.................%%%%......%...........%%%%%%%%...%%%........%%%...............%%%%..%%%%%......
m %%..........%%................%%%%.....................%%%%%%%%%%%........%%%...............%%%%.....%%%%....%
m %%..........%%%.............%%%%%.........................%%%%%%%.........%%...............%%%%.......%%%%%..%
m %...........%%%..........%%%%%%%%............................%%%%......................%%%%%%%.........%%%%%%%
m %............%%..........%%%%%%%%%............................%%%.....................%%%%%%%...........%%%%%%
m .............%%%........%%%%..%%%%%.....................1.....%%%.....................%%%................%%%%%
m .............%%%........%%%%....%%%%..........................%%%....................%%%..................%%%%
m %............%%%%.......%%%%.....%%%%.........................%%%...................%%%.....................%%
m %..........%%%%%%%.......%%%......%%%%%......................%%%%...........%......%%%......................%%
m %%%......%%%%%%%%%.......%%%.......%%%%...........%%%%%%%%%%%%%%...........%%%%%%.%%%%.........%%%...........%
m %%%%%.%%%%%%%..%%%.......%%%........%%%...........%%%%%%%%%%%%%..........%%%%%%%%%%%%..........%%%...........%
m %%%%%%%%%%%.....%%%.......%%.........%%..........%%%%%%%%%%%%..........%%%%%%.%%%%%%%..........%%...........%%
m %..%%%%%%.......%%%.......%%%........%%%.......%%%%...................%%%%%.......%%...........%%...........%%
m %....%%%%.......%%%.......%%%.......%%%%.....%%%%%%...................%%%.....................%%%..........%%%
m ......%%%........%%%......%%%......%%%.....%%%%%%......................%......................%%%..........%%%
m ......%%%........%%%......%%%.....%%%......%%%%..............................................%%%%%.........%%.
m .......%%........%%%.............%%%........%........................................%%........%%%%......%%%%.
m .......%%%........%%%............%%..................................................%%%........%%%%...%%%%%..
m ........%%........%%%%...............................................%%%............%%%%%........%%%%%%%%%%...
m ........%%%.......%%%%%..............................................%%%............%%%%%.........%%%%%%%.....
m ........%%%........%%%%..............................................%%%%..........%%%%%%%.........%%%%.......
m ........%%%..........%%.....................................%%.........%%%........%%%.%%%%..........%.........
m %%......%%%..........%%%..................................%%%%..........%%%......%%%...%%%%...................
m %%%%%...%%..........%%%%....................%%%..........%%%%%...........%%%.....%%.....%%%%.................%
m %%%%%%%%%%..........%%%............%%.......%%%%%.......%%%%%%...........%%%.............%%%%...............%%
m %%%%%%%%%%..........%%%...........%%%........%%%%%%....%%%%%.............%%...............%%%%.............%%%
m .....%%%%...........%%............%%%..........%%%%%%%%%%...............%%%................%%%%%%%%%.....%%%%%
m ......%%%..........%%%...........%%%............%%%%%%%%................%%%.................%%%%%%%%%%%%%%%%%.
m ......%%%%.........%%...........%%%%............%%%%%%%.................%%%................%%%%%%%%%%%%%%%%%..
m .....%%%%%........%%%...........%%%%%..........%%%%%%...................%%................%%%%......%%%%%%%...
m ...%%%%%%%%.......%%%..........%%%%%%%.........%%%%....................%%%........%%%%...%%%%.......%%%%......
m ..%%%%%%%%%%..................%%%%%%%%........%%%%.....................%%%........%%%%%%%%%%........%%%.......
m .%%%%%....%%%.................%%%..%%%%......%%%%......................%%%.........%%%%%%%%.........%%%.......
m .%%%.......%%................%%%.....%%%....%%%%.....................%%%%%%%..........%%%%..........%%%.......
m %%%.........................%%%.......%%%..%%%%......................%%%%%%%%%..........%%%..........%........
m %%......................%%%%%%%........%%%%%%%......................%%%...%%%%%.........%%%..................%
m %%......................%%%%%%..........%%%%%......................%%%......%%%..........%%.................%%
m %..........%%..........%%%%%%...........%%%%%.....................%%%%...................%%%%%%............%%%
m %.........%%%.........%%%...............%%%%%%..........%%........%%%...................%%%%%%%%%%.........%%%
m %%%.......%%%........%%%...............%%%%%%%%.........%%%.......%%%..................%%%%.%%%%%%.........%%%
m %%%%%%...%%%........%%%...............%%%%..%%%%%......%%%........%%%.................%%%%......%...........%%
m %%%%%%%%%%%........%%%...............%%%%.....%%%%....%%%..........%%................%%%%.....................
m ...%%%%%%%.........%%...............%%%%.......%%%%%..%%%..........%%%.............%%%%%......................
m ......%%%%......................%%%%%%%.........%%%%%%%%...........%%%..........%%%%%%%%......................
