# map type: blank
# random seed: 1226972402
# hill distance   9, 85  81, 43  45, 64  27, 22  63,  1
#         9, 85       0      86      89      86      89 
#        81, 43      86       0      89      89      86 
#        45, 64      89      89       0      86      86 
#        27, 22      86      89      86       0      89 
#        63,  1      89      86      86      89       0 
players 5
rows 90
cols 105
m ..........%%%%....%%%.......................%%%.............%%%%........%%%%%%..%%%%.......%%%.......%%%.
m ..........%%%................................%%.............%%%.......%%%%%%%%%%%%%%......%%%%.......%%%.
m ..........%%...................%.............%%.............%%%.......%%%...%%%%%%%%......%%%.........%%.
m .........%%%.................%%%%............%%............%%%.........%.......%%%%%.....%%%..........%%%
m .........%%%...............%%%%%%%...........%%...........%%%%..................%%%%....%%%%..........%%%
m .........%%%............%%%%%%%%%%%.........%%%%.........%%%%....................%%......%%%..........%%%
m .........%%............%%%%%%...%%%%%.......%%%.........%%%%.............................%%%..........%%%
m ........%%%...........%%%%%.......%%%%%....%%%.........%%%%...............................%%...........%%
m %.......%%%%.........%%%%..........%%%%%%.%%%..........%%%................................%%...........%%
m %.........%%%.......%%%%%...........%%%%%%%%%...........%............................4....%%%..........%%
m %..........%%%%....%%%%%%............%%%%%%%........................%%%%%.................%%%..........%%
m ............%%%....%%%%%%.............%%%%%.......................%%%%%%%%................%%%%........%%%
m ............%%.....%%%%%%..............%%%%......................%%%%%%%%%%%%%%%%..........%%%........%%%
m ...........%%%.....%%%%%................%%%.......................%.....%%%%%%%%%%........%%%%........%%%
m ...........%%%.....%%%%................%%%................................%%%%%%%%%%.....%%%%.........%%%
m %..........%%%.....%%%................%%%...............%%%%.....................%%%%%%.%%%%...........%%
m %..........%%......%%.........%.......%%%..............%%%%%%%.....................%%%%%%%%............%%
m %.........%%%%....%%%........%%%......%%%............%%%%%%%%%%.....................%%%%%%.............%%
m %........%%%%%%..%%%%.......%%%.......%%%...........%%%%....%%%.......................%%%.............%%%
m .......%%%%%%%%%%%%%%......%%%%.......%%%...........%%%................................%%.............%%%
m .......%%%...%%%%%%%%......%%%.........%%...........%%...................%.............%%.............%%%
m ........%.......%%%%%.....%%%..........%%%.........%%%.................%%%%............%%............%%%.
m .................%%%%....%%%%..........%%%.........%%%...............%%%%%%%...........%%...........%%%%.
m ..................%%......%%%..........%%%.........%%%............%%%%%%%%%%%.........%%%%.........%%%%..
m ..........................%%%..........%%%.........%%............%%%%%%...%%%%%.......%%%.........%%%%...
m ...........................%%...........%%........%%%...........%%%%%.......%%%%%....%%%.........%%%%....
m ...........................%%...........%%%.......%%%%.........%%%%..........%%%%%%.%%%..........%%%.....
m ......................1....%%%..........%%%.........%%%.......%%%%%...........%%%%%%%%%...........%......
m .....%%%%%.................%%%..........%%%..........%%%%....%%%%%%............%%%%%%%...................
m ...%%%%%%%%................%%%%........%%%............%%%....%%%%%%.............%%%%%....................
m ..%%%%%%%%%%%%%%%%..........%%%........%%%............%%.....%%%%%%..............%%%%....................
m ...%.....%%%%%%%%%%........%%%%........%%%...........%%%.....%%%%%................%%%....................
m ...........%%%%%%%%%%.....%%%%.........%%%...........%%%.....%%%%................%%%.....................
m ..................%%%%%%.%%%%...........%%%..........%%%.....%%%................%%%...............%%%%...
m ....................%%%%%%%%............%%%..........%%......%%.........%.......%%%..............%%%%%%%.
m .....................%%%%%%.............%%%.........%%%%....%%%........%%%......%%%............%%%%%%%%%%
m .......................%%%.............%%%%........%%%%%%..%%%%.......%%%.......%%%...........%%%%....%%%
m ........................%%.............%%%.......%%%%%%%%%%%%%%......%%%%.......%%%...........%%%........
m ..........%.............%%.............%%%.......%%%...%%%%%%%%......%%%.........%%...........%%.........
m ........%%%%............%%............%%%.........%.......%%%%%.....%%%..........%%%.........%%%.........
m ......%%%%%%%...........%%...........%%%%..................%%%%....%%%%..........%%%.........%%%.........
m ...%%%%%%%%%%%.........%%%%.........%%%%....................%%......%%%..........%%%.........%%%.........
m ..%%%%%%...%%%%%.......%%%.........%%%%.............................%%%..........%%%.........%%..........
m .%%%%%.......%%%%%....%%%.........%%%%...............................%%...........%%........%%%..........
m %%%%..........%%%%%%.%%%..........%%%................................%%...........%%%.......%%%%.........
m %%%%...........%%%%%%%%%...........%............................3....%%%..........%%%.........%%%.......%
m %%%%............%%%%%%%........................%%%%%.................%%%..........%%%..........%%%%....%%
m %%%%.............%%%%%.......................%%%%%%%%................%%%%........%%%............%%%....%%
m %%%%..............%%%%......................%%%%%%%%%%%%%%%%..........%%%........%%%............%%.....%%
m %%%................%%%.......................%.....%%%%%%%%%%........%%%%........%%%...........%%%.....%%
m %%................%%%................................%%%%%%%%%%.....%%%%.........%%%...........%%%.....%%
m %................%%%...............%%%%.....................%%%%%%.%%%%...........%%%..........%%%.....%%
m .........%.......%%%..............%%%%%%%.....................%%%%%%%%............%%%..........%%......%%
m ........%%%......%%%............%%%%%%%%%%.....................%%%%%%.............%%%.........%%%%....%%%
m .......%%%.......%%%...........%%%%....%%%.......................%%%.............%%%%........%%%%%%..%%%%
m ......%%%%.......%%%...........%%%................................%%.............%%%.......%%%%%%%%%%%%%%
m ......%%%.........%%...........%%...................%.............%%.............%%%.......%%%...%%%%%%%%
m .....%%%..........%%%.........%%%.................%%%%............%%............%%%.........%.......%%%%%
m ....%%%%..........%%%.........%%%...............%%%%%%%...........%%...........%%%%..................%%%%
m .....%%%..........%%%.........%%%............%%%%%%%%%%%.........%%%%.........%%%%....................%%.
m .....%%%..........%%%.........%%............%%%%%%...%%%%%.......%%%.........%%%%........................
m ......%%...........%%........%%%...........%%%%%.......%%%%%....%%%.........%%%%.........................
m ......%%...........%%%.......%%%%.........%%%%..........%%%%%%.%%%..........%%%..........................
m .0....%%%..........%%%.........%%%.......%%%%%...........%%%%%%%%%...........%...........................
m ......%%%..........%%%..........%%%%....%%%%%%............%%%%%%%........................%%%%%...........
m ......%%%%........%%%............%%%....%%%%%%.............%%%%%.......................%%%%%%%%..........
m .......%%%........%%%............%%.....%%%%%%..............%%%%......................%%%%%%%%%%%%%%%%...
m ......%%%%........%%%...........%%%.....%%%%%................%%%.......................%.....%%%%%%%%%%..
m .....%%%%.........%%%...........%%%.....%%%%................%%%................................%%%%%%%%%%
m %%%.%%%%...........%%%..........%%%.....%%%................%%%...............%%%%.....................%%%
m %%%%%%%............%%%..........%%......%%.........%.......%%%..............%%%%%%%.....................%
m %%%%%%.............%%%.........%%%%....%%%........%%%......%%%............%%%%%%%%%%.....................
m ..%%%.............%%%%........%%%%%%..%%%%.......%%%.......%%%...........%%%%....%%%.....................
m ...%%.............%%%.......%%%%%%%%%%%%%%......%%%%.......%%%...........%%%.............................
m ...%%.............%%%.......%%%...%%%%%%%%......%%%.........%%...........%%...................%..........
m ...%%............%%%.........%.......%%%%%.....%%%..........%%%.........%%%.................%%%%.........
m ...%%...........%%%%..................%%%%....%%%%..........%%%.........%%%...............%%%%%%%........
m ..%%%%.........%%%%....................%%......%%%..........%%%.........%%%............%%%%%%%%%%%.......
m ..%%%.........%%%%.............................%%%..........%%%.........%%............%%%%%%...%%%%%.....
m .%%%.........%%%%...............................%%...........%%........%%%...........%%%%%.......%%%%%...
m %%%..........%%%................................%%...........%%%.......%%%%.........%%%%..........%%%%%%.
m %%%...........%............................2....%%%..........%%%.........%%%.......%%%%%...........%%%%%%
m %%........................%%%%%.................%%%..........%%%..........%%%%....%%%%%%............%%%%%
m %.......................%%%%%%%%................%%%%........%%%............%%%....%%%%%%.............%%%%
m %......................%%%%%%%%%%%%%%%%..........%%%........%%%............%%.....%%%%%%..............%%%
m %.......................%.....%%%%%%%%%%........%%%%........%%%...........%%%.....%%%%%................%%
m ................................%%%%%%%%%%.....%%%%.........%%%...........%%%.....%%%%................%%%
m ..............%%%%.....................%%%%%%.%%%%...........%%%..........%%%.....%%%................%%%.
m .............%%%%%%%.....................%%%%%%%%............%%%..........%%......%%.........%.......%%%.
m ...........%%%%%%%%%%.....................%%%%%%.............%%%.........%%%%....%%%........%%%......%%%.
