# map type: blank
# random seed: 42241026
# hill distance  41,138  27, 42  13, 90
#        41,138       0     144     144 
#        27, 42     144       0     144 
#        13, 90     144     144       0 
players 3
rows 42
cols 144
m ............%%%..........%%%.....%%......................%%...........................%%%%%...%%%%................%%.................%%.......%%
m ..........%%%%%%..........%%%%%.%%.......................%...........................%%...%%%%%...................%%.................%%.......%%
m ..........%...%%%............%%%%.......................%%.........................%%%......%.............%%%........................%%.......%.
m .........%%.....%%%............%%......................%%........................%%%........%..........%%%%%%%...............%......%%.......%%.
m .........%.......%%%............%..........%%..........%%.......................%%%.........%........%%%%...%%.............%%%.....%%........%%.
m ........%%.........%%%..........%%%.......%%............%.......................%%..........%........%.......%...........%%%.....%%%..........%.
m ....................%%.........%%%%%%%..%%%............%%%%%%%%%%%%%%%........%%%%%.........%................%%.........%%........%%..........%%
m %..............................%%...%%%%%.............%%%%%%%%%%%%%%%%.......%%..%%%........%................%%.........%%........%%...........%
m %.............................%%.......%............%%%............%%.......%%.....%%.......%................%%........%%..........%...........%
m ..............................%%...................%%..............%%...............%%......%%%....%%.........%.....%%%%%..........%...........%
m .....................%%%%%%%%%%..................%%%...............%%................%%.......%%%%%%%.........%%%%%%%%%%...........%%.........%%
m ...........%%%%%%%%%%%%%%%%%%%%..................%.................%.................%%........%%.............%%%%%................%%.........%%
m ...........%%%%%%%%%%............................%.................%.................%%........%..............%%..................%%.........%%.
m ..........%%.......%....................%.......%%.................%.................%%...1...%%.............%%...................%.........%%..
m .........%%...........................%%%%%...%%%%................%%.................%%.......%%............%%%..........%%%.....%%.............
m .........%...........................%%...%%%%%...................%%.................%%.......%%..........%%%%%%..........%%%%%.%%..............
m ........%%.........................%%%......%.............%%%........................%%.......%...........%...%%%............%%%%...............
m .......%%........................%%%........%..........%%%%%%%...............%......%%.......%%..........%%.....%%%............%%...............
m .......%%.......................%%%.........%........%%%%...%%.............%%%.....%%........%%..........%.......%%%............%..........%%...
m ........%.......................%%..........%........%.......%...........%%%.....%%%..........%.........%%.........%%%..........%%%.......%%....
m .......%%%%%%%%%%%%%%%........%%%%%.........%................%%.........%%........%%..........%%....................%%.........%%%%%%%..%%%.....
m ......%%%%%%%%%%%%%%%%.......%%..%%%........%................%%.........%%........%%...........%%..............................%%...%%%%%.......
m ....%%%............%%.......%%.....%%.......%................%%........%%..........%...........%%.............................%%.......%........
m ...%%..............%%...............%%......%%%....%%.........%.....%%%%%..........%...........%..............................%%................
m .%%%...............%%................%%.......%%%%%%%.........%%%%%%%%%%...........%%.........%%.....................%%%%%%%%%%.................
m .%.................%.................%%........%%.............%%%%%................%%.........%%...........%%%%%%%%%%%%%%%%%%%%.................
m .%.................%.................%%........%..............%%..................%%.........%%............%%%%%%%%%%...........................
m %%.................%.................%%...0...%%.............%%...................%.........%%............%%.......%....................%.......
m %%................%%.................%%.......%%............%%%..........%%%.....%%......................%%...........................%%%%%...%%
m ..................%%.................%%.......%%..........%%%%%%..........%%%%%.%%.......................%...........................%%...%%%%%.
m ..........%%%........................%%.......%...........%...%%%............%%%%.......................%%.........................%%%......%...
m .......%%%%%%%...............%......%%.......%%..........%%.....%%%............%%......................%%........................%%%........%...
m .....%%%%...%%.............%%%.....%%........%%..........%.......%%%............%..........%%..........%%.......................%%%.........%...
m .....%.......%...........%%%.....%%%..........%.........%%.........%%%..........%%%.......%%............%.......................%%..........%...
m .............%%.........%%........%%..........%%....................%%.........%%%%%%%..%%%............%%%%%%%%%%%%%%%........%%%%%.........%...
m .............%%.........%%........%%...........%%..............................%%...%%%%%.............%%%%%%%%%%%%%%%%.......%%..%%%........%...
m .............%%........%%..........%...........%%.............................%%.......%............%%%............%%.......%%.....%%.......%...
m ...%%.........%.....%%%%%..........%...........%..............................%%...................%%..............%%...............%%......%%%.
m %%%%%.........%%%%%%%%%%...........%%.........%%.....................%%%%%%%%%%..................%%%...............%%................%%.......%%
m %.............%%%%%................%%.........%%...........%%%%%%%%%%%%%%%%%%%%..................%.................%.................%%........%
m ..............%%..................%%.........%%............%%%%%%%%%%............................%.................%.................%%........%
m .............%%...................%.........%%............%%.......%....................%.......%%.................%.................%%...2...%%
