# random seed -217943896869824654
# players 2
# area 26590
# cell width: 1.00993230279
# cell size: 7
# openness: 0.191253991188
# grid size: (1, 2)
# tile size: (134, 98) 0.731343283582
# map size: (134, 196) 1.46268656716
# horz_copy
# maze type recursive backtracker
# final openness 0.191253991188
# map_type cell_maze
# random_seed -217943896869824654
players 2
rows 134
cols 196
m ........................%%.............%%................%.....%%......%................%.................................%%.............%%................%.....%%......%................%.........
m ..............%.......................%%........................%%.....%................%.......................%.......................%%........................%%.....%................%.........
m ..............%%.....................%%..........................%%.....................%.......................%%.....................%%..........................%%.....................%.........
m .....%%%%......%%...................%%........%...................%.........%%..........%..............%%%%......%%...................%%........%...................%.........%%..........%.........
m ..%%%%..........%%................%%%.........%...................%.........%%%.....................%%%%..........%%................%%%.........%...................%.........%%%...................
m %%%..............%............................%...................%........%%.%%..................%%%..............%............................%...................%........%%.%%..................
m %................%............................%...................%.......%%...%%.................%................%............................%...................%.......%%...%%.................
m ...............................................%........%.........%%......%.....%%...............%...............................................%........%.........%%......%.....%%...............%
m ........................................%.......%.......%%..........%....%.......%%..............%........................................%.......%.......%%..........%....%.......%%..............%
m .........%................%..............................%%..........%%.%%........%%..........%%%..........%................%..............................%%..........%%.%%........%%..........%%%.
m .............%..........%%%%%%............................%%..........%%%..........%.........%%................%..........%%%%%%............................%%..........%%%..........%.........%%...
m .............%........%%%....%%...........................%%............%..........%........%%.................%........%%%....%%...........................%%............%..........%........%%....
m .............%%.......%...................................%.............%..........%%%%%...%%..................%%.......%...................................%.............%..........%%%%%...%%.....
m ..%%%%........%......%%...................................%.............%..........%....%%%%........%%%%........%......%%...................................%.............%..........%....%%%%......
m ..............%......%...................................%.........................%............................%......%...................................%.........................%..............
m ..............%%....%%...........%%...%..................%..................%......%............................%%....%%...........%%...%..................%..................%......%..............
m ..............%%.....%%...........%%%%...................%..........%.......%......%............................%%.....%%...........%%%%...................%..........%.......%......%..............
m ..............%.......%.......................%%....................%.......%......%............................%.......%.......................%%....................%.......%......%..............
m ..........%%%%.........%.......................%%%.................%%.......%.......%.......................%%%%.........%.......................%%%.................%%.......%.......%.............
m .......................%%.........................................%%%........%......%....................................%%.........................................%%%........%......%.............
m ........................%%......................................%%%.%%.......%......%.....................................%%......................................%%%.%%.......%......%.............
m %........................%.................................%%.%%%....%.......%......%......%%%%%%%%........................%.................................%%.%%%....%.......%......%......%%%%%%%
m %......................%%%%..................................%%.......%......%......%.............%......................%%%%..................................%%.......%......%......%.............
m %.....%%.............%%%..%...........................................%%.....%......%%%...........%.....%%.............%%%..%...........................................%%.....%......%%%...........
m %.................%%%......%.........%.................................%%.%%%%........%%..........%.................%%%......%.........%.................................%%.%%%%........%%..........
m %................%%........%%%.......................%..................%%..%%.........%..........%................%%........%%%.......................%..................%%..%%.........%..........
m %................%...........%%%%..........%.........%%.....................%%.........%..........%................%...........%%%%..........%.........%%.....................%%.........%..........
m .............%%%%...............%.........%%........%%.......................%...................%.............%%%%...............%.........%%........%%.......................%...................%
m .........%%%%....%..............%..................%.........................%...................%.........%%%%....%..............%..................%.........................%...................%
m ........%........%..............%................%%.............%............%%..................%........%........%..............%................%%.............%............%%..................%
m ........%.........%..............%..............................%%%%..........%..................%........%.........%..............%..............................%%%%..........%..................%
m ..................%.....%........%.........................%.......%..........%..................%..................%.....%........%.........................%.......%..........%..................%
m ..................%%....%%.......%......%...........................%.........%%................%...................%%....%%.......%......%...........................%.........%%................%.
m ..................%......%%......%......%%..........................%.........%%................%...................%......%%......%......%%..........................%.........%%................%.
m .................%%.......%%....%........%...........................%.........%%%%%%...........%..................%%.......%%....%........%...........................%.........%%%%%%...........%.
m .................%........%.....%%.......%%%%..........%%%%...................%.................%..................%........%.....%%.......%%%%..........%%%%...................%.................%.
m ................%%........%......%...........%%%%%%%%%%.....................%%.................%%.................%%........%......%...........%%%%%%%%%%.....................%%.................%%.
m .........%%..............%%......%...............%%.........................%%.............%%%%%%..........%%..............%%......%...............%%.........................%%.............%%%%%%.
m ...........%.............%.......%...............%%...............%.........%%..........%%%%....%%...........%.............%.......%...............%%...............%.........%%..........%%%%....%%
m %........................%.......%%%.............%%........%%...............%%..........%........%%........................%.......%%%.............%%........%%...............%%..........%........%
m %.....................%%%%..........%%%..........%%.........................%%.........%%.........%.....................%%%%..........%%%..........%%.........................%%.........%%.........
m ......................%...............%%.........%%........................%%..........%................................%...............%%.........%%........................%%..........%..........
m .................................................%%.......................%%...........%...........................................................%%.......................%%...........%..........
m .............................%..................%........%%%.......%%....%%...........%%.......................................%..................%........%%%.......%%....%%...........%%..........
m ............%%................%................%.......%%%.%%.....%%%%%%%%............%.......................%%................%................%.......%%%.%%.....%%%%%%%%............%...........
m %..........%%%%%%%%%%.........%........................%.....%...%%....%%............%%...........%..........%%%%%%%%%%.........%........................%.....%...%%....%%............%%...........
m %..........%........%..................................%......%%%%......%..........%%.............%..........%........%..................................%......%%%%......%..........%%.............
m ........%%%..........%.................................%.......%%........%................................%%%..........%.................................%.......%%........%........................
m ......%%%............%..............%..................%.................%..............................%%%............%..............%..................%.................%........................
m ......%%..............%...%.........%........%%........%......................................%.........%%..............%...%.........%........%%........%......................................%...
m ......%...................%%................%..........%.........................%............%.........%...................%%................%..........%.........................%............%...
m ......%....................%...............%.........%%%......%%%................%.....1......%.........%....................%...............%.........%%%......%%%................%.....0......%...
m ......%....................%%..............%.......%%%......%%%..%%..............%...........%..........%....................%%..............%.......%%%......%%%..%%..............%...........%....
m ......%.......%%%%%%%.......%..............%.......%.......%%......%%............%%..........%..........%.......%%%%%%%.......%..............%.......%.......%%......%%............%%..........%....
m ......%.............%.......%%.............%.......%................%%............%%.........%%.........%.............%.......%%.............%.......%................%%............%%.........%%...
m ......%.............%........%%............%.......%.................%.............%%.........%.........%.............%........%%............%.......%.................%.............%%.........%...
m .....%%..............%.......%%.%%.........%.......%.................%........................%........%%..............%.......%%.%%.........%.......%.................%........................%...
m ......%.....%%.......%........%%...........%.......%..................%.................................%.....%%.......%........%%...........%.......%..................%...........................
m .....................%%.......%%...........%........%................%%...%............................................%%.......%%...........%........%................%%...%.......................
m .....................%........%%...........%.........%...............%....%%...........................................%........%%...........%.........%...............%....%%......................
m ....................%%........%%..........%%..........%.............%.................................................%%........%%..........%%..........%.............%.............................
m ....................%.........%%..........%%...........%%%%........%................%.................................%.........%%..........%%...........%%%%........%................%.............
m ...................%%...........%.........%%...........%........%%%%.........................%.......................%%...........%.........%%...........%........%%%%.........................%....
m .....%............%%.............%.........%%.........%........%%.%%........................%%.........%............%%.............%.........%%.........%........%%.%%........................%%....
m ................%%................%.........%%.......%%............%%.............................................%%................%.........%%.......%%............%%.............................
m %%.................................%.........%%......%..............%..........%..................%%.................................%.........%%......%..............%..........%..................
m ....................................%........%.......%...............%.........%......................................................%........%.......%...............%.........%..................
m ............%...........%...........%........%.......%...............%.........%%.............................%...........%...........%........%.......%...............%.........%%.................
m ............%...........%%..........%........%.......%%...............%.......%.%%........%...................%...........%%..........%........%.......%%...............%.......%.%%........%.......
m ...........%%...........%.........%%%........%........%...........................%%.........................%%...........%.........%%%........%........%...........................%%..............
m ...........%...........%%.......%%%..........%........%....%%%.....................%%........................%...........%%.......%%%..........%........%....%%%.....................%%.............
m ......................%%......%%%..........%%%%.......%%%%%..%%.....................%...................................%%......%%%..........%%%%.......%%%%%..%%.....................%.............
m ......................%.......%.........%%%...%%..............%%....................%...................................%.......%.........%%%...%%..............%%....................%.............
m .%%%%%%%.............%........%.........%......%%..............%%...................%........%%....%%%%%%%.............%........%.........%......%%..............%%...................%........%%...
m ..%%%%%%............%%........%.................%%%.............%%%%.................%..............%%%%%%............%%........%.................%%%.............%%%%.................%............
m .......%%..........%%.........%..................%%%%...........%%%%%.......%........%...................%%..........%%.........%..................%%%%...........%%%%%.......%........%............
m ........%.........%%..........%.....................%%.........%.....%...%%%%........%....................%.........%%..........%.....................%%.........%.....%...%%%%........%............
m ........%........%............%...............................%.......%%%%...........%....................%........%............%...............................%.......%%%%...........%............
m .........%.......%............%%%%%..........................%........%%.............%%%%%%%...............%.......%............%%%%%..........................%........%%.............%%%%%%%......
m .........%%%....%............%%....%%%%%..............................%%.........%%%%%.....%%..............%%%....%............%%....%%%%%..............................%%.........%%%%%.....%%.....
m ............%%%%%...........%%..........%.............................%%....................%%................%%%%%...........%%..........%.............................%%....................%%....
m %%..............%..........%%...........%%%...........................%......................%%..%%%..............%..........%%...........%%%...........................%......................%%..%
m .%%.............%.........%................%%........................%........................%%%..%%.............%.........%................%%........................%........................%%%.
m ...%%...........%........%..................%................%......%................................%%...........%........%..................%................%......%.............................
m ....%%%%........%.......%....................%..............%%.....%..................................%%%%........%.......%....................%..............%%.....%..............................
m .......%%..............%.....................%%............%%...............%............................%%..............%.....................%%............%%...............%.....................
m .........%............%%......................%%%%%%%%%...%%................%..............................%............%%......................%%%%%%%%%...%%................%.....................
m ..........%%...........%........%%%%%..................%%%%%................%.........%.....................%%...........%........%%%%%..................%%%%%................%.........%...........
m ...........%%%.........%.......%%%%%%%......................%...............%........%......%................%%%.........%.......%%%%%%%......................%...............%........%......%.....
m .............%.........%.......%.....%.......................%..............%.......%........%.................%.........%.......%.....%.......................%..............%.......%........%....
m ..%.........%%%........%%.....%......%%.......................%.....%%.....%%......%................%.........%%%........%%.....%......%%.......................%.....%%.....%%......%..............
m ...%.......%%.%%......%%.....%%.......%...%%%%.................%......%%..%%.........................%.......%%.%%......%%.....%%.......%...%%%%.................%......%%..%%......................
m ...%......%%...%%....%......%%........%%%%....%.......%................%%%%..........................%......%%...%%....%......%%........%%%%....%.......%................%%%%.......................
m ....%....%%.....%%.%%.......%.........%.......%.......%...............................................%....%%.....%%.%%.......%.........%.......%.......%...........................................
m ........%%.......%%%.........%........%........%............................................%.............%%.......%%%.........%........%........%............................................%.....
m ........%%...................%.......%%........%%...................................%%....%%%.............%%...................%.......%%........%%...................................%%....%%%.....
m .........%.....................................%%....................................%%%%%%................%.....................................%%....................................%%%%%%.......
m .........%.......................%.............%........................................%..................%.......................%.............%........................................%.........
m .........%........%%%%%.........................%..........%%%%.........................%..................%........%%%%%.........................%..........%%%%.........................%.........
m %........%%......%%....%%%%..............%......%.........%%...%%..............%........%.........%........%%......%%....%%%%..............%......%.........%%...%%..............%........%.........
m %.........%......%.......................%.......%.......%%......%%............%.........%........%.........%......%.......................%.......%.......%%......%%............%.........%........
m %.........%.............................%%.......%......%%.........%%..........%.........%........%.........%.............................%%.......%......%%.........%%..........%.........%........
m %........%..............................%...............%...........%..........%.........%........%........%..............................%...............%...........%..........%.........%........
m ........%...............................%...............%....................%%%.........%.......%........%...............................%...............%....................%%%.........%.......%
m ........%.........................%.....%%..............%...................%%...........%......%.........%.........................%.....%%..............%...................%%...........%......%.
m ........%.........%%......%%.............%%....%.........%..................%............%................%.........%%......%%.............%%....%.........%..................%............%........
m ........%.........%.......%...............%%...%%........%..................%..........%%.................%.........%.......%...............%%...%%........%..................%..........%%.........
m ........%%.......%%.......%................%....%%.......%........%.........%..........%..................%%.......%%.......%................%....%%.......%........%.........%..........%..........
m ........%%%......%........%......................%%......%........%.........%..........%..................%%%......%........%......................%%......%........%.........%..........%..........
m .......%...%...%%%........%.......................%%..............%........%...........%.................%...%...%%%........%.......................%%..............%........%...........%..........
m ......%.....%%%%...................%...............................%.......%...........%................%.....%%%%...................%...............................%.......%...........%..........
m .....%.............................%...............................%.......%............%..............%.............................%...............................%.......%............%.........
m %...%...................................%%.........................%.......%............%........%%...%...................................%%.........................%.......%............%........%
m %%%%...........................%...................................%........%............%....%%%%%%%%...........................%...................................%........%............%....%%%%
m ..%%.................%.........%..................................%%........%%%%.........%%%%%%.....%%.................%.........%..................................%%........%%%%.........%%%%%%...
m .....................%........%.................%.........%%.......%.......%%.............%%...........................%........%.................%.........%%.......%.......%%.............%%......
m .....................%..........................%..........%.......%.......%.............%%............................%..........................%..........%.......%.......%.............%%.......
m .....................%...........................%.................%%......%.............%.............................%...........................%.................%%......%.............%........
m .........%%%%%%%%%%%%%...........................%%%................%.....%..............%.................%%%%%%%%%%%%%...........................%%%................%.....%..............%........
m .........%%...........%.........................%...................%.....%..............%.................%%...........%.........................%...................%.....%..............%........
m ........%..............%%......................%....................%%...%%..............%................%..............%%......................%....................%%...%%..............%........
m .......%............................%%%%......%....................%%....%..........%....%%..............%............................%%%%......%....................%%....%..........%....%%.......
m %.....%.............................%...%%%..%...................%%......%%........%%......%.....%%.....%.............................%...%%%..%...................%%......%%........%%......%.....%
m .%%..%.............................%.......%%..............%%%..%%........%.................%......%%..%.............................%.......%%..............%%%..%%........%.................%.....
m ...%%......................%................%..........%%%%%..%%%.........%..........................%%......................%................%..........%%%%%..%%%.........%.......................
m ....%.......................................%.........%%.......%..........%...........................%.......................................%.........%%.......%..........%.......................
m ....%.......................................%%........%........%.........%%...........................%.......................................%%........%........%.........%%.......................
m ....%%.......%...%%.........................%%.......%%.........%.......%%............................%%.......%...%%.........................%%.......%%.........%.......%%........................
m .....%........%%%%.................%.......%%........%.........%%......%%..............................%........%%%%.................%.......%%........%.........%%......%%.........................
m ...%%%............................%%......%%........%%.........%......%%.............................%%%............................%%......%%........%%.........%......%%..........................
m .%%%.............................%.......%%........%%.........%%......%............................%%%.............................%.......%%........%%.........%%......%...........................
m %..............................%%.......%%..........%.........%.......%..........%%%.......%%%..%%%..............................%%.......%%..........%.........%.......%..........%%%.......%%%..%%
m ..........................%%.%%%........%....................%%........%........%%..%%%...%...%%%...........................%%.%%%........%....................%%........%........%%..%%%...%...%%%.
m .........................%%%%%..........%....................%%%.......%...............%%%.................................%%%%%..........%....................%%%.......%...............%%%........
