# random seed -873684748324875692
# players 7
# area 6300, 900 (30.0^2) per player
# cell width: 6.10482898798
# cell size: 12
# openness: 0.05
# grid size: (1, 7)
# tile size: (49, 16) 0.326530612245
# map size: (49, 112) 2.28571428571
# horz shear step: 3
# horz_shear
# maze type recursive backtracker
# final openness 0.05
# map_type cell_maze
# random_seed -873684748324875692
players 7
rows 49
cols 112
m %%%%%........%%..................%%%%%%%%%%%%...%%.................................%%%%%%%%%...................%
m %%%%%.........%...................%%%%%%%%%%%%%..%................................%%%%%%%%%%%%%...............%%
m %%%%%%..............................%%%%%%%%%%%...................................%%%%%%%%%%%%%..............%%%
m %%%%%%..............%................%%%%%%%%%..................................%..%%%%%%%%%%%%...............%%
m %%%%%%%...........%%.............2...%%%%%%%%%..................................%%%%%%%%%%%%%%%%..............%%
m %%%%%%%%%........%%...................%%%%%%........%%%%%.......................%%%%%%%%%%%%%%%%..............%%
m %%%%%%%%%%......%%....................%%%%.........%%%%%%%.....................%%%%%.......%%%%...............%%
m .%%%%%%%%%%%%...%%.................................%%%%%%%%%...................%%%%%%........%%.................
m ..%%%%%%%%%%%%%..%................................%%%%%%%%%%%%%...............%%%%%%%.........%.................
m ....%%%%%%%%%%%...................................%%%%%%%%%%%%%..............%%%%%%%%%..........................
m .....%%%%%%%%%..................................%..%%%%%%%%%%%%...............%%%%%%%%..............%...........
m .3...%%%%%%%%%..................................%%%%%%%%%%%%%%%%..............%%%%%%%%%...........%%............
m ......%%%%%%........%%%%%.......................%%%%%%%%%%%%%%%%..............%%%%%%%%%%%........%%.............
m ......%%%%.........%%%%%%%.....................%%%%%.......%%%%...............%%%%%%%%%%%%......%%..............
m ...................%%%%%%%%%...................%%%%%%........%%..................%%%%%%%%%%%%...%%..............
m ..................%%%%%%%%%%%%%...............%%%%%%%.........%...................%%%%%%%%%%%%%..%..............
m ..................%%%%%%%%%%%%%..............%%%%%%%%%..............................%%%%%%%%%%%.................
m ................%..%%%%%%%%%%%%...............%%%%%%%%..............%................%%%%%%%%%..................
m ................%%%%%%%%%%%%%%%%..............%%%%%%%%%...........%%.............0...%%%%%%%%%..................
m ................%%%%%%%%%%%%%%%%..............%%%%%%%%%%%........%%...................%%%%%%........%%%%%.......
m ...............%%%%%.......%%%%...............%%%%%%%%%%%%......%%....................%%%%.........%%%%%%%......
m ...............%%%%%%........%%..................%%%%%%%%%%%%...%%.................................%%%%%%%%%....
m ..............%%%%%%%.........%...................%%%%%%%%%%%%%..%................................%%%%%%%%%%%%%.
m .............%%%%%%%%%..............................%%%%%%%%%%%...................................%%%%%%%%%%%%%.
m ..............%%%%%%%%..............%................%%%%%%%%%..................................%..%%%%%%%%%%%%.
m ..............%%%%%%%%%...........%%.............4...%%%%%%%%%..................................%%%%%%%%%%%%%%%%
m ..............%%%%%%%%%%%........%%...................%%%%%%........%%%%%.......................%%%%%%%%%%%%%%%%
m ..............%%%%%%%%%%%%......%%....................%%%%.........%%%%%%%.....................%%%%%.......%%%%.
m .................%%%%%%%%%%%%...%%.................................%%%%%%%%%...................%%%%%%........%%.
m ..................%%%%%%%%%%%%%..%................................%%%%%%%%%%%%%...............%%%%%%%.........%.
m ....................%%%%%%%%%%%...................................%%%%%%%%%%%%%..............%%%%%%%%%..........
m ....%................%%%%%%%%%..................................%..%%%%%%%%%%%%...............%%%%%%%%..........
m ..%%.............6...%%%%%%%%%..................................%%%%%%%%%%%%%%%%..............%%%%%%%%%.........
m .%%...................%%%%%%........%%%%%.......................%%%%%%%%%%%%%%%%..............%%%%%%%%%%%.......
m %%....................%%%%.........%%%%%%%.....................%%%%%.......%%%%...............%%%%%%%%%%%%......
m %%.................................%%%%%%%%%...................%%%%%%........%%..................%%%%%%%%%%%%...
m .%................................%%%%%%%%%%%%%...............%%%%%%%.........%...................%%%%%%%%%%%%%.
m ..................................%%%%%%%%%%%%%..............%%%%%%%%%..............................%%%%%%%%%%%.
m ................................%..%%%%%%%%%%%%...............%%%%%%%%..............%................%%%%%%%%%..
m ................................%%%%%%%%%%%%%%%%..............%%%%%%%%%...........%%.............5...%%%%%%%%%..
m ....%%%%%.......................%%%%%%%%%%%%%%%%..............%%%%%%%%%%%........%%...................%%%%%%....
m ...%%%%%%%.....................%%%%%.......%%%%...............%%%%%%%%%%%%......%%....................%%%%......
m ...%%%%%%%%%...................%%%%%%........%%..................%%%%%%%%%%%%...%%..............................
m ..%%%%%%%%%%%%%...............%%%%%%%.........%...................%%%%%%%%%%%%%..%..............................
m ..%%%%%%%%%%%%%..............%%%%%%%%%..............................%%%%%%%%%%%.................................
m %..%%%%%%%%%%%%...............%%%%%%%%..............%................%%%%%%%%%..................................
m %%%%%%%%%%%%%%%%..............%%%%%%%%%...........%%.............1...%%%%%%%%%..................................
m %%%%%%%%%%%%%%%%..............%%%%%%%%%%%........%%...................%%%%%%........%%%%%.......................
m %%%%.......%%%%...............%%%%%%%%%%%%......%%....................%%%%.........%%%%%%%.....................%
