# random seed -5777256027727465526
# players 7
# area 10500, 1500 (38.7^2) per player
# cell width: 1.00422909812
# cell size: 7
# openness: 0.05
# grid size: (1, 7)
# tile size: (56, 25) 0.446428571429
# map size: (56, 175) 3.125
# horz_copy
# maze type recursive backtracker
# final openness 0.05
# map_type cell_maze
# random_seed -5777256027727465526
players 7
rows 56
cols 175
m ...%....%..........%........%....%..........%........%....%..........%........%....%..........%........%....%..........%........%....%..........%........%....%..........%.....
m ...%%...%..........%%.......%%...%..........%%.......%%...%..........%%.......%%...%..........%%.......%%...%..........%%.......%%...%..........%%.......%%...%..........%%....
m ...%%...%%..........%.......%%...%%..........%.......%%...%%..........%.......%%...%%..........%.......%%...%%..........%.......%%...%%..........%.......%%...%%..........%....
m ..%%.....%%.........%......%%.....%%.........%......%%.....%%.........%......%%.....%%.........%......%%.....%%.........%......%%.....%%.........%......%%.....%%.........%....
m .%%.......%.........%%....%%.......%.........%%....%%.......%.........%%....%%.......%.........%%....%%.......%.........%%....%%.......%.........%%....%%.......%.........%%...
m %%........%%.............%%........%%.............%%........%%.............%%........%%.............%%........%%.............%%........%%.............%%........%%.............
m .%.........%%.............%.........%%.............%.........%%.............%.........%%.............%.........%%.............%.........%%.............%.........%%............
m .%..........%%%...........%..........%%%...........%..........%%%...........%..........%%%...........%..........%%%...........%..........%%%...........%..........%%%..........
m .%.............%%%........%.............%%%........%.............%%%........%.............%%%........%.............%%%........%.............%%%........%.............%%%.......
m .%%..............%........%%..............%........%%..............%........%%..............%........%%..............%........%%..............%........%%..............%.......
m ..%...............%........%...............%........%...............%........%...............%........%...............%........%...............%........%...............%......
m %%%...............%......%%%...............%......%%%...............%......%%%...............%......%%%...............%......%%%...............%......%%%...............%......
m %..%%%%%..........%..%%%%%..%%%%%..........%..%%%%%..%%%%%..........%..%%%%%..%%%%%..........%..%%%%%..%%%%%..........%..%%%%%..%%%%%..........%..%%%%%..%%%%%..........%..%%%%
m ...................%%%......................%%%......................%%%......................%%%......................%%%......................%%%......................%%%...
m ..................%........................%........................%........................%........................%........................%........................%......
m ..................%........................%........................%........................%........................%........................%........................%......
m .................%........................%........................%........................%........................%........................%........................%.......
m ..............%%%......................%%%......................%%%......................%%%......................%%%......................%%%......................%%%........
m .............%........................%........................%........................%........................%........................%........................%...........
m %%%........%%............%%%........%%............%%%........%%............%%%........%%............%%%........%%............%%%........%%............%%%........%%............
m %.........%%%........%%%%%.........%%%........%%%%%.........%%%........%%%%%.........%%%........%%%%%.........%%%........%%%%%.........%%%........%%%%%.........%%%........%%%%
m ........%%%..........%%..........%%%..........%%..........%%%..........%%..........%%%..........%%..........%%%..........%%..........%%%..........%%..........%%%..........%%..
m ......%%%............%%........%%%............%%........%%%............%%........%%%............%%........%%%............%%........%%%............%%........%%%............%%..
m ......%..........1...%%........%..........6...%%........%..........5...%%........%..........4...%%........%..........3...%%........%..........0...%%........%..........2...%%..
m .....%%..............%%.......%%..............%%.......%%..............%%.......%%..............%%.......%%..............%%.......%%..............%%.......%%..............%%..
m .....%...............%%.......%...............%%.......%...............%%.......%...............%%.......%...............%%.......%...............%%.......%...............%%..
m ......%.............%%%%%......%.............%%%%%......%.............%%%%%......%.............%%%%%......%.............%%%%%......%.............%%%%%......%.............%%%%%
m %%.....%......%...%%....%%%.....%......%...%%....%%%.....%......%...%%....%%%.....%......%...%%....%%%.....%......%...%%....%%%.....%......%...%%....%%%.....%......%...%%....%
m .%......%......%%%%.......%......%......%%%%.......%......%......%%%%.......%......%......%%%%.......%......%......%%%%.......%......%......%%%%.......%......%......%%%%......
m .........%.......%................%.......%................%.......%................%.......%................%.......%................%.......%................%.......%.......
m .........%.......%................%.......%................%.......%................%.......%................%.......%................%.......%................%.......%.......
m ........%%.......%...............%%.......%...............%%.......%...............%%.......%...............%%.......%...............%%.......%...............%%.......%.......
m ........%........................%........................%........................%........................%........................%........................%................
m ........%........................%........................%........................%........................%........................%........................%................
m .......%%.......................%%.......................%%.......................%%.......................%%.......................%%.......................%%................
m .%......%%................%......%%................%......%%................%......%%................%......%%................%......%%................%......%%...............
m %........%%..............%........%%..............%........%%..............%........%%..............%........%%..............%........%%..............%........%%..............
m %.........%%.............%.........%%.............%.........%%.............%.........%%.............%.........%%.............%.........%%.............%.........%%.............
m ...........%%%..........%...........%%%..........%...........%%%..........%...........%%%..........%...........%%%..........%...........%%%..........%...........%%%..........%
m ...........%%...........%...........%%...........%...........%%...........%...........%%...........%...........%%...........%...........%%...........%...........%%...........%
m ..........%............%...........%............%...........%............%...........%............%...........%............%...........%............%...........%............%.
m .........%............%...........%............%...........%............%...........%............%...........%............%...........%............%...........%............%..
m ........%..........%%%...........%..........%%%...........%..........%%%...........%..........%%%...........%..........%%%...........%..........%%%...........%..........%%%...
m .......%.........%%%............%.........%%%............%.........%%%............%.........%%%............%.........%%%............%.........%%%............%.........%%%.....
m ......%..........%.............%..........%.............%..........%.............%..........%.............%..........%.............%..........%.............%..........%.......
m ................%........................%........................%........................%........................%........................%........................%........
m ................%........................%........................%........................%........................%........................%........................%........
m ...............%........................%........................%........................%........................%........................%........................%.........
m .......%%......%................%%......%................%%......%................%%......%................%%......%................%%......%................%%......%.........
m ........%%%%%%%%.................%%%%%%%%.................%%%%%%%%.................%%%%%%%%.................%%%%%%%%.................%%%%%%%%.................%%%%%%%%.........
m %........%.....%.........%........%.....%.........%........%.....%.........%........%.....%.........%........%.....%.........%........%.....%.........%........%.....%.........
m %........%......%........%........%......%........%........%......%........%........%......%........%........%......%........%........%......%........%........%......%........
m %........%......%........%........%......%........%........%......%........%........%......%........%........%......%........%........%......%........%........%......%........
m %%.......%.......%.......%%.......%.......%.......%%.......%.......%.......%%.......%.......%.......%%.......%.......%.......%%.......%.......%.......%%.......%.......%.......
m .%......%........%%.......%......%........%%.......%......%........%%.......%......%........%%.......%......%........%%.......%......%........%%.......%......%........%%......
m ..%.....%.........%%.......%.....%.........%%.......%.....%.........%%.......%.....%.........%%.......%.....%.........%%.......%.....%.........%%.......%.....%.........%%.....
