# random seed 1417260535661931338
# players 3
# area 10500, 3500 (59.2^2) per player
# cell width: 2.24962143704
# cell size: 9
# openness: 0.2
# grid size: (1, 3)
# tile size: (78, 43) 0.551282051282
# map size: (78, 129) 1.65384615385
# horz shear step: 1
# horz_shear
# maze type recursive backtracker
# final openness 0.2
# map_type cell_maze
# random_seed 1417260535661931338
players 3
rows 78
cols 129
m %%%...........%%%%%%...%%...........%%.............%%%%%%..........%%........%....................%%%............%%...........%%%
m %%..............%...................%%%..............%%%%%.........%%.......%%%.......%%%%.........%.............%%%............%
m %%...................................%%%%..............%%%%..................%%%......%%%%%%.....................%%%%............
m %%..................................%%%%%%%..............%%%..................%%........%%%%%....................%%%%%...........
m %%.................................%%%..%%%...............%%%%................%%%.........%%%......................%%%%..........
m %%................................%%%......................%%%%%..............%%%.........%%%.......................%%%%........%
m %%...............................%%%........................%%%%%.............%%%.........%%%.........%%%............%%%%%......%
m %%...........%.................%%%%..........................%%%%%............%%%.........%%%........%%%%%%%%.........%%%%%.....%
m %%..........%%%............%%%%%%%............................%%%%............%%..........%%%........%%%%%%%%%.........%%%%.....%
m %%...........%%...........%%%%%%%%.........%%%%%%%............%%%.............%%..........%%%.......%%%....%%%........%%%%......%
m %%...........%%%......%%%%%%..%%%%........%%%%%%%%%..........%%%..............%%..........%%%......%%%...............%%%%........
m %%............%%%%%%%%%%%%%....%%%%......%%%%%%%%%%%........%%%...........................%%%.....%%%...............%%%%.........
m %%............%%%%%%%%%%%%......%%%%....%%%%......%%%......%%%.........%%%...............%%%%....%%%...............%%%%..........
m %%.............%%%...............%%%...%%%%........%%%....%%%..........%%%..............%%%%......%%..............%%%%...........
m %%...............................%%%...%%%.........%%%.....%...........%%%.............%%%%......................%%%%....0.......
m %%%%.............................%%%...................................%%%...........%%%%%.....................%%%%%%............
m %%%%%%...........................%%....................................%%%...........%%%%.....................%%%%%%............%
m %%%%%%%%.........................%%....................................%%%............%%.....................%%%................%
m %...%%%%%%%......................%%....................................%%%...........................%%......%%%................%
m .......%%%%%%%...................%%....................................%%%..........................%%%%....%%%..........%%%.....
m .........%%%%%..................%%%....................................%%%..........................%%%.....%%...........%%......
m ...........%%%%%%%%%%%%%%.......%%%%.............%%...................%%%................................................%%......
m .............%%%%%%%%%%%%%%.....%%%%%%.........%%%%%%................%%%.....%%%.................................................
m .............%%%%%%%%%%%%%%%.......%%%%%%%...%%%%%%%%%%%...........%%%%.......%%..........%%%....................................
m .............%%%..........%%%........%%%%%%%%%%%.%%%%%%%%%%%%%%%%%%%%%........%%%..........%%%%%%%...............................
m ............%%%............%%..........%%%%%%%%.......%%%%%%%%%%%%%%%..........%%...........%%%%%%%...........%%.................
m ............%%%............%%...........%%%%%%...........%%%%%%...%%...........%%.............%%%%%%..........%%........%........
m %%%%.........%.............%%%............%%%..............%...................%%%..............%%%%%.........%%.......%%%.......
m %%%%%%.....................%%%%............%%...................................%%%%..............%%%%..................%%%......
m ..%%%%%....................%%%%%...........%%..................................%%%%%%%..............%%%..................%%......
m ....%%%......................%%%%..........%%.................................%%%..%%%...............%%%%................%%%.....
m ....%%%.......................%%%%........%%%................................%%%......................%%%%%..............%%%.....
m ....%%%.........%%%............%%%%%......%%%...............................%%%........................%%%%%.............%%%.....
m ....%%%........%%%%%%%%.........%%%%%.....%%%...........%.................%%%%..........................%%%%%............%%%.....
m ....%%%........%%%%%%%%%.........%%%%.....%%%..........%%%............%%%%%%%............................%%%%............%%......
m ....%%%.......%%%....%%%........%%%%......%%%...........%%...........%%%%%%%%.........%%%%%%%............%%%.............%%......
m ....%%%......%%%...............%%%%........%%...........%%%......%%%%%%..%%%%........%%%%%%%%%..........%%%..............%%......
m ....%%%.....%%%...............%%%%.........%%............%%%%%%%%%%%%%....%%%%......%%%%%%%%%%%........%%%.......................
m ...%%%%....%%%...............%%%%..........%%............%%%%%%%%%%%%......%%%%....%%%%......%%%......%%%.........%%%............
m ..%%%%......%%..............%%%%...........%%.............%%%...............%%%...%%%%........%%%....%%%..........%%%............
m .%%%%......................%%%%....2.......%%...............................%%%...%%%.........%%%.....%...........%%%............
m %%%%.....................%%%%%%............%%%%.............................%%%...................................%%%...........%
m %%%.....................%%%%%%............%%%%%%%...........................%%....................................%%%...........%
m %%.....................%%%................%%%%%%%%%.........................%%....................................%%%............
m ...............%%......%%%................%%...%%%%%%%......................%%....................................%%%............
m ..............%%%%....%%%..........%%%............%%%%%%%...................%%....................................%%%............
m ..............%%%.....%%...........%%...............%%%%%..................%%%....................................%%%............
m ...................................%%.................%%%%%%%%%%%%%%.......%%%%.............%%...................%%%.............
m ........................................................%%%%%%%%%%%%%%.....%%%%%%.........%%%%%%................%%%.....%%%......
m ....%%%.................................................%%%%%%%%%%%%%%%.......%%%%%%%...%%%%%%%%%%%...........%%%%.......%%......
m .....%%%%%%%............................................%%%..........%%%........%%%%%%%%%%%.%%%%%%%%%%%%%%%%%%%%%........%%%.....
m ......%%%%%%%...........%%.............................%%%............%%..........%%%%%%%%.......%%%%%%%%%%%%%%%..........%%.....
m ........%%%%%%..........%%........%....................%%%............%%...........%%%%%%...........%%%%%%...%%...........%%.....
m ..........%%%%%.........%%.......%%%.......%%%%.........%.............%%%............%%%..............%...................%%%....
m ............%%%%..................%%%......%%%%%%.....................%%%%............%%...................................%%%%..
m ..............%%%..................%%........%%%%%....................%%%%%...........%%..................................%%%%%%%
m ...............%%%%................%%%.........%%%......................%%%%..........%%.................................%%%..%%%
m ................%%%%%..............%%%.........%%%.......................%%%%........%%%................................%%%......
m .................%%%%%.............%%%.........%%%.........%%%............%%%%%......%%%...............................%%%.......
m ..................%%%%%............%%%.........%%%........%%%%%%%%.........%%%%%.....%%%...........%.................%%%%........
m ...................%%%%............%%..........%%%........%%%%%%%%%.........%%%%.....%%%..........%%%............%%%%%%%.........
m %%%%%%%............%%%.............%%..........%%%.......%%%....%%%........%%%%......%%%...........%%...........%%%%%%%%.........
m %%%%%%%%..........%%%..............%%..........%%%......%%%...............%%%%........%%...........%%%......%%%%%%..%%%%........%
m %%%%%%%%%........%%%...........................%%%.....%%%...............%%%%.........%%............%%%%%%%%%%%%%....%%%%......%%
m %......%%%......%%%.........%%%...............%%%%....%%%...............%%%%..........%%............%%%%%%%%%%%%......%%%%....%%%
m ........%%%....%%%..........%%%..............%%%%......%%..............%%%%...........%%.............%%%...............%%%...%%%%
m ........%%%.....%...........%%%.............%%%%......................%%%%....1.......%%...............................%%%...%%%.
m ............................%%%...........%%%%%.....................%%%%%%............%%%%.............................%%%.......
m ............................%%%...........%%%%.....................%%%%%%............%%%%%%%...........................%%........
m ............................%%%............%%.....................%%%................%%%%%%%%%.........................%%........
m ............................%%%...........................%%......%%%................%%...%%%%%%%......................%%........
m ............................%%%..........................%%%%....%%%..........%%%............%%%%%%%...................%%........
m ............................%%%..........................%%%.....%%...........%%...............%%%%%..................%%%........
m ......%%...................%%%................................................%%.................%%%%%%%%%%%%%%.......%%%%.......
m ....%%%%%%................%%%.....%%%..............................................................%%%%%%%%%%%%%%.....%%%%%%.....
m ..%%%%%%%%%%%...........%%%%.......%%..........%%%.................................................%%%%%%%%%%%%%%%.......%%%%%%%.
m %%%%%.%%%%%%%%%%%%%%%%%%%%%........%%%..........%%%%%%%............................................%%%..........%%%........%%%%%%
m %%%%.......%%%%%%%%%%%%%%%..........%%...........%%%%%%%...........%%.............................%%%............%%..........%%%%
