# map type: cell maze
# random seed: -557888051
# players 6
# area 6808, 1134 (33.7^2) per player
# cell width: 1.32471953066
# cell size: 8.28743079471
# openness: 0.0105322978692
# maze type growing
# vert_rotate
# horz_copy
# final parameters
# area: 6480
# grid size: (2, 3)
# tile size: (30, 36) 1.2
# map size: (60, 108) 1.8
# hill distance   1, 99  12, 58  47, 85   1, 27  58,  8  47, 13  12, 94  58, 80   1, 63  58, 44  12, 22  47, 49
#         1, 99       0      78      84      70      20      36      20      68      70      72      86      80 
#        12, 58      78       0      52      86      80      88      94      36      20      84      94     100 
#        47, 85      84      52       0      80      86      94     100      20      36      78      88      94 
#         1, 27      70      86      80       0      68      84      78      72      70      20      20      36 
#        58,  8      20      80      86      68       0      20      36      70      72      70      84      78 
#        47, 13      36      88      94      84      20       0      52      78      80      86     100      94 
#        12, 94      20      94     100      78      36      52       0      84      86      80      94      88 
#        58, 80      68      36      20      72      70      78      84       0      20      70      80      86 
#         1, 63      70      20      36      70      72      80      86      20       0      68      78      84 
#        58, 44      72      84      78      20      70      86      80      70      68       0      36      20 
#        12, 22      86      94      88      20      84     100      94      80      78      36       0      52 
#        47, 49      80     100      94      36      78      94      88      86      84      20      52       0 
players 6
rows 60
cols 108
m .........%%............%%%...................%%............%%%...................%%............%%%..........
m .......%%%...........%%%%..1...............%%%...........%%%%..4...............%%%...........%%%%..5........
m .....%%%%..........%%%%%.................%%%%..........%%%%%.................%%%%..........%%%%%............
m ...%%%%%...........%%%%................%%%%%...........%%%%................%%%%%...........%%%%.............
m ...%%%%............%%%.................%%%%............%%%.................%%%%............%%%..............
m ..................%%%%%...............................%%%%%...............................%%%%%.............
m .................%%...%%%%...........................%%...%%%%...........................%%...%%%%..........
m ................%%......%%%%........................%%......%%%%........................%%......%%%%........
m ...............%%..........%%......................%%..........%%......................%%..........%%.......
m ...............%...................................%...................................%....................
m ..............%%..................................%%..................................%%....................
m ..............%%..................................%%..................................%%....................
m .%%............%%.....0..............%%............%%.....2..............%%............%%.....3.............
m %%..............%%................%%%%..............%%................%%%%..............%%................%%
m ................%%............%%%%%.................%%............%%%%%.................%%............%%%%%.
m .................%%..........%%%%....................%%..........%%%%....................%%..........%%%%...
m .......%..........%%.......%%%%............%..........%%.......%%%%............%..........%%.......%%%%.....
m .......%..........%%%%%%%.%%...............%..........%%%%%%%.%%...............%..........%%%%%%%.%%........
m .......%...........%%%%%%%%................%...........%%%%%%%%................%...........%%%%%%%%.........
m .......%.................%%................%.................%%................%.................%%.........
m .......%.................%%................%.................%%................%.................%%.........
m ......%%.................%%...............%%.................%%...............%%.................%%.........
m %.....%%.................%%........%%.....%%.................%%........%%.....%%.................%%........%
m %......%.................%%........%%......%.................%%........%%......%.................%%........%
m .......%%................%%.......%%.......%%................%%.......%%.......%%................%%.......%%
m ........%%...............%%.......%.........%%...............%%.......%.........%%...............%%.......%.
m .........%%..............%%......%...........%%..............%%......%...........%%..............%%......%..
m ..........%%.............%%....%%%............%%.............%%....%%%............%%.............%%....%%%..
m .........%%..............%%.%%%%.............%%..............%%.%%%%.............%%..............%%.%%%%....
m .......%%%%..............%%%%%.............%%%%..............%%%%%.............%%%%..............%%%%%......
m ......%%%%%..............%%%%.............%%%%%..............%%%%.............%%%%%..............%%%%.......
m ....%%%%.%%..............%%.............%%%%.%%..............%%.............%%%%.%%..............%%.........
m ..%%%....%%.............%%............%%%....%%.............%%............%%%....%%.............%%..........
m ..%......%%..............%%...........%......%%..............%%...........%......%%..............%%.........
m .%.......%%...............%%.........%.......%%...............%%.........%.......%%...............%%........
m %%.......%%................%%.......%%.......%%................%%.......%%.......%%................%%.......
m %........%%.................%......%%........%%.................%......%%........%%.................%......%
m %........%%.................%%.....%%........%%.................%%.....%%........%%.................%%.....%
m .........%%.................%%...............%%.................%%...............%%.................%%......
m .........%%.................%................%%.................%................%%.................%.......
m .........%%.................%................%%.................%................%%.................%.......
m .........%%%%%%%%...........%................%%%%%%%%...........%................%%%%%%%%...........%.......
m ........%%.%%%%%%%..........%...............%%.%%%%%%%..........%...............%%.%%%%%%%..........%.......
m .....%%%%.......%%..........%............%%%%.......%%..........%............%%%%.......%%..........%.......
m ...%%%%..........%%....................%%%%..........%%....................%%%%..........%%.................
m .%%%%%............%%.................%%%%%............%%.................%%%%%............%%................
m %%................%%..............%%%%................%%..............%%%%................%%..............%%
m .............1.....%%............%%..............4.....%%............%%..............5.....%%............%%.
m ....................%%..................................%%..................................%%..............
m ....................%%..................................%%..................................%%..............
m ....................%...................................%...................................%...............
m .......%%..........%%......................%%..........%%......................%%..........%%...............
m ........%%%%......%%........................%%%%......%%........................%%%%......%%................
m ..........%%%%...%%...........................%%%%...%%...........................%%%%...%%.................
m .............%%%%%...............................%%%%%...............................%%%%%..................
m ..............%%%............%%%%.................%%%............%%%%.................%%%............%%%%...
m .............%%%%...........%%%%%................%%%%...........%%%%%................%%%%...........%%%%%...
m ............%%%%%..........%%%%.................%%%%%..........%%%%.................%%%%%..........%%%%.....
m ........0..%%%%...........%%%...............2..%%%%...........%%%...............3..%%%%...........%%%.......
m ..........%%%............%%...................%%%............%%...................%%%............%%.........
