# map type: cell maze
# random seed: 1082339225
# players 3
# area 11521, 3840 (62.0^2) per player
# cell width: 1.49956226177
# cell size: 7.68890215324
# openness: 0.0781854266641
# maze type backtrack
# horz shear step: 2
# horz_shear
# final parameters
# area: 11016
# grid size: (1, 3)
# tile size: (108, 34) 0.314814814815
# map size: (108, 102) 0.944444444444
# hill distance  56, 72  27, 62  95, 98  61, 26  22,  0  90, 36
#        56, 72       0     149      71      77     148     148 
#        27, 62     149       0      78      78      77      71 
#        95, 98      71      78       0      78     149      77 
#        61, 26      77      78      78       0      71     149 
#        22,  0     148      77     149      71       0     148 
#        90, 36     148      71      77     149     148       0 
players 3
rows 102
cols 108
m ..................%%%%%%%%..............................%%...%%.............%%%...%%%...........%%%%%.....%%
m %.........%%%%%%%%%....................................%%.....%%...........%%%......%%...........%.........%
m %........%%%%%%%%%................%%%%%%..............%%......%%...........%%%%......%%%....................
m ........%%%......................%%%%%%%.............%%........%%...........%%%.......%%%...................
m ........%%.............................%%........%%%%%..........%%...........%%.........%...................
m .........%..............................%%........%%%%..........%%...........%%.............................
m .........%.................%............%%........%%............%%%%%%%.......%.............................
m .........%..............%%%%%%...........%........%%...........%%%..%%%.......%%............................
m .........%.........%%%%%%%%%.%%.........%%........%%..........%%.....%%.......%%...........................%
m %%.......%%........%%%%.......%%%.......%.........%.........%%%.......%........%%...............%%%.......%%
m %%%.....%%........%%...........%%%%....%%........%%........%%%........%........%%..............%%.......%%%.
m ..%%%...%%........%...............%%%%%%%........%%........%%.........%.........%............%%%.......%%...
m ...%%%%%%.........%%................%%...........%%........%%.........%................%%%%%%%.........%....
m .....%%%..........%%.............................%.........%%.........%%.............%%%...%%..........%....
m ......%%..........%%............................%%..........%.........%%.............%%................%....
m ......%%...........%............................%%....................%%.............%%................%....
m ......%%..........%%.......%....................%%..................%%%%%............%.................%....
m ......%%.........%%.....%%%%%%................%%%%................%%%%..%%..........%%..............%%%%%...
m ......%%.......%%%.....%%%..%%%..............%%%.%%%%%%%..........%......%%.........%%.........%%%%%%%%%%%..
m ......%%%.....%%..............%%%..........%%%............................%%......%%%..........%%%%.....%...
m .......%%%%.%%%................%%%%%......%%..............................%%%%%%%%%%%.........%%............
m .........%%%%%...................%%%%...%%%................................%%%%%..............%%............
m 0..........%%.....................%.%%%%%.....................%%%.............................%.............
m ............%.........................%%...................%%%%%%............................%%.............
m ............%%.........%%%............%%..................%%%..............................%%%..............
m ............%%%%.....%%%%%%............%..................%%..........................%%%%%%................
m ..............%%%%..%%%...%%%..........%%................%%...............%%%........%%%.%%.................
m %%...............%%%%......%%%..........%.........%......%%...0..........%%%%%%%...%%%.................%%%%%
m %%.................%.........%..........%%.......%%%%%%%%%..............%%%...%%%%%%%................%%%%%%%
m .%%..........................%..........%%......%%%....................%%%......%%%.................%%%.....
m ..%%.........................%..........%%.....%%.....................%%%...........................%%......
m ...%%%%%%%%.................%%...........%%...%%.....................%%%...........................%%.......
m ....%%%%%%%................%%............%%.%%%%...................%%%%...........................%%........
m ..........................%%.............%%%%%%%................%%%%%%%....................%%%%%%%%.........
m ....................%%...%%.............%%%...%%%...........%%%%%.....%%..................%%%%%%%%..........
m ...................%%.....%%...........%%%......%%...........%.........%%.........%%%%%%%%%.................
m %%%%..............%%......%%...........%%%%......%%%....................%........%%%%%%%%%................%%
m %%%%.............%%........%%...........%%%.......%%%...........................%%%......................%%%
m ...%%........%%%%%..........%%...........%%.........%...........................%%..........................
m ....%%........%%%%..........%%...........%%......................................%..........................
m ....%%........%%............%%%%%%%.......%......................................%.................%........
m .....%........%%...........%%%..%%%.......%%.....................................%..............%%%%%%......
m ....%%........%%..........%%.....%%.......%%...........................%.........%.........%%%%%%%%%.%%.....
m ....%.........%.........%%%.......%........%%...............%%%.......%%%%.......%%........%%%%.......%%%...
m ...%%........%%........%%%........%........%%..............%%.......%%%.%%%.....%%........%%...........%%%%.
m %%%%%........%%........%%.........%.........%............%%%.......%%.....%%%...%%........%...............%%
m %%...........%%........%%.........%................%%%%%%%.........%.......%%%%%%.........%%................
m .............%.........%%.........%%.............%%%...%%..........%.........%%%..........%%................
m ............%%..........%.........%%.............%%................%..........%%..........%%................
m ............%%....................%%.............%%................%..........%%...........%................
m ............%%..................%%%%%............%.................%..........%%..........%%.......%........
m ..........%%%%................%%%%..%%..........%%..............%%%%%.........%%.........%%.....%%%%%%......
m .........%%%.%%%%%%%..........%......%%.........%%.........%%%%%%%%%%%........%%.......%%%.....%%%..%%%.....
m .......%%%............................%%......%%%..........%%%%.....%.........%%%.....%%..............%%%...
m ......%%..............................%%%%%%%%%%%.........%%...................%%%%.%%%................%%%%%
m %...%%%................................%%%%%..............%%.....................%%%%%...................%%%
m %%%%%.....................%%%.............................%.............1..........%%.....................%.
m ..%%...................%%%%%%............................%%.........................%.......................
m ..%%..................%%%..............................%%%..........................%%.........%%%..........
m ...%..................%%..........................%%%%%%............................%%%%.....%%%%%%.........
m ...%%................%%...............%%%........%%%.%%...............................%%%%..%%%...%%%.......
m ....%.........%......%%...1..........%%%%%%%...%%%.................%%%%%%%...............%%%%......%%%......
m ....%%.......%%%%%%%%%..............%%%...%%%%%%%................%%%%%%%%%.................%.........%......
m ....%%......%%%....................%%%......%%%.................%%%......%%..........................%......
m ....%%.....%%.....................%%%...........................%%........%%.........................%......
m .....%%...%%.....................%%%...........................%%..........%%%%%%%%.................%%......
m .....%%.%%%%...................%%%%...........................%%............%%%%%%%................%%.......
m .....%%%%%%%................%%%%%%%....................%%%%%%%%...................................%%........
m ....%%%...%%%...........%%%%%.....%%..................%%%%%%%%..............................%%...%%.........
m ...%%%......%%...........%.........%%.........%%%%%%%%%....................................%%.....%%........
m ...%%%%......%%%....................%........%%%%%%%%%................%%%%%%..............%%......%%........
m ....%%%.......%%%...........................%%%......................%%%%%%%.............%%........%%.......
m .....%%.........%...........................%%.............................%%........%%%%%..........%%......
m .....%%......................................%..............................%%........%%%%..........%%......
m ......%......................................%.................%............%%........%%............%%%%%%%.
m ......%%.....................................%..............%%%%%%...........%........%%...........%%%..%%%.
m ......%%...........................%.........%.........%%%%%%%%%.%%.........%%........%%..........%%.....%%.
m .......%%...............%%%.......%%%%.......%%........%%%%.......%%%.......%.........%.........%%%.......%.
m .......%%..............%%.......%%%.%%%.....%%........%%...........%%%%....%%........%%........%%%........%.
m ........%............%%%.......%%.....%%%...%%........%...............%%%%%%%........%%........%%.........%.
m ...............%%%%%%%.........%.......%%%%%%.........%%................%%...........%%........%%.........%.
m .............%%%...%%..........%.........%%%..........%%.............................%.........%%.........%%
m .............%%................%..........%%..........%%............................%%..........%.........%%
m .............%%................%..........%%...........%............................%%....................%%
m %............%.................%..........%%..........%%.......%....................%%..................%%%%
m %%..........%%..............%%%%%.........%%.........%%.....%%%%%%................%%%%................%%%%..
m .%%.........%%.........%%%%%%%%%%%........%%.......%%%.....%%%..%%%..............%%%.%%%%%%%..........%.....
m ..%%......%%%..........%%%%.....%.........%%%.....%%..............%%%..........%%%..........................
m ..%%%%%%%%%%%.........%%...................%%%%.%%%................%%%%%......%%............................
m ...%%%%%..............%%.....................%%%%%...................%%%%...%%%.............................
m ......................%.............2..........%%.....................%.%%%%%.....................%%%.......
m .....................%%.........................%.........................%%...................%%%%%%.......
m ...................%%%..........................%%.........%%%............%%..................%%%...........
m ..............%%%%%%............................%%%%.....%%%%%%............%..................%%............
m ..%%%........%%%.%%...............................%%%%..%%%...%%%..........%%................%%.............
m .%%%%%%%...%%%.................%%%%%%%...............%%%%......%%%..........%.........%......%%...2.........
m %%%...%%%%%%%................%%%%%%%%%.................%.........%..........%%.......%%%%%%%%%..............
m %%......%%%.................%%%......%%..........................%..........%%......%%%....................%
m %...........................%%........%%.........................%..........%%.....%%.....................%%
m ...........................%%..........%%%%%%%%.................%%...........%%...%%.....................%%%
m ..........................%%............%%%%%%%................%%............%%.%%%%...................%%%%.
m ...................%%%%%%%%...................................%%.............%%%%%%%................%%%%%%%.
