# map type: blank
# random seed: 37377094
# hill distance  95, 44  17,104  60,100  34, 40  99, 10   4, 14  47, 10  73, 70  56, 14  30, 74  86, 40  21, 70  82, 74  43, 44  69,104   8,100
#        95, 44       0      90     107      51      40      47      90      64      79      79      33      56      47      72      90      77 
#        17,104      90       0      51      77      64      47      56      90      79      47     107      40      79      90      72      33 
#        60,100     107      51       0      86      69      90      55      55      40      56      86      69      64      77      33      76 
#        34, 40      51      77      86       0      69      56      55      69      64      40      76      55      90      33     107      86 
#        99, 10      40      64      69      69       0      33      76      86      51     107      55      86      77      90      56      55 
#         4, 14      47      47      90      56      33       0      51     107      72      90      64      77      90      79      79      40 
#        47, 10      90      56      55      55      76      51       0      86      33      77      69      86     107      40      64      69 
#        73, 70      64      90      55      69      86     107      86       0      77      51      55      76      33      56      40      69 
#        56, 14      79      79      40      64      51      72      33      77       0      90      56     107      90      47      47      90 
#        30, 74      79      47      56      40     107      90      77      51      90       0      90      33      72      47      79      64 
#        86, 40      33     107      86      76      55      64      69      55      56      90       0      69      40      51      77      86 
#        21, 70      56      40      69      55      86      77      86      76     107      33      69       0      51      64      90      55 
#        82, 74      47      79      64      90      77      90     107      33      90      72      40      51       0      79      47      56 
#        43, 44      72      90      77      33      90      79      40      56      47      47      51      64      79       0      90     107 
#        69,104      90      72      33     107      56      79      64      40      47      79      77      90      47      90       0      51 
#         8,100      77      33      76      86      55      40      69      69      90      64      86      55      56     107      51       0 
players 8
rows 104
cols 120
m ......%%..%%%.......%............%........%...........%............%..........%....................%%..............%....
m ......%%%%%.........%%...........%.........%.........%%..........%%%%.........%.....................%%%%...........%....
m ......%%............%%...........%...................%.........%%%...%........%%...................................%....
m .....%%.............%%...........%...................%........%%......%.......%.......%%...........................%%...
m ....%%........5.....%%...........%...................%........................%........%............................%...
m ...%%...............%%..........%%...................%........................%........%%...............................
m ..%%............................%..........%.........%........................%.........%...............................
m .%%........................................%%.................................%..........%..............................
m .%%.........................................%%...............%................%..........%%%%%......0...................
m ..............................................%%...........%%%%%..............%.........%%...%%.........................
m .............%...........%%....................%%.........%%...%%%............%........%%.....%%..........%%............
m ............%............%%..........%%.........%................%%%..........%.......%%.......%........%%%%%%..........
m ..%.........%............%...........%%.........%..................%%%........%......%%.........%.....%%%....%%.........
m ...%........%...........%............%..........%....................%%..............%..........%%..%%%.......%.........
m ...%.........%.........%%..........%%%%.........%.....................%%%%...........%..........%%%%%.........%%........
m ...%...................%.........%%%...%........%%...................................%..........%%............%%........
m ...%...................%........%%......%.......%.......%%...........................%%........%%.............%%........
m ...%...................%........................%........%............................%.......%%........6.....%%........
m ..%%...................%........................%........%%..................................%%...............%%........
m ..%..........%.........%........................%.........%.................................%%..........................
m .............%%.................................%..........%...............................%%...........................
m ..............%%...............%................%..........%%%%%......1....................%%...........................
m ................%%...........%%%%%..............%.........%%...%%.......................................................
m .................%%.........%%...%%%............%........%%.....%%..........%%.........................%...........%%...
m .......%%.........%................%%%..........%.......%%.......%........%%%%%%......................%............%%...
m .......%%.........%..................%%%........%......%%.........%.....%%%....%%...........%.........%............%....
m .......%..........%....................%%..............%..........%%..%%%.......%............%........%...........%.....
m .....%%%%.........%.....................%%%%...........%..........%%%%%.........%%...........%.........%.........%%.....
m ...%%%...%........%%...................................%..........%%............%%...........%...................%......
m ..%%......%.......%.......%%...........................%%........%%.............%%...........%...................%......
m ..................%........%............................%.......%%........7.....%%...........%...................%......
m ..................%........%%..................................%%...............%%..........%%...................%......
m ..................%.........%.................................%%............................%..........%.........%......
m ..................%..........%...............................%%........................................%%...............
m .%................%..........%%%%%......2....................%%.........................................%%..............
m %%%%..............%.........%%...%%.......................................................................%%...........%
m ...%%%............%........%%.....%%..........%%.........................%...........%%....................%%.........%%
m .....%%%..........%.......%%.......%........%%%%%%......................%............%%..........%%.........%...........
m .......%%%........%......%%.........%.....%%%....%%...........%.........%............%...........%%.........%...........
m .........%%..............%..........%%..%%%.......%............%........%...........%............%..........%...........
m ..........%%%%...........%..........%%%%%.........%%...........%.........%.........%%..........%%%%.........%...........
m .........................%..........%%............%%...........%...................%.........%%%...%........%%..........
m .........................%%........%%.............%%...........%...................%........%%......%.......%.......%%..
m ..........................%.......%%........0.....%%...........%...................%........................%........%..
m .................................%%...............%%..........%%...................%........................%........%%.
m ................................%%............................%..........%.........%........................%.........%.
m ...............................%%........................................%%.................................%..........%
m %%%%......3....................%%.........................................%%...............%................%..........%
m ...%%.......................................................................%%...........%%%%%..............%.........%%
m ....%%..........%%.........................%...........%%....................%%.........%%...%%%............%........%%.
m .....%........%%%%%%......................%............%%..........%%.........%................%%%..........%.......%%..
m ......%.....%%%....%%...........%.........%............%...........%%.........%..................%%%........%......%%...
m ......%%..%%%.......%............%........%...........%............%..........%....................%%..............%....
m ......%%%%%.........%%...........%.........%.........%%..........%%%%.........%.....................%%%%...........%....
m ......%%............%%...........%...................%.........%%%...%........%%...................................%....
m .....%%.............%%...........%...................%........%%......%.......%.......%%...........................%%...
m ....%%........1.....%%...........%...................%........................%........%............................%...
m ...%%...............%%..........%%...................%........................%........%%...............................
m ..%%............................%..........%.........%........................%.........%...............................
m .%%........................................%%.................................%..........%..............................
m .%%.........................................%%...............%................%..........%%%%%......4...................
m ..............................................%%...........%%%%%..............%.........%%...%%.........................
m .............%...........%%....................%%.........%%...%%%............%........%%.....%%..........%%............
m ............%............%%..........%%.........%................%%%..........%.......%%.......%........%%%%%%..........
m ..%.........%............%...........%%.........%..................%%%........%......%%.........%.....%%%....%%.........
m ...%........%...........%............%..........%....................%%..............%..........%%..%%%.......%.........
m ...%.........%.........%%..........%%%%.........%.....................%%%%...........%..........%%%%%.........%%........
m ...%...................%.........%%%...%........%%...................................%..........%%............%%........
m ...%...................%........%%......%.......%.......%%...........................%%........%%.............%%........
m ...%...................%........................%........%............................%.......%%........2.....%%........
m ..%%...................%........................%........%%..................................%%...............%%........
m ..%..........%.........%........................%.........%.................................%%..........................
m .............%%.................................%..........%...............................%%...........................
m ..............%%...............%................%..........%%%%%......5....................%%...........................
m ................%%...........%%%%%..............%.........%%...%%.......................................................
m .................%%.........%%...%%%............%........%%.....%%..........%%.........................%...........%%...
m .......%%.........%................%%%..........%.......%%.......%........%%%%%%......................%............%%...
m .......%%.........%..................%%%........%......%%.........%.....%%%....%%...........%.........%............%....
m .......%..........%....................%%..............%..........%%..%%%.......%............%........%...........%.....
m .....%%%%.........%.....................%%%%...........%..........%%%%%.........%%...........%.........%.........%%.....
m ...%%%...%........%%...................................%..........%%............%%...........%...................%......
m ..%%......%.......%.......%%...........................%%........%%.............%%...........%...................%......
m ..................%........%............................%.......%%........3.....%%...........%...................%......
m ..................%........%%..................................%%...............%%..........%%...................%......
m ..................%.........%.................................%%............................%..........%.........%......
m ..................%..........%...............................%%........................................%%...............
m .%................%..........%%%%%......6....................%%.........................................%%..............
m %%%%..............%.........%%...%%.......................................................................%%...........%
m ...%%%............%........%%.....%%..........%%.........................%...........%%....................%%.........%%
m .....%%%..........%.......%%.......%........%%%%%%......................%............%%..........%%.........%...........
m .......%%%........%......%%.........%.....%%%....%%...........%.........%............%...........%%.........%...........
m .........%%..............%..........%%..%%%.......%............%........%...........%............%..........%...........
m ..........%%%%...........%..........%%%%%.........%%...........%.........%.........%%..........%%%%.........%...........
m .........................%..........%%............%%...........%...................%.........%%%...%........%%..........
m .........................%%........%%.............%%...........%...................%........%%......%.......%.......%%..
m ..........................%.......%%........4.....%%...........%...................%........................%........%..
m .................................%%...............%%..........%%...................%........................%........%%.
m ................................%%............................%..........%.........%........................%.........%.
m ...............................%%........................................%%.................................%..........%
m %%%%......7....................%%.........................................%%...............%................%..........%
m ...%%.......................................................................%%...........%%%%%..............%.........%%
m ....%%..........%%.........................%...........%%....................%%.........%%...%%%............%........%%.
m .....%........%%%%%%......................%............%%..........%%.........%................%%%..........%.......%%..
m ......%.....%%%....%%...........%.........%............%...........%%.........%..................%%%........%......%%...
