# map type: cell maze
# random seed: -192545249
# players 3
# area 12317, 4105 (64.1^2) per player
# cell width: 1.34147903941
# cell size: 7.86041447444
# openness: 0.136774758728
# maze type backtrack
# horz shear step: 1
# horz_shear
# final parameters
# area: 11880
# grid size: (1, 3)
# tile size: (60, 66) 1.1
# map size: (60, 198) 3.3
# hill distance  17,178  37, 46  57,112
#        17,178       0     150     150 
#        37, 46     150       0     150 
#        57,112     150     150       0 
players 3
rows 60
cols 198
m %.....%%%...........%%................%%....................%..........%%%%%%%...........%%%%%..............%%.....................%%..............%%%.........%%.........%%..........................
m %%..%%%............%%..................%%%..................%.........%%.%%%%...............%%%%%%%.........%%.....................%...........................%%..........%..........................
m .%%%%%.............%%...................%%%................%%.........%..........................%%%.........%%....................%...........................%%..........%%.....%%..................
m .%%%%.............%%.....................%%..............%%%.........%%............................%%.........%%...................%............................%..........%%%%%%%%......%%...........
m .%%..............%%......................%%..........%%%%%...........%..............................%%.........%.................%%%............................%.........%..............%%...........
m .%%%.............%%......................%%..........%%.............%...................%...........%..........................%%%.............................%.........%%...............%%..........
m %%%%%%............%%.....................%%........................%%..................%%%..........%%.......................%%%......................%%%%%%%%%%.........%%................%%.........
m %...%%%%...........%..........%..........%%........................%..................%%%%%.........%%......................%%%.......................%..................%%................%%%%%%%%%%%
m .......%%%....................%%..........%%...................%%%%%................%%....%%.........%%.........%..........%%%............%%.........%%..................%.................%.....%%%%%
m .........%%%..................%............%%%%...............%%%..%%..............%%.......%%........%........%%..........%%............%%..........%...................%................%%..........
m ...........%..................%...............%%%%%%..........%%....%..........%%%%%.........%%........%.......%...........%%...........%%..........%%...................%................%...........
m ...........%..................%..................%%%%%.......%.......%........%%..%%%.........%........%%%%%%%%%...........%%...........%%.........%%...........%.......%%...............%%...........
m ...........%..................%.....................%%%....%%................%%....%%...................%%%%%.%%............%%..........%%..........%...........%%%%....%%........%%%....%............
m ...........%..................%.......................%%%.%%%.......................%%.........................%.............%%..........%..........%..........%%..%%%%%%%......%%%.%%%%%%............
m ...........%.................%%.........................%%%%.........................%.........................%%.............%%.........%..........%%........%%......%%......%%%.....%%%%...........%
m ...........%.........%......%%...........................%%...........................%........................%%..............%.........%..........%%.......%%..............%%.........%............%
m %..........%........%%.....%%.............................%...........................%%......%.................%..............%.........%.........%%%......%%...............%%.........%%...........%
m %%.........%.......%%......%..........%......................................%.........%%.....%%...%%%%.........%%.............%%........%%.......%%.......%%%................%...2......%............
m %%........%%%%....%%.......%..........%.....................................%%.........%%......%%%%%%%%%........%%%%%%.........%.........%%......%%.......%%%.................%..........%%...........
m %.......%%%.%%%%%%%........%%.........%%..................................%%%..........%%.......%......%%............%........%%.........%%....%%.........%%%%................%............%.........%
m %..............%%%.........%%.........%%..........................%.....%%%...........%%................%%....................%..........%%%%%%%...........%%%%%..............%%.....................%
m ...........................%%..........%..........................%%..%%%............%%..................%%%..................%.........%%.%%%%...............%%%%%%%.........%%.....................%
m ...........................%%..........%%.....%%...................%%%%%.............%%...................%%%................%%.........%..........................%%%.........%%....................%
m ............................%..........%%%%%%%%......%%............%%%%.............%%.....................%%..............%%%.........%%............................%%.........%%...................%
m ............................%.........%..............%%............%%..............%%......................%%..........%%%%%...........%..............................%%.........%.................%%%
m ...........................%.........%%...............%%...........%%%.............%%......................%%..........%%.............%...................%...........%..........................%%%..
m ..................%%%%%%%%%%.........%%................%%.........%%%%%%............%%.....................%%........................%%..................%%%..........%%.......................%%%....
m ..................%..................%%................%%%%%%%%%%%%...%%%%...........%..........%..........%%........................%..................%%%%%.........%%......................%%%.....
m ......%%.........%%..................%.................%.....%%%%%.......%%%....................%%..........%%...................%%%%%................%%....%%.........%%.........%..........%%%......
m .....%%..........%...................%................%%...................%%%..................%............%%%%...............%%%..%%..............%%.......%%........%........%%..........%%.......
m ....%%..........%%...................%................%......................%..................%...............%%%%%%..........%%....%..........%%%%%.........%%........%.......%...........%%.......
m ....%%.........%%...........%.......%%...............%%......................%..................%..................%%%%%.......%.......%........%%..%%%.........%........%%%%%%%%%...........%%.......
m ....%%..........%...........%%%%....%%........%%%....%.......................%..................%.....................%%%....%%................%%....%%...................%%%%%.%%............%%......
m .....%..........%..........%%..%%%%%%%......%%%.%%%%%%.......................%..................%.......................%%%.%%%.......................%%.........................%.............%%.....
m .....%..........%%........%%......%%......%%%.....%%%%...........%...........%.................%%.........................%%%%.........................%.........................%%.............%%....
m .....%..........%%.......%%..............%%.........%............%...........%.........%......%%...........................%%...........................%........................%%..............%....
m .....%.........%%%......%%...............%%.........%%...........%%..........%........%%.....%%.............................%...........................%%......%.................%..............%....
m .....%%.......%%.......%%%................%...0......%............%%.........%.......%%......%..........%......................................%.........%%.....%%...%%%%.........%%.............%%...
m .....%%......%%.......%%%.................%..........%%...........%%........%%%%....%%.......%..........%.....................................%%.........%%......%%%%%%%%%........%%%%%%.........%....
m .....%%....%%.........%%%%................%............%.........%%.......%%%.%%%%%%%........%%.........%%..................................%%%..........%%.......%......%%............%........%%....
m .....%%%%%%%...........%%%%%..............%%.....................%%..............%%%.........%%.........%%..........................%.....%%%...........%%................%%....................%.....
m ....%%.%%%%...............%%%%%%%.........%%.....................%...........................%%..........%..........................%%..%%%............%%..................%%%..................%.....
m ....%..........................%%%.........%%....................%...........................%%..........%%.....%%...................%%%%%.............%%...................%%%................%%.....
m ...%%............................%%.........%%...................%............................%..........%%%%%%%%......%%............%%%%.............%%.....................%%..............%%%......
m ...%..............................%%.........%.................%%%............................%.........%..............%%............%%..............%%......................%%..........%%%%%........
m ..%...................%...........%..........................%%%.............................%.........%%...............%%...........%%%.............%%......................%%..........%%...........
m .%%..................%%%..........%%.......................%%%......................%%%%%%%%%%.........%%................%%.........%%%%%%............%%.....................%%.......................
m .%..................%%%%%.........%%......................%%%.......................%..................%%................%%%%%%%%%%%%...%%%%...........%..........%..........%%.......................
m %%................%%....%%.........%%.........%..........%%%............%%.........%%..................%.................%.....%%%%%.......%%%....................%%..........%%...................%%%
m .%%..............%%.......%%........%........%%..........%%............%%..........%...................%................%%...................%%%..................%............%%%%...............%%%.
m ..%..........%%%%%.........%%........%.......%...........%%...........%%..........%%...................%................%......................%..................%...............%%%%%%..........%%..
m ...%........%%..%%%.........%........%%%%%%%%%...........%%...........%%.........%%...........%.......%%...............%%......................%..................%..................%%%%%.......%....
m ...........%%....%%...................%%%%%.%%............%%..........%%..........%...........%%%%....%%........%%%....%.......................%..................%.....................%%%....%%.....
m ..................%%.........................%.............%%..........%..........%..........%%..%%%%%%%......%%%.%%%%%%.......................%..................%.......................%%%.%%%.....
m ...................%.........................%%.............%%.........%..........%%........%%......%%......%%%.....%%%%...........%...........%.................%%.........................%%%%......
m ....................%........................%%..............%.........%..........%%.......%%..............%%.........%............%...........%.........%......%%...........................%%.......
m ....................%%......%.................%..............%.........%.........%%%......%%...............%%.........%%...........%%..........%........%%.....%%.............................%.......
m ...........%.........%%.....%%...%%%%.........%%.............%%........%%.......%%.......%%%................%...1......%............%%.........%.......%%......%..........%...........................
m ..........%%.........%%......%%%%%%%%%........%%%%%%.........%.........%%......%%.......%%%.................%..........%%...........%%........%%%%....%%.......%..........%...........................
m ........%%%..........%%.......%......%%............%........%%.........%%....%%.........%%%%................%............%.........%%.......%%%.%%%%%%%........%%.........%%..........................
