# random seed 3266485998379061860
# players 3
# area 13548
# cell width: 1.28435621977
# cell size: 7
# openness: 0.152202172774
# grid size: (1, 3)
# tile size: (129, 34) 0.263565891473
# map size: (129, 102) 0.790697674419
# horz shear step: 1
# horz_shear
# maze type recursive backtracker
# final openness 0.152202172774
# map_type cell_maze
# random_seed 3266485998379061860
players 3
rows 102
cols 129
m ................%%............%%..................%................%%......................%.............%........%%.............
m .................%............%%%%%..............%%................%..................%%...%%...........%..........%%............
m .........%.......%%.........%%%%%%%%............%%.................%.................%%%....%%.........%%..........%%%%..........
m ........%........%%%..........%............%%%%%%........%.........%%%%%%%...........%%...........%%..............%%%............
m %%.....%%.........%%%....................%%%%%%%.......%%%.....%%%%%.....%%%%.......%%............%%..............%%............%
m %%%%%%%%............%%%................%%%.............%%.......%%..........%.......%..............%.............%%.............%
m .......%..............%%...............%%..............%.........%%.........%......%%..............%.............%.......%%......
m .......%%..............%...............%%..............%.........%%.........%%.....%...............%............%%.......%%......
m ........%%.............................%%..............%.........%%..........%....%%...............%%..........%%........%.......
m .........%.............................%%...........%%%%.........%%..............%%................%%.......%%%%%.......%%.......
m .........%%%%%%................%.......%%........%%%%..............%.............%%.................%.......%%%%........%%.......
m ..........%%%%%%.......%......%%%%%...%%%.......%%..................%......................%........%......%............%........
m .........%.....%%%....%%.....%%...%%%%%........%%....................%...................%%%........%.....%............%%........
m %%......%%.......%%..%%......%.......%.........%...........%..........%%.................%%.........%%%%%%...........%%%%%.......
m %.......%.........%%%%........................%%..........%%..........%%%................%........%%................%%...%%....%%
m .......%......................................%%..........%............%%................%........%................%%......%%%%%.
m ......%%.....................................%%..........%%..............%.....%%%.......%.........................%........%%...
m ......%%.....................................%..........%%................%%%%%%%%.......%.........................%.............
m .....%%.............................%.......%%........%%..................%%%.....%.....%%........................%%.............
m .....%..............................%%.....%%........%%............................%%...%%........................%..............
m ....%%........................%.......%%.%%%...................%%%%................%%%.%%%%%%...%%%.........%..%%%%..............
m ...%%.........%..............%%........%%%.....................%....................%%%....%%%%%%.%%...%%%%%%%%%...%.............
m ...%..........%..........%%%%%...........................................%%..........%........%....%%%%%%...........%............
m %%%%..........%%..........%%%.........................................%%%%..........%%......................................%%%%%
m ..............%%............%%........................................%.............%.......................................%%...
m ...............%%...........%%%%.....................%................%.......%%%%%%%.......................................%....
m .................%..........%%%%%%%...............%%%%%..............%%......%%%%%..%.......................................%....
m ............................%%....%%%%..........%%%...%%%............%...............%......................%..........1....%....
m ............................%........%%........%%.......%%%.......%%%%...............%...................%%%%...............%....
m ......%%....................%.........%%.................%%%%%%%%%%%.%%..............%...........%%%%%%%%%...%....%%%.......%....
m ......%%....................%...........%%.................%%%%.......%%............%%.......%%%%%%..%%.......%%%%..%%%.....%....
m ...........................%%............%%%...............%%..........%%....................%................%%......%%%%%%%....
m ...........................%%..............................%%...........%%...................%................%%.........%%%%....
m ...................%.......%%..............................%%...........%%%..................%................%%.................
m .....%.............%........%%.............................%%............%%..................%................%%.................
m %%...%%...........%..........%%.............................%............%%%%%..............%%................%..................
m %%....%%.........%%..........%%%%...................%.......%%.........%%%%%%%%............%%.................%.................%
m %...........%%..............%%%....................%........%%%..........%............%%%%%%........%.........%%%%%%%...........%
m ............%%..............%%............%%%.....%%.........%%%....................%%%%%%%.......%%%.....%%%%%.....%%%%.......%%
m .............%.............%%.............%%%%%%%%%............%%%................%%%.............%%.......%%..........%.......%.
m .............%.............%.......%%.............%..............%%...............%%..............%.........%%.........%......%%.
m .............%............%%.......%%.............%%..............%...............%%..............%.........%%.........%%.....%..
m .............%%..........%%........%...............%%.............................%%..............%.........%%..........%....%%..
m .............%%.......%%%%%.......%%................%.............................%%...........%%%%.........%%..............%%...
m ..............%.......%%%%........%%................%%%%%%................%.......%%........%%%%..............%.............%%...
m .....%........%......%............%..................%%%%%%.......%......%%%%%...%%%.......%%..................%.................
m ...%%%........%.....%............%%.................%.....%%%....%%.....%%...%%%%%........%%....................%................
m ...%%.........%%%%%%...........%%%%%.......%%......%%.......%%..%%......%.......%.........%...........%..........%%..............
m ...%........%%................%%...%%....%%%.......%.........%%%%........................%%..........%%..........%%%.............
m ...%........%................%%......%%%%%........%......................................%%..........%............%%.............
m ...%.........................%........%%.........%%.....................................%%..........%%..............%.....%%%....
m ...%.........................%...................%%.....................................%..........%%................%%%%%%%%....
m ..%%........................%%..................%%.............................%.......%%........%%..................%%%.....%...
m ..%%........................%...................%..............................%%.....%%........%%............................%%.
m .%%%%%%...%%%.........%..%%%%..................%%........................%.......%%.%%%...................%%%%................%%%
m %....%%%%%%.%%...%%%%%%%%%...%................%%.........%..............%%........%%%.....................%....................%%
m ........%....%%%%%%...........%...............%..........%..........%%%%%...........................................%%..........%
m ......................................%%%%%%%%%..........%%..........%%%.........................................%%%%..........%%
m ......................................%%.................%%............%%........................................%.............%.
m ......................................%...................%%...........%%%%.....................%................%.......%%%%%%%.
m ......................................%.....................%..........%%%%%%%...............%%%%%..............%%......%%%%%..%.
m ......................%..........0....%................................%%....%%%%..........%%%...%%%............%...............%
m ...................%%%%...............%................................%........%%........%%.......%%%.......%%%%...............%
m ...........%%%%%%%%%...%....%%%.......%..........%%....................%.........%%.................%%%%%%%%%%%.%%..............%
m .......%%%%%%..%%.......%%%%..%%%.....%..........%%....................%...........%%.................%%%%.......%%............%%
m .......%................%%......%%%%%%%...............................%%............%%%...............%%..........%%.............
m .......%................%%.........%%%%...............................%%..............................%%...........%%............
m .......%................%%....................................%.......%%..............................%%...........%%%...........
m .......%................%%......................%.............%........%%.............................%%............%%...........
m ......%%................%..................%%...%%...........%..........%%.............................%............%%%%%........
m .....%%.................%.................%%%....%%.........%%..........%%%%...................%.......%%.........%%%%%%%%.......
m %%%%%%........%.........%%%%%%%...........%%...........%%..............%%%....................%........%%%..........%............
m %%%%%.......%%%.....%%%%%.....%%%%.......%%............%%..............%%............%%%.....%%.........%%%....................%%
m ............%%.......%%..........%.......%..............%.............%%.............%%%%%%%%%............%%%................%%%.
m ............%.........%%.........%......%%..............%.............%.......%%.............%..............%%...............%%..
m ............%.........%%.........%%.....%...............%............%%.......%%.............%%..............%...............%%..
m ............%.........%%..........%....%%...............%%..........%%........%...............%%.............................%%..
m .........%%%%.........%%..............%%................%%.......%%%%%.......%%................%.............................%%..
m ......%%%%..............%.............%%.................%.......%%%%........%%................%%%%%%................%.......%%..
m .....%%..................%......................%........%......%............%..................%%%%%%.......%......%%%%%...%%%..
m ....%%....................%...................%%%........%.....%............%%.................%.....%%%....%%.....%%...%%%%%....
m ....%...........%..........%%.................%%.........%%%%%%...........%%%%%.......%%......%%.......%%..%%......%.......%.....
m ...%%..........%%..........%%%................%........%%................%%...%%....%%%.......%.........%%%%.....................
m ...%%..........%............%%................%........%................%%......%%%%%........%...................................
m ..%%..........%%..............%.....%%%.......%.........................%........%%.........%%...................................
m ..%..........%%................%%%%%%%%.......%.........................%...................%%...................................
m .%%........%%..................%%%.....%.....%%........................%%..................%%.............................%......
m %%........%%............................%%...%%........................%...................%..............................%%.....
m %...................%%%%................%%%.%%%%%%...%%%.........%..%%%%..................%%........................%.......%%.%%
m ....................%....................%%%....%%%%%%.%%...%%%%%%%%%...%................%%.........%..............%%........%%%.
m ..............................%%..........%........%....%%%%%%...........%...............%..........%..........%%%%%.............
m ...........................%%%%..........%%......................................%%%%%%%%%..........%%..........%%%..............
m ...........................%.............%.......................................%%.................%%............%%.............
m ..........%................%.......%%%%%%%.......................................%...................%%...........%%%%...........
m .......%%%%%..............%%......%%%%%..%.......................................%.....................%..........%%%%%%%........
m .....%%%...%%%............%...............%......................%..........2....%................................%%....%%%%.....
m ....%%.......%%%.......%%%%...............%...................%%%%...............%................................%........%%....
m ..............%%%%%%%%%%%.%%..............%...........%%%%%%%%%...%....%%%.......%..........%%....................%.........%%...
m ................%%%%.......%%............%%.......%%%%%%..%%.......%%%%..%%%.....%..........%%....................%...........%%.
m %...............%%..........%%....................%................%%......%%%%%%%...............................%%............%%
m ................%%...........%%...................%................%%.........%%%%...............................%%..............
m ................%%...........%%%..................%................%%....................................%.......%%..............
