# map type: cell maze
# random seed: -1917628824
# players 5
# area 11734, 2346 (48.4^2) per player
# cell width: 1.38872977907
# cell size: 7.47964611265
# openness: 0.455464608044
# maze type backtrack
# horz shear step: 1
# horz_shear
# final parameters
# area: 11000
# grid size: (1, 5)
# tile size: (55, 40) 0.727272727273
# map size: (55, 200) 3.63636363636
# hill distance   9,106  20,146  53, 66  31,186  42, 26
#         9,106       0      65      65     113     113 
#        20,146      65       0     113      65     113 
#        53, 66      65     113       0     113      65 
#        31,186     113      65     113       0      65 
#        42, 26     113     113      65      65       0 
players 5
rows 55
cols 200
m .........%%%%.........%%%..............................................%%...................%................%........%%%...................%%%%%%%%%...............%%%.........%%%%%%.............%....
m ....%%%%%%%.%%.......%%......%%......................................%%%%..........%........%................%...............................%%%...%%%%%............%...........%.................%%....
m ....%%..............%%.......%%...........%%%%%%%...........%%%%%%%%%%%%..........%%........%...............%%................................%%......%%%%%.........%%...........................%%.....
m ...................%%.........%...........%..................%%%%.................%%........%...............%%................................%..........%%.........%%.........................%%%%.....
m .........................................%%.......................................%........%%%..............%%...................%%...........%......................%..................................
m ........................................%%.......................................%%.........%%...............%....................%%.........%%......................%..................................
m .....................................%%%%........................................%...........%%%%%...........%%..........%%........%%........%%.........................................................
m ............%........................%%.............%...................%%%%%%%%%%...............%%...........%%.........%..........%.........%............................%%%%.........................
m %%%......%%%%..............%%.......%%..............%.....................%%%%%%%%.................%...........%.........%..........%.....................%................%%%%%%........%............%%
m .%%...%%%%%...........%%%%%%........%...............%.....................................................2....%%...................%.....................%%%...................%%%......%..............
m ...%%%%%...........%%%%%...........%%..............%%..........%%...............................................%...................%.......................%%%%..................%%%%..%%%%............
m ....%%%.........%%%%%%.............%.............%%%%.........%%%..............................................%%...................%................%........%%%...................%%%%%%%%%...........
m ....%...........%.................%%........%%%%%%%.%%.......%%......%%......................................%%%%..........%........%................%...............................%%%...%%%%%........
m ....%%...........................%%.........%%..............%%.......%%...........%%%%%%%...........%%%%%%%%%%%%..........%%........%...............%%................................%%......%%%%%.....
m ....%%.........................%%%%........................%%.........%...........%..................%%%%.................%%........%...............%%................................%..........%%.....
m .....%...........................................................................%%.......................................%........%%%..............%%...................%%...........%.................
m .....%..........................................................................%%.......................................%%.........%%...............%....................%%.........%%.................
m .............................................................................%%%%........................................%...........%%%%%...........%%..........%%........%%........%%.................
m ...........%%%%.....................................%........................%%.............%...................%%%%%%%%%%...............%%...........%%.........%..........%.........%.................
m ...........%%%%%%........%............%%%%%......%%%%..............%%.......%%..............%.....................%%%%%%%%.................%...........%.........%..........%.....................%.....
m ................%%%......%...............%%...%%%%%...........%%%%%%........%...............%.....................................................3....%%...................%.....................%%%...
m ..................%%%%..%%%%...............%%%%%...........%%%%%...........%%..............%%..........%%...............................................%...................%.......................%%%%
m %...................%%%%%%%%%...............%%%.........%%%%%%.............%.............%%%%.........%%%..............................................%%...................%................%........%%
m .....................%%%...%%%%%............%...........%.................%%........%%%%%%%.%%.......%%......%%......................................%%%%..........%........%................%..........
m ......................%%......%%%%%.........%%...........................%%.........%%..............%%.......%%...........%%%%%%%...........%%%%%%%%%%%%..........%%........%...............%%..........
m ......................%..........%%.........%%.........................%%%%........................%%.........%...........%..................%%%%.................%%........%...............%%..........
m .........%%...........%......................%...........................................................................%%.......................................%........%%%..............%%..........
m ..........%%.........%%......................%..........................................................................%%.......................................%%.........%%...............%..........
m .%%........%%........%%..............................................................................................%%%%........................................%...........%%%%%...........%%.........
m .%..........%.........%............................%%%%.....................................%........................%%.............%...................%%%%%%%%%%...............%%...........%%........
m .%..........%.....................%................%%%%%%........%............%%%%%......%%%%..............%%.......%%..............%.....................%%%%%%%%.................%...........%........
m ............%.....................%%%...................%%%......%...............%%...%%%%%...........%%%%%%........%...............%.....................................................4....%%.......
m ............%.......................%%%%..................%%%%..%%%%...............%%%%%...........%%%%%...........%%..............%%..........%%...............................................%.......
m ............%................%........%%%...................%%%%%%%%%...............%%%.........%%%%%%.............%.............%%%%.........%%%..............................................%%.......
m ...%........%................%...............................%%%...%%%%%............%...........%.................%%........%%%%%%%.%%.......%%......%%......................................%%%%.......
m ..%%........%...............%%................................%%......%%%%%.........%%...........................%%.........%%..............%%.......%%...........%%%%%%%...........%%%%%%%%%%%%........
m ..%%........%...............%%................................%..........%%.........%%.........................%%%%........................%%.........%...........%..................%%%%...............
m ..%........%%%..............%%...................%%...........%......................%...........................................................................%%.....................................
m .%%.........%%...............%....................%%.........%%......................%..........................................................................%%......................................
m .%...........%%%%%...........%%..........%%........%%........%%..............................................................................................%%%%.......................................
m %%...............%%...........%%.........%..........%.........%............................%%%%.....................................%........................%%.............%...................%%%%%%%%
m %%.................%...........%.........%..........%.....................%................%%%%%%........%............%%%%%......%%%%..............%%.......%%..............%.....................%%%%%%
m ..........................0....%%...................%.....................%%%...................%%%......%...............%%...%%%%%...........%%%%%%........%...............%...........................
m ................................%...................%.......................%%%%..................%%%%..%%%%...............%%%%%...........%%%%%...........%%..............%%..........%%...............
m ...............................%%...................%................%........%%%...................%%%%%%%%%...............%%%.........%%%%%%.............%.............%%%%.........%%%...............
m .............................%%%%..........%........%................%...............................%%%...%%%%%............%...........%.................%%........%%%%%%%.%%.......%%......%%.........
m ..%%%%%%%...........%%%%%%%%%%%%..........%%........%...............%%................................%%......%%%%%.........%%...........................%%.........%%..............%%.......%%.........
m ..%..................%%%%.................%%........%...............%%................................%..........%%.........%%.........................%%%%........................%%.........%.........
m .%%.......................................%........%%%..............%%...................%%...........%......................%..........................................................................
m %%.......................................%%.........%%...............%....................%%.........%%......................%..........................................................................
m %........................................%...........%%%%%...........%%..........%%........%%........%%..............................................................................................%%%
m ............%...................%%%%%%%%%%...............%%...........%%.........%..........%.........%............................%%%%.....................................%........................%%.
m ............%.....................%%%%%%%%.................%...........%.........%..........%.....................%................%%%%%%........%............%%%%%......%%%%..............%%.......%%..
m ............%.....................................................1....%%...................%.....................%%%...................%%%......%...............%%...%%%%%...........%%%%%%........%...
m ...........%%..........%%...............................................%...................%.......................%%%%..................%%%%..%%%%...............%%%%%...........%%%%%...........%%...
