# map type: blank
# random seed: 50953527
# hill distance  36,119   8, 56  22,182
#        36,119       0     145     145 
#         8, 56     145       0     145 
#        22,182     145     145       0 
players 3
rows 42
cols 189
m ...........%......%%%.........%%..............%.........%%......%..............%%..........%%.........................................%..........%%.......................%%%................
m ............%%.%%%..%%........%..............%.........%.........%............%%...........%..........%%%%%...........................%%....................................................%
m %%...........%%......%.......%%..............%........%%..........%....%%....%%...........%%..............%............................%................%%...................................
m .%%..........%........%......%........%%%%%%%.........%%...........%%%%..%%%%%...........%%...............%%...........................%................%.............................%......
m ..%..........%.........%....%%........%%%%%%%........%%...........%%%.......%%...........%%................%%%.........................%...............%%............................%%......
m ..%..........%.........%%..%%...............%%.......%.........%%%%%.........%.........%%%%..................%%%......%%..............%%%%%%%%%........%........%....................%.......
m ..%%.........%..........%%%%%................%......%%.....%%%%..............%........%%..%%....................%%%.%%.%%%%.......%%%%%%......%%.......%........%..........%%%%%%%%%%%.......
m ..%%%%.......%...............................%%.....%......%%.................%.....%%.....%%.....................%%%.....%%%%%%%%%............%.......%.........%.......%%..........%.......
m .%%..%%%......................................%....%%...0..%%.................%%..%%........%%%%%..................%.........%%.................%.....%%.........%.%%%%%%%...........%.......
m .%.....%%%....................................%%..%%.......%%...................%%%................................%............................%%....%..........%%%.................%.......
m %%............................%%%%%%...........%%%%%.......%%....................%................................%%.............................%%.%%...........%...................%.......
m %..................%%.........%%...................%%......%%%....%%%............%%...............................%...............................%%............%%...................%.......
m %.................%%.........%%......................%.......%%%%%%..%............%.................%%%%%%......%%%...............................%..........%%%%....................%%....%%
m %................%%..........%........................%........%......%%..........%.................%%%%%%%..%%%........................%.........%..........%%.............%.........%%%%%%.
m .%..............%%..........%%.........................................%..........%%.......................%%%...........................%......%%%.........%%..............%.........%%.....
m ..%............%%...........%..........%%%%%...........................%%....................................................%............%%.%%%..%%........%..............%.........%.......
m ...%....%%....%%...........%%..............%............................%................%%...................................%%...........%%......%.......%%..............%........%%.......
m ....%%%%..%%%%%...........%%...............%%...........................%................%.............................%.......%%..........%........%......%........%%%%%%%.........%%.......
m ...%%%.......%%...........%%................%%%.........................%...............%%............................%%........%..........%.........%....%%........%%%%%%%........%%........
m %%%%%.........%.........%%%%..................%%%......%%..............%%%%%%%%%........%........%....................%.........%..........%.........%%..%%...............%%.......%.........
m ..............%........%%..%%....................%%%.%%.%%%%.......%%%%%%......%%.......%........%..........%%%%%%%%%%%.........%%.........%..........%%%%%................%......%%.....%%%%
m ...............%.....%%.....%%.....................%%%.....%%%%%%%%%............%.......%.........%.......%%..........%.........%%%%.......%...............................%%.....%......%%..
m ...............%%..%%........%%%%%..................%.........%%.................%.....%%.........%.%%%%%%%...........%........%%..%%%......................................%....%%...2..%%..
m .................%%%................................%............................%%....%..........%%%.................%........%.....%%%....................................%%..%%.......%%..
m ..................%................................%%.............................%%.%%...........%...................%.......%%............................%%%%%%...........%%%%%.......%%..
m ...%%%............%%...............................%...............................%%............%%...................%.......%..................%%.........%%...................%%......%%%.
m %%%%..%............%.................%%%%%%......%%%...............................%..........%%%%....................%%....%%%.................%%.........%%......................%.......%%
m %......%%..........%.................%%%%%%%..%%%........................%.........%..........%%.............%.........%%%%%%.%................%%..........%........................%........
m ........%..........%%.......................%%%...........................%......%%%.........%%..............%.........%%......%..............%%..........%%.................................
m ........%%....................................................%............%%.%%%..%%........%..............%.........%.........%............%%...........%..........%%%%%...................
m .........%................%%...................................%%...........%%......%.......%%..............%........%%..........%....%%....%%...........%%..............%...................
m .........%................%.............................%.......%%..........%........%......%........%%%%%%%.........%%...........%%%%..%%%%%...........%%...............%%..................
m .........%...............%%............................%%........%..........%.........%....%%........%%%%%%%........%%...........%%%.......%%...........%%................%%%................
m ........%%%%%%%%%........%........%....................%.........%..........%.........%%..%%...............%%.......%.........%%%%%.........%.........%%%%..................%%%......%%......
m ....%%%%%%......%%.......%........%..........%%%%%%%%%%%.........%%.........%..........%%%%%................%......%%.....%%%%..............%........%%..%%....................%%%.%%.%%%%...
m %%%%%............%.......%.........%.......%%..........%.........%%%%.......%...............................%%.....%......%%.................%.....%%.....%%.....................%%%.....%%%%
m %.................%.....%%.........%.%%%%%%%...........%........%%..%%%......................................%....%%...1..%%.................%%..%%........%%%%%..................%.........%
m ..................%%....%..........%%%.................%........%.....%%%....................................%%..%%.......%%...................%%%................................%..........
m ...................%%.%%...........%...................%.......%%............................%%%%%%...........%%%%%.......%%....................%................................%%..........
m ....................%%............%%...................%.......%..................%%.........%%...................%%......%%%....%%%............%%...............................%...........
m ....................%..........%%%%....................%%....%%%.................%%.........%%......................%.......%%%%%%..%............%.................%%%%%%......%%%...........
m ..........%.........%..........%%.............%.........%%%%%%.%................%%..........%........................%........%......%%..........%.................%%%%%%%..%%%..............
