# map type: cell maze
# random seed: -950537362
# players 5
# area 6435, 1287 (35.9^2) per player
# cell width: 1.18379842764
# cell size: 7.65668588708
# openness: 0.449780749521
# maze type growing
# horz shear step: 1
# horz_shear
# final parameters
# area: 6075
# grid size: (1, 5)
# tile size: (45, 27) 0.6
# map size: (45, 135) 3.0
# hill distance  24, 77  33,104   6, 23  15, 50  42,131
#        24, 77       0      54      81      54      81 
#        33,104      54       0      81      81      54 
#         6, 23      81      81       0      54      54 
#        15, 50      54      81      54       0      81 
#        42,131      81      54      54      81       0 
players 5
rows 45
cols 135
m ..%...........%%........%.........%...................%%...................%.......................%......%..........%%................
m ..%...........%%%%................%..................%%...................%.......................%%......%..........%%................
m .%...........%%...%...............%..................%....................%.......................%.......%%.........%.................
m %%...........%%...................%%.................%%..........%%......%.......................%%.......%%........%%.................
m %...........%%.....................%..................%...........%%%...%%.................%...............%........%...........%%%%%%%
m ............%......................%.................%%.............%%%%%%................%%...............%.......%%..........%%%%%%%.
m ...........%%..........0...........%%................%.................%%.................%................%.......%...........%%...%%.
m ...........%.........................%%%%...........%%......%......................%%......................%%..................%....%%.
m ..........%%............................%%.........%%.......%%....................%%..........................................%%.....%.
m .........%%..................%...........%%........%.........%...................%%...................%.......................%......%.
m .........%%..................%...........%%%%................%..................%%...................%.......................%%......%.
m .........%..................%...........%%...%...............%..................%....................%.......................%.......%%
m ........%%.................%%...........%%...................%%.................%%..........%%......%.......................%%.......%%
m ........%...........%%%%%%%%...........%%.....................%..................%...........%%%...%%.................%...............%
m .......%%..........%%%%%%%.............%......................%.................%%.............%%%%%%................%%...............%
m .......%...........%%...%%............%%..........1...........%%................%.................%%.................%................%
m %..................%....%%............%.........................%%%%...........%%......%......................%%......................%
m ..................%%.....%...........%%............................%%.........%%.......%%....................%%........................
m ..................%......%..........%%..................%...........%%........%.........%...................%%...................%.....
m .................%%......%..........%%..................%...........%%%%................%..................%%...................%......
m .................%.......%%.........%..................%...........%%...%...............%..................%....................%......
m ................%%.......%%........%%.................%%...........%%...................%%.................%%..........%%......%.......
m ..........%...............%........%...........%%%%%%%%...........%%.....................%..................%...........%%%...%%.......
m .........%%...............%.......%%..........%%%%%%%.............%......................%.................%%.............%%%%%%.......
m .........%................%.......%...........%%...%%............%%..........2...........%%................%.................%%........
m ..%%......................%%..................%....%%............%.........................%%%%...........%%......%....................
m .%%..........................................%%.....%...........%%............................%%.........%%.......%%...................
m %%...................%.......................%......%..........%%..................%...........%%........%.........%...................
m %...................%.......................%%......%..........%%..................%...........%%%%................%..................%
m ....................%.......................%.......%%.........%..................%...........%%...%...............%..................%
m %..........%%......%.......................%%.......%%........%%.................%%...........%%...................%%.................%
m %...........%%%...%%.................%...............%........%...........%%%%%%%%...........%%.....................%..................
m %.............%%%%%%................%%...............%.......%%..........%%%%%%%.............%......................%.................%
m .................%%.................%................%.......%...........%%...%%............%%..........3...........%%................%
m ......%......................%%......................%%..................%....%%............%.........................%%%%...........%%
m ......%%....................%%..........................................%%.....%...........%%............................%%.........%%.
m .......%...................%%...................%.......................%......%..........%%..................%...........%%........%..
m .......%..................%%...................%.......................%%......%..........%%..................%...........%%%%.........
m .......%..................%....................%.......................%.......%%.........%..................%...........%%...%........
m .......%%.................%%..........%%......%.......................%%.......%%........%%.................%%...........%%............
m ........%..................%...........%%%...%%.................%...............%........%...........%%%%%%%%...........%%.............
m ........%.................%%.............%%%%%%................%%...............%.......%%..........%%%%%%%.............%..............
m ........%%................%.................%%.................%................%.......%...........%%...%%............%%..........4...
m ..........%%%%...........%%......%......................%%......................%%..................%....%%............%...............
m .............%%.........%%.......%%....................%%..........................................%%.....%...........%%...............
