# map type: cell maze
# random seed: -1702688918
# players 2
# area 5363, 2681 (51.8^2) per player
# cell width: 1.15313238185
# cell size: 7.88207566885
# openness: 0.315285216662
# maze type growing
# horz_shear
# final parameters
# area: 5184
# grid size: (1, 2)
# tile size: (48, 54) 1.125
# map size: (48, 108) 2.25
# hill distance   8,102  45, 12   8, 48  45, 66
#         8,102       0      29      94      67 
#        45, 12      29       0      67      74 
#         8, 48      94      67       0      29 
#        45, 66      67      74      29       0 
players 2
rows 48
cols 108
m ................%%.........%%.........%%..............................%%.........%%.........%%..............
m ........%......%%..........%...........%......................%......%%..........%...........%..............
m .......%.......%%..........%...........%%.....%%%%...........%.......%%..........%...........%%.....%%%%....
m %%%%..%.........%..........%............%%.......%%%%%%%%%..%.........%..........%............%%.......%%%%%
m ...%%%..........%.......................%%...............%%%..........%.......................%%............
m ................%........................%............................%........................%............
m ................%.......................%%............................%.......................%%............
m ................%%....................%%%.............................%%....................%%%.............
m .......%%%......%%...............%%%%%%%%%......0............%%%......%%...............%%%%%%%%%......1.....
m .........%%%%%..%%......................%%.....................%%%%%..%%......................%%............
m .............%%%%%......................%%.........................%%%%%......................%%............
m ................%%%%%...................%%............................%%%%%...................%%............
m ....................%%..................%%................................%%..................%%............
m .....................%%.................%..................................%%.................%.............
m .....%................%%................%.........%%.......%................%%................%.........%%..
m .....%%................%%...............%..........%.......%%................%%...............%..........%..
m ......%%.....................%..........%..........%........%%.....................%..........%..........%..
m .......%%.....................%........%%.........%%.........%%.....................%........%%.........%%..
m ........%%....................%........%%.........%...........%%....................%........%%.........%...
m .........%%...................%........%%........%%............%%...................%........%%........%%...
m .........%%%%.................%.........%.......%%.............%%%%.................%.........%.......%%....
m .........%..%%%...............%........%%.....%%...............%..%%%...............%........%%.....%%......
m ........%%....%%%............%%........%%....%%...............%%....%%%............%%........%%....%%.......
m ........%.......%%%%%........%%.......%%......................%.......%%%%%........%%.......%%..............
m ..%...............%%.........%........%.................%...............%%.........%........%...............
m .%%..........................%.......%%................%%..........................%.......%%...............
m .%...........................%.......%.................%...........................%.......%................
m .%...........................%......%%.................%...........................%......%%................
m .%..........................%%......%.........%........%..........................%%......%.........%.......
m %%..........................%.................%%%.....%%..........................%.................%%%.....
m %...............................................%%....%...............................................%%....
m %.........%......................................%%%..%.........%......................................%%%..
m %.....%%%%%%%.%%%..................................%%%%.....%%%%%%%.%%%..................................%%%
m %%%%%%%.....%%..........................%...........%%%%%%%%%.....%%..........................%...........%%
m %%%.......................%%............%.............%%%.......................%%............%.............
m %......................%%%%%%...........%.............%......................%%%%%%...........%.............
m .......................%....%%.........%%............%.......................%....%%.........%%............%
m .............................%.........%%............%.............................%.........%%............%
m %............................%.........%%%...........%%............................%.........%%%...........%
m %%%.........%................%...........%%%%.........%%%.........%................%...........%%%%.........
m .%%%%.....%%%................%..............%%%........%%%%.....%%%................%..............%%%.......
m ....%%%%.%%..................%............................%%%%.%%..................%........................
m .......%%%...................%...............................%%%...................%........................
m .............................%.....................................................%........................
m ...................%.........%...........................................%.........%........................
m ............1......%.........%.......%............................0......%.........%.......%................
m ..................%%.........%.......%..................................%%.........%.......%................
m .................%%.........%%.......%%................................%%.........%%.......%%...............
