# random seed 8205135778800891858
# players 2
# area 2000, 1000.0 per player or 31.6227766017 squared
# cell width: 2.40055430101
# cell size: 8
# openness: 0.148980249617
# grid size: (1, 2)
# tile size: (20, 48) 2.4
# map size: (20, 96) 4.8
# horz_copy
# maze type recursive backtracker
# final openness 0.148980249617
# map_type cell_maze
# random_seed 8205135778800891858
players 2
rows 20
cols 96
m .................%%%........%%.......%%%%%%......................%%%........%%.......%%%%%%.....
m ..................%%.......%%%.........%..........................%%.......%%%.........%........
m .................%%%.......%%%...................................%%%.......%%%..................
m ......%%.........%%%.......%%%........................%%.........%%%.......%%%..................
m ......%%%........%%.........%%....1...................%%%........%%.........%%....0.............
m %.....%%%........%%.........%%%................%%.....%%%........%%.........%%%................%
m %......%%%.......%%........%%%%%...............%%......%%%.......%%........%%%%%...............%
m %.......%%%................%%%%%%%...%%.......%%%.......%%%................%%%%%%%...%%.......%%
m %.......%%%%..............%%%..%%%%%%%%.......%%%.......%%%%..............%%%..%%%%%%%%.......%%
m .........%%%.............%%%.....%%%%%........%%.........%%%.............%%%.....%%%%%........%%
m .........%%%.........%%.%%%.......%%.........%%%.........%%%.........%%.%%%.......%%.........%%%
m .........%%%........%%%%%%%..................%%%.........%%%........%%%%%%%..................%%%
m .........%%%.......%%%%.%%...................%%%.........%%%.......%%%%.%%...................%%%
m .........%%%......%%%%.......................%%%.........%%%......%%%%.......................%%%
m .........%%%.....%%%%........................%%%.........%%%.....%%%%........................%%%
m ........%%%%....%%%%........................%%%.........%%%%....%%%%........................%%%.
m .......%%%%....%%%%..............%..........%%%........%%%%....%%%%..............%..........%%%.
m .......%%......%%%%...........%%%%%%.......%%%.........%%......%%%%...........%%%%%%.......%%%..
m ................%%...........%%%%%%%%%%...%%%...................%%...........%%%%%%%%%%...%%%...
m ................%%%.........%%%%..%%%%%%%%%%%...................%%%.........%%%%..%%%%%%%%%%%...
