# map type: blank
# random seed: 1662919192
# hill distance  55, 94  68, 72   7, 49  20, 18  55,103  20, 27
#        55, 94       0      41      79      87      39     102 
#        68, 72      41       0      38      90      52      79 
#         7, 49      79      38       0      52      90      41 
#        20, 18      87      90      52       0      72      39 
#        55,103      39      52      90      72       0      87 
#        20, 27     102      79      41      39      87       0 
players 2
rows 76
cols 122
m ...%%..........%........%%%%%...................%%.......................%%...............%%%%.............%.........%%...
m ....%...........%...............................%%...........%%...........%%........%%.%%%%.................%........%....
m ....%............%%%............................%%..........%%%%%...........%%.......%%%.....................%............
m ....%..........................................%...........%%...%%%%.........%%.......%......................%%...........
m ....%%................................%%......%...........%%.......%%.........%%......%%.....................%............
m .....%...............................%%......%............%...........................%%.....................%............
m .....%...............................%......%..........%%%.............................%.....................%............
m .....%%%%...........................%............0.....%.%%............................%.....................%............
m ........%%%..................%%....%%.....................%%...........................%.....................%............
m ..........%%.................%.....%.......................%...........................%%...................%%............
m ...........%................%......%%.......................%........%%...................................................
m ...........%................%.......%........................%........%%%.%%%%%...................%%......................
m ...........%%..............%........%%.......%%..............%%.........%%....%%................%%.%%%%.................%%
m ............%.......%.....%%.........%........%%%.............%.................%%..............%................%%%%%%%%%
m %...........%%......%%%.%%%..........%%.........%%%..............................%%%...........%%.........................
m %...........%%........%%..............%.........%%.................................%...........%..........................
m .%..........%%........%%.............%..........%%.................................%...........%..........................
m ............%.........%%.............%..........%..................................%..........%...........................
m ...........%..........%%............%%.........%%...................................%.........%...........................
m .......%%%%%..........%%............%..........%.............................................%%...........................
m ..................1...%%...0.......%%..........%............%...........%....................%.................%..........
m ......................%%...........%..........%%............%..........%.....................%..............%%%%..........
m ......................%%...........%..........%.............%........%%.........%.........................%%%.............
m ......................%%.....................%%............%........%%..........%........................%................
m ......................%%....................%%%...........%........%%...........%.......................%%................
m ......................%%................%%%%.............%.........%............%%............%.........%............%....
m ................%%%%%%%%................%%..............%..........%.............%...........%%........%%............%....
m .......................%%%%%%%...........%.............%...........%%............%........%%%%.........%%.............%...
m .........................%%%%............%............%.............%............%......%%%%............%.............%...
m ...%%....................................%............%.............%............%%.%%%%..............................%...
m .%%%.....................................%...........%..............%%%...........%%%%................................%%..
m %%..........%............................%...........%.............%%.%%%.............................................%%.%
m ............%............................%...........%............%%....%%%........................................%%%%%%%
m ............%............................%%.......................%.......%.....................................%%%%......
m .............%.............................%%....................%........................................................
m .............%%%............................%%..................%............................%%%..........................
m ...............%%%%.............%%............%................%%...........................%%.%%%........................
m ..................%%%%%........%%.%%%.....................................................%%.....%%%.%....................
m ....................%.%%%.....%%.....................................................%%%.%%........%%%%%..................
m ........................%%%.%%...........................%%................%............%%.............%%%%...............
m ..........................%%%............................%..................%%............................%%%.............
m ........................................................%....................%%.............................%.............
m ......%%%%.....................................%.......%.......................%%............................%............
m %%%%%%%........................................%%%....%%............%...........%............................%............
m %.%%.............................................%%%.%%.............%...........%............................%..........%%
m ..%%................................%%%%...........%%%..............%...........%.....................................%%%.
m ...%..............................%%%%.%%............%.............%............%....................................%%...
m ...%.............%............%%%%......%............%.............%............%............%%%%.........................
m ...%.............%%.........%%%%........%............%%...........%.............%...........%%%%%%%.......................
m ....%............%%........%%...........%.............%..........%..............%%................%%%%%%%%................
m ....%............%.........%............%%............%.........%.............%%%%................%%......................
m ................%%.......................%...........%%........%...........%%%....................%%......................
m ................%........................%..........%%........%............%%.....................%%......................
m .............%%%.........................%.........%%........%.............%..........%...........%%......................
m ..........%%%%..............%.....................%..........%............%%..........%...........%%......................
m ..........%.................%....................%...........%............%..........%%.......1...%%...0..................
m ...........................%%.............................................%..........%............%%..........%%%%%.......
m ...........................%.........%...................................%%.........%%............%%..........%...........
m ...........................%..........%..................................%..........%.............%%.........%............
m ..........................%...........%.................................%%..........%.............%%........%%..........%.
m ..........................%...........%.................................%%.........%..............%%........%%...........%
m .........................%%...........%%%..............................%%%.........%%..........%%%.%%%......%%...........%
m %%%%%%%%%................%..............%%.................%.............%%%........%.........%%.....%.......%............
m %%.................%%%%.%%................%%....%%.........%%..............%%.......%%........%..............%%...........
m ......................%%...................%%%%%.%%%........%........................%.......%................%...........
m ...................................................%%........%.......................%%......%................%...........
m ............%%...................%%...........................%.......................%.....%.................%%..........
m ............%.....................%...........................%%.....................%%....%%..................%%%........
m ............%.....................%............................%%.%.....1............%...........................%%%%.....
m ............%.....................%.............................%%%..........%......%...............................%.....
m ............%.....................%%...........................%............%......%%...............................%.....
m ............%.....................%%......%%.........%%.......%%...........%......%%................................%%....
m ...........%%......................%.......%%.........%%%%...%%...........%..........................................%....
m ............%.....................%%%.......%%...........%%%%%..........%%............................%%%............%....
m ....%........%.................%%%%.%%........%%...........%%...........%%...............................%...........%....
m ...%%.........%.............%%%%...............%%.......................%%...................%%%%%........%..........%%...
