# map type: cell maze
# random seed: 1184876942
# players 5
# area 10379, 2075 (45.6^2) per player
# cell width: 1.4768947641
# cell size: 7.58520698562
# openness: 0.0491913250593
# maze type backtrack
# horz shear step: 2
# horz_shear
# final parameters
# area: 9900
# grid size: (1, 5)
# tile size: (90, 22) 0.244444444444
# map size: (90, 110) 1.22222222222
# hill distance  79, 11  25, 61  43, 17  25, 33  79, 39  61, 83  61, 55   7, 77  43, 99   7,105
#        79, 11       0     146     140     130      36      56      92      92     130      74 
#        25, 61     146       0      84      36     130     130     140      74      56      84 
#        43, 17     140      84       0      74     130      84      56     146      36     130 
#        25, 33     130      36      74       0     140     146     130      92      92      56 
#        79, 39      36     130     130     140       0      84      74      56     146      84 
#        61, 83      56     130      84     146      84       0      36     140      74     130 
#        61, 55      92     140      56     130      74      36       0     130      92     146 
#         7, 77      92      74     146      92      56     140     130       0     130      36 
#        43, 99     130      56      36      92     146      74      92     130       0     140 
#         7,105      74      84     130      56      84     130     146      36     140       0 
players 5
rows 90
cols 110
m .....%%.................%%.........%%%%%......%%%%..........................%%......%.........................
m %%%%%%%%...........................%%..%%%.......%%.........................%%%%.%%%%..................%%%%%%%
m %%....%%%.........................%%.....%.....................................%%%%.........................%%
m .......%%%....%..................%%...........................................................................
m ........%%%%%%%%.................%%...........................................................%%..............
m .........%....%%%...............%%...........................................................%%%%%%%..........
m ........%%.....%%%..........%%%%%...........................%%%%%%.........................%%%....%%..........
m ........%.......%%%............%%..........................%%....%%%.........3............%%.......%%....2....
m ........%........%%.............%%.......................%%%......%%%%%%...........................%%.........
m %%.....%%.........%%............%%........%.............%%.............%%...........................%........%
m .%%....%%.........%%.............%%.......%%......%%%%%%%...............%%..........................%%.....%%%
m .%%%....%%.........%%%...........%.........%%%%%%%%.....................%%..........................%%...%%%..
m ..%.....%%...........%%....................%%%%%%%.......................%%%%%%%%%%..................%%%%%....
m ..%......%%...........%....................%%.....................................%%%%%%%............%%%%.....
m ..%.......%%..........%%%.................%%............................................%%...........%%%......
m ..%.......%%%..........%%%%%%.............%..............................................%%...........%.......
m ..%........%..............%%%%%%.........%%...............................................%%..........%%......
m .%%%..........................%%%.......%%................................................%%..........%%%.....
m ..%%%%..........................%%......%..............................%%.................%%.........%%%%%....
m .....%%.........................%%%%.%%%%..................%%%%%%%%%%%%%%%...........................%%..%%%..
m ...................................%%%%.........................%%%%....%%%.........................%%.....%..
m .........................................................................%%%....%..................%%.........
m ..................................................%%......................%%%%%%%%.................%%.........
m .................................................%%%%%%%...................%....%%%...............%%..........
m ................%%%%%%.........................%%%....%%..................%%.....%%%..........%%%%%...........
m ...............%%....%%%.........1............%%.......%%....0............%.......%%%............%%...........
m .............%%%......%%%%%%...........................%%.................%........%%.............%%..........
m ............%%.............%%...........................%........%%%.....%%.........%%............%%........%.
m ......%%%%%%%...............%%..........................%%.....%%%.%%....%%.........%%.............%%.......%%
m %%%%%%%.....................%%..........................%%...%%%...%%%....%%.........%%%...........%.........%
m %%%%%%.......................%%%%%%%%%%..................%%%%%......%.....%%...........%%....................%
m %.....................................%%%%%%%............%%%%.......%......%%...........%....................%
m ............................................%%...........%%%........%.......%%..........%%%.................%%
m .............................................%%...........%.........%.......%%%..........%%%%%%.............%.
m ..............................................%%..........%%........%........%..............%%%%%%.........%%.
m ..............................................%%..........%%%......%%%..........................%%%.......%%..
m ...........................%%.................%%.........%%%%%......%%%%..........................%%......%...
m ...............%%%%%%%%%%%%%%%...........................%%..%%%.......%%.........................%%%%.%%%%...
m ....................%%%%....%%%.........................%%.....%.....................................%%%%.....
m .............................%%%....%..................%%.....................................................
m ......%%......................%%%%%%%%.................%%.....................................................
m .....%%%%%%%...................%....%%%...............%%......................................................
m ...%%%....%%..................%%.....%%%..........%%%%%...........................%%%%%%......................
m ..%%.......%%....3............%.......%%%............%%..........................%%....%%%.........4..........
m ...........%%.................%........%%.............%%.......................%%%......%%%%%%................
m ............%........%%%.....%%.........%%............%%........%.............%%.............%%...............
m ............%%.....%%%.%%....%%.........%%.............%%.......%%......%%%%%%%...............%%..............
m ............%%...%%%...%%%....%%.........%%%...........%.........%%%%%%%%.....................%%..............
m .............%%%%%......%.....%%...........%%....................%%%%%%%.......................%%%%%%%%%%.....
m %............%%%%.......%......%%...........%....................%%.....................................%%%%%%
m %%...........%%%........%.......%%..........%%%.................%%............................................
m .%%...........%.........%.......%%%..........%%%%%%.............%.............................................
m ..%%..........%%........%........%..............%%%%%%.........%%.............................................
m ..%%..........%%%......%%%..........................%%%.......%%..............................................
m ..%%.........%%%%%......%%%%..........................%%......%..............................%%...............
m .............%%..%%%.......%%.........................%%%%.%%%%..................%%%%%%%%%%%%%%%..............
m ............%%.....%.....................................%%%%.........................%%%%....%%%.............
m ...........%%..................................................................................%%%....%.......
m ...........%%...........................................................%%......................%%%%%%%%......
m ..........%%...........................................................%%%%%%%...................%....%%%.....
m ......%%%%%...........................%%%%%%.........................%%%....%%..................%%.....%%%....
m .........%%..........................%%....%%%.........2............%%.......%%....1............%.......%%%...
m ..........%%.......................%%%......%%%%%%...........................%%.................%........%%...
m ..........%%........%.............%%.............%%...........................%........%%%.....%%.........%%..
m ...........%%.......%%......%%%%%%%...............%%..........................%%.....%%%.%%....%%.........%%..
m ...........%.........%%%%%%%%.....................%%..........................%%...%%%...%%%....%%.........%%%
m %....................%%%%%%%.......................%%%%%%%%%%..................%%%%%......%.....%%...........%
m %....................%%.....................................%%%%%%%............%%%%.......%......%%...........
m %%%.................%%............................................%%...........%%%........%.......%%..........
m .%%%%%%.............%..............................................%%...........%.........%.......%%%.........
m ....%%%%%%.........%%...............................................%%..........%%........%........%..........
m ........%%%.......%%................................................%%..........%%%......%%%..................
m ..........%%......%..............................%%.................%%.........%%%%%......%%%%................
m ..........%%%%.%%%%..................%%%%%%%%%%%%%%%...........................%%..%%%.......%%...............
m .............%%%%.........................%%%%....%%%.........................%%.....%........................
m ...................................................%%%....%..................%%...............................
m ............................%%......................%%%%%%%%.................%%...............................
m ...........................%%%%%%%...................%....%%%...............%%................................
m .........................%%%....%%..................%%.....%%%..........%%%%%...........................%%%%%%
m %%.........0............%%.......%%....4............%.......%%%............%%..........................%%....%
m %%%%%%...........................%%.................%........%%.............%%.......................%%%......
m .....%%...........................%........%%%.....%%.........%%............%%........%.............%%........
m ......%%..........................%%.....%%%.%%....%%.........%%.............%%.......%%......%%%%%%%.........
m ......%%..........................%%...%%%...%%%....%%.........%%%...........%.........%%%%%%%%...............
m .......%%%%%%%%%%..................%%%%%......%.....%%...........%%....................%%%%%%%................
m ................%%%%%%%............%%%%.......%......%%...........%....................%%.....................
m ......................%%...........%%%........%.......%%..........%%%.................%%......................
m .......................%%...........%.........%.......%%%..........%%%%%%.............%.......................
m ........................%%..........%%........%........%..............%%%%%%.........%%.......................
m ........................%%..........%%%......%%%..........................%%%.......%%........................
