# map type: cell maze
# random seed: 1474076363
# players 7
# area 17490, 2498 (50.0^2) per player
# cell width: 1.02814280116
# cell size: 8.0148379677
# openness: 0.0296764159082
# maze type backtrack
# horz shear step: 5
# horz_shear
# final parameters
# area: 15876
# grid size: (1, 7)
# tile size: (84, 27) 0.321428571429
# map size: (84, 189) 2.25
# hill distance  72,161   0, 53  60, 80  24, 26  12,134  36,107  48,188
#        72,161       0     149     149      94      97      94      97 
#         0, 53     149       0      97      97     149      94      94 
#        60, 80     149      97       0      94      94      97     149 
#        24, 26      94      97      94       0     149     149      97 
#        12,134      97     149      94     149       0      97      94 
#        36,107      94      94      97     149      97       0     149 
#        48,188      97      94     149      97      94     149       0 
players 7
rows 84
cols 189
m .................%%............................%.....1...%.....%%.....................................%%.................%%.........%.......%.....................%%%.......%%%....%......%..
m ................%%.............................%..........%%...%.......................................%..................%.........%.......%......................%..........%%%%%.......%..
m ...............%%..............................%...........%%..%........................................%.................%..........%.....%.......................%......................%..
m ..............%%...............................%............%%%%........................................%.................%..........%%.%%%........................%.....................%%..
m .............%%................................%..............%..........%%...%%............%%...........%................%%.........%%%%..........................%.....................%%..
m ..%..........%%...............................%%%........................%.....%%............%%............................%...........%%............%%%...........%%...................%....
m ..%%.........%%............................%%%%.%%......................%%.....%%%............%%...........................%%%%........%%.........%%%%.%%...........%........................
m ...%.........%%............................%.....%%.....................%......%%%%.............%%............................%%%%......%.........%.................%........................
m ...%%........%............................%.......%%....................%......%%..%%............%%..............................%......%%.......%%.................%%.......................
m .....%%...%%%%.....................................%%.......%...........%......%.....%%...........%%%.....%%...%%................%.......%.......%...................%%%.....................
m ......%%%%%..%.........%.........%..................%%.....%%%%........%.......%......%%............%%......%%%%%%%%%%...........%.......%.......%......................%%%...%%%%%%%%%......
m .......%.....%.........%.........%...................%%..%%...%%%......%.......%.......%...........%%........%...................%........%......%.........................%%%%%%%%%%%%%.....
m .............%%.........%.......%.....................%%%.......%%%....%......%...................%%............................%.....4...%.....%%.....................................%%....
m ..............%.........%.......%......................%..........%%%%%.......%..................%%.............................%..........%%...%.......................................%....
m ..............%..........%.....%.......................%......................%.................%%..............................%...........%%..%........................................%...
m ..............%..........%%.%%%........................%.....................%%................%%...............................%............%%%%........................................%...
m ..............%%.........%%%%..........................%.....................%%...............%%................................%..............%..........%%...%%............%%...........%..
m ...............%...........%%............%%%...........%%...................%......%..........%%...............................%%%........................%.....%%............%%.............
m ...............%%%%........%%.........%%%%.%%...........%..........................%%.........%%............................%%%%.%%......................%%.....%%%............%%............
m ..................%%%%......%.........%.................%...........................%.........%%............................%.....%%.....................%......%%%%.............%%..........
m .....................%......%%.......%%.................%%..........................%%........%............................%.......%%....................%......%%..%%............%%.........
m ...%%................%.......%.......%...................%%%..........................%%...%%%%.....................................%%.......%...........%......%.....%%...........%%%.....%%
m %%%%%%%%%%...........%.......%.......%......................%%%...%%%%%%%%%............%%%%%..%.........%.........%..................%%.....%%%%........%.......%......%%............%%......
m .%...................%........%......%.........................%%%%%%%%%%%%%............%.....%.........%.........%...................%%..%%...%%%......%.......%.......%...........%%.......
m ....................%.....0...%.....%%.....................................%%.................%%.........%.......%.....................%%%.......%%%....%......%...................%%........
m ....................%..........%%...%.......................................%..................%.........%.......%......................%..........%%%%%.......%..................%%.........
m ....................%...........%%..%........................................%.................%..........%.....%.......................%......................%.................%%..........
m ....................%............%%%%........................................%.................%..........%%.%%%........................%.....................%%................%%...........
m ....................%..............%..........%%...%%............%%...........%................%%.........%%%%..........................%.....................%%...............%%............
m ...................%%%........................%.....%%............%%............................%...........%%............%%%...........%%...................%......%..........%%............
m ................%%%%.%%......................%%.....%%%............%%...........................%%%%........%%.........%%%%.%%...........%..........................%%.........%%............
m ................%.....%%.....................%......%%%%.............%%............................%%%%......%.........%.................%...........................%.........%%............
m ...............%.......%%....................%......%%..%%............%%..............................%......%%.......%%.................%%..........................%%........%.............
m ........................%%.......%...........%......%.....%%...........%%%.....%%...%%................%.......%.......%...................%%%..........................%%...%%%%.............
m ......%..................%%.....%%%%........%.......%......%%............%%......%%%%%%%%%%...........%.......%.......%......................%%%...%%%%%%%%%............%%%%%..%.........%...
m ......%...................%%..%%...%%%......%.......%.......%...........%%........%...................%........%......%.........................%%%%%%%%%%%%%............%.....%.........%...
m .....%.....................%%%.......%%%....%......%...................%%............................%.....3...%.....%%.....................................%%.................%%.........%..
m .....%......................%..........%%%%%.......%..................%%.............................%..........%%...%.......................................%..................%.........%..
m ....%.......................%......................%.................%%..............................%...........%%..%........................................%.................%..........%.
m .%%%........................%.....................%%................%%...............................%............%%%%........................................%.................%..........%%
m %%..........................%.....................%%...............%%................................%..............%..........%%...%%............%%...........%................%%.........%%
m %%............%%%...........%%...................%......%..........%%...............................%%%........................%.....%%............%%............................%...........
m %%.........%%%%.%%...........%..........................%%.........%%............................%%%%.%%......................%%.....%%%............%%...........................%%%%........
m .%.........%.................%...........................%.........%%............................%.....%%.....................%......%%%%.............%%............................%%%%.....
m .%%.......%%.................%%..........................%%........%............................%.......%%....................%......%%..%%............%%..............................%.....
m ..%.......%...................%%%..........................%%...%%%%.....................................%%.......%...........%......%.....%%...........%%%.....%%...%%................%.....
m ..%.......%......................%%%...%%%%%%%%%............%%%%%..%.........%.........%..................%%.....%%%%........%.......%......%%............%%......%%%%%%%%%%...........%.....
m ...%......%.........................%%%%%%%%%%%%%............%.....%.........%.........%...................%%..%%...%%%......%.......%.......%...........%%........%...................%.....
m ...%.....%%.....................................%%.................%%.........%.......%.....................%%%.......%%%....%......%...................%%............................%.....6
m ....%%...%.......................................%..................%.........%.......%......................%..........%%%%%.......%..................%%.............................%......
m .....%%..%........................................%.................%..........%.....%.......................%......................%.................%%..............................%......
m ......%%%%........................................%.................%..........%%.%%%........................%.....................%%................%%...............................%......
m ........%..........%%...%%............%%...........%................%%.........%%%%..........................%.....................%%...............%%................................%......
m ...................%.....%%............%%............................%...........%%............%%%...........%%...................%......%..........%%...............................%%%.....
m ..................%%.....%%%............%%...........................%%%%........%%.........%%%%.%%...........%..........................%%.........%%............................%%%%.%%....
m ..................%......%%%%.............%%............................%%%%......%.........%.................%...........................%.........%%............................%.....%%...
m ..................%......%%..%%............%%..............................%......%%.......%%.................%%..........................%%........%............................%.......%%..
m ......%...........%......%.....%%...........%%%.....%%...%%................%.......%.......%...................%%%..........................%%...%%%%.....................................%%.
m .....%%%%........%.......%......%%............%%......%%%%%%%%%%...........%.......%.......%......................%%%...%%%%%%%%%............%%%%%..%.........%.........%..................%%
m %..%%...%%%......%.......%.......%...........%%........%...................%........%......%.........................%%%%%%%%%%%%%............%.....%.........%.........%...................%
m %%%.......%%%....%......%...................%%............................%.....2...%.....%%.....................................%%.................%%.........%.......%.....................
m .%..........%%%%%.......%..................%%.............................%..........%%...%.......................................%..................%.........%.......%.....................
m .%......................%.................%%..............................%...........%%..%........................................%.................%..........%.....%......................
m .%.....................%%................%%...............................%............%%%%........................................%.................%..........%%.%%%.......................
m .%.....................%%...............%%................................%..............%..........%%...%%............%%...........%................%%.........%%%%.........................
m .%%...................%......%..........%%...............................%%%........................%.....%%............%%............................%...........%%............%%%..........
m ..%..........................%%.........%%............................%%%%.%%......................%%.....%%%............%%...........................%%%%........%%.........%%%%.%%.........
m ..%...........................%.........%%............................%.....%%.....................%......%%%%.............%%............................%%%%......%.........%...............
m ..%%..........................%%........%............................%.......%%....................%......%%..%%............%%..............................%......%%.......%%...............
m ...%%%..........................%%...%%%%.....................................%%.......%...........%......%.....%%...........%%%.....%%...%%................%.......%.......%................
m ......%%%...%%%%%%%%%............%%%%%..%.........%.........%..................%%.....%%%%........%.......%......%%............%%......%%%%%%%%%%...........%.......%.......%................
m .........%%%%%%%%%%%%%............%.....%.........%.........%...................%%..%%...%%%......%.......%.......%...........%%........%...................%........%......%................
m .....................%%.................%%.........%.......%.....................%%%.......%%%....%......%...................%%............................%.....5...%.....%%................
m ......................%..................%.........%.......%......................%..........%%%%%.......%..................%%.............................%..........%%...%.................
m .......................%.................%..........%.....%.......................%......................%.................%%..............................%...........%%..%.................
m .......................%.................%..........%%.%%%........................%.....................%%................%%...............................%............%%%%.................
m ...........%%...........%................%%.........%%%%..........................%.....................%%...............%%................................%..............%..........%%...%%.
m ............%%............................%...........%%............%%%...........%%...................%......%..........%%...............................%%%........................%.....%%
m %............%%...........................%%%%........%%.........%%%%.%%...........%..........................%%.........%%............................%%%%.%%......................%%.....%%
m %%.............%%............................%%%%......%.........%.................%...........................%.........%%............................%.....%%.....................%......%%
m ..%%............%%..............................%......%%.......%%.................%%..........................%%........%............................%.......%%....................%......%%
m ....%%...........%%%.....%%...%%................%.......%.......%...................%%%..........................%%...%%%%.....................................%%.......%...........%......%.
m .....%%............%%......%%%%%%%%%%...........%.......%.......%......................%%%...%%%%%%%%%............%%%%%..%.........%.........%..................%%.....%%%%........%.......%.
m ......%...........%%........%...................%........%......%.........................%%%%%%%%%%%%%............%.....%.........%.........%...................%%..%%...%%%......%.......%.
