# map type: cell maze
# random seed: 1133286183
# players 5
# area 9296, 1859 (43.1^2) per player
# cell width: 7.0
# cell size: 15.0097272508
# openness: 0.282320152708
# maze type backtrack
# horz shear step: 1
# horz_shear
# final parameters
# area: 9100
# grid size: (1, 5)
# tile size: (70, 26) 0.371428571429
# map size: (70, 130) 1.85714285714
# hill distance  17, 18  14, 60  56,  8  45, 70  31, 44  42,112   3,122   0, 34  59, 96  28, 86
#        17, 18       0     109      49      80      40      61      40      85      80      77 
#        14, 60     109       0     104      49      85     104      77      64      61      64 
#        56,  8      49     104       0      77      61      64      85      64     109     104 
#        45, 70      80      49      77       0      40     109      80      61      40      85 
#        31, 44      40      85      61      40       0      77      80      49      80     109 
#        42,112      61     104      64     109      77       0      49     104      85      64 
#         3,122      40      77      85      80      80      49       0     109      40      61 
#         0, 34      85      64      64      61      49     104     109       0      77     104 
#        59, 96      80      61     109      40      80      85      40      77       0      49 
#        28, 86      77      64     104      85     109      64      61     104      49       0 
players 5
rows 70
cols 130
m .%%%%%%%%%%............%%%%%%%....1.......%%%%%%%%%%%%%%%%%%%%%%%%%%............................%%%%%%%%..........................
m ....%%...%.............%%%%%%%...........%%%%%%%%%%%%%%%%%%%%%%%%%%%............................%%%%%%%%%........%%...............
m .......................%%%%%%%..........%%%%%%%%%%%%%%%%%%%%%%%%%%%%.............................%%%%%%%%%%%.%%%%%%%..............
m .......................%%%%%%%.........%%%%%%%%%%%%%%%%%%%%%%%%%%%%%............................%%%%%%%%%%%%%%%%%%%%......0.......
m ......................%%%%%%%%%.......%%%%%%%%%%%%%%%%%%%%%%%%%%%%%.............................%%%%%%%%%%%%%%%%%%%%%.............
m ............%%%%%%%%%%%%%%%%%%%.....%%%%%%%%%%%%%%%%%%%%%%.......%...............................%%%%%%%%%%%%%%%%%%%%.............
m ...........%%%%%%%%%%%%%%%%%%%%...%%%%%%%%%%%%%%%%%%%%%%%%........................................%%%%%%%%%%%%%%%%%%..............
m ...........%%%%%%%%%%%%%%%%%%%%.%%%%%%%%%%%%%%%.%%%%%%%%%..........................................%%%%%%%%%%%%%%%%%..............
m ...........%%%%%%%%%%%%%%%%%%%%%%%%%%%%%%%%%%...%%%%%%%%%...............................................%%%%%%%%%%%........%......
m ..........%%%%%%%%%%%%%%%%%%%%%%%%%%%%%%%%%.....%%%%%%%%%..................................................%%%%%%%%........%%%%%..
m ...........%%%%%%%%%%%%%%%%%%%%%%%%%%%%%%.......%%%%%%%%%....................................................%%%%%........%%%%%%..
m ...........%%%%%%%%%%%%%%%%%%%%%%%%%%%%%.........%%%%%%%..............%%...%......%%.............................%.......%%%%%%%..
m ...........%%%%%%%%%%%%%%%%%%%%%%%%%%%%..........%%%%%%%.............%%%%%%%%...%%%%%%%%%%%%%............................%%%%%%%%.
m ...........%.............%%%%%%%%%%%%%...........%%%%%%%.............%%%%%%%%%%%%%%%%%%%%%%%%.............................%%%%%%%.
m ...........................%%%%%%%%%%............%%%%%%%....2.......%%%%%%%%%%%%%%%%%%%%%%%%%%............................%%%%%%%%
m %........%%...................%%...%.............%%%%%%%...........%%%%%%%%%%%%%%%%%%%%%%%%%%%............................%%%%%%%%
m %%%%.%%%%%%%.....................................%%%%%%%..........%%%%%%%%%%%%%%%%%%%%%%%%%%%%.............................%%%%%%%
m %%%%%%%%%%%%......1..............................%%%%%%%.........%%%%%%%%%%%%%%%%%%%%%%%%%%%%%............................%%%%%%%%
m %%%%%%%%%%%%%...................................%%%%%%%%%.......%%%%%%%%%%%%%%%%%%%%%%%%%%%%%.............................%%%%%%%%
m %%%%%%%%%%%%%.........................%%%%%%%%%%%%%%%%%%%.....%%%%%%%%%%%%%%%%%%%%%%.......%...............................%%%%%%%
m %%%%%%%%%%%%.........................%%%%%%%%%%%%%%%%%%%%...%%%%%%%%%%%%%%%%%%%%%%%%........................................%%%%%%
m %%%%%%%%%%%%.........................%%%%%%%%%%%%%%%%%%%%.%%%%%%%%%%%%%%%.%%%%%%%%%..........................................%%%%%
m %%%%%%%%%%%........%.................%%%%%%%%%%%%%%%%%%%%%%%%%%%%%%%%%%...%%%%%%%%%...............................................
m ...%%%%%%%%........%%%%%............%%%%%%%%%%%%%%%%%%%%%%%%%%%%%%%%%.....%%%%%%%%%...............................................
m .....%%%%%........%%%%%%.............%%%%%%%%%%%%%%%%%%%%%%%%%%%%%%.......%%%%%%%%%...............................................
m .........%.......%%%%%%%.............%%%%%%%%%%%%%%%%%%%%%%%%%%%%%.........%%%%%%%..............%%...%......%%....................
m .................%%%%%%%%............%%%%%%%%%%%%%%%%%%%%%%%%%%%%..........%%%%%%%.............%%%%%%%%...%%%%%%%%%%%%%...........
m ..................%%%%%%%............%.............%%%%%%%%%%%%%...........%%%%%%%.............%%%%%%%%%%%%%%%%%%%%%%%%...........
m ..................%%%%%%%%...........................%%%%%%%%%%............%%%%%%%....3.......%%%%%%%%%%%%%%%%%%%%%%%%%%..........
m ..................%%%%%%%%%........%%...................%%...%.............%%%%%%%...........%%%%%%%%%%%%%%%%%%%%%%%%%%%..........
m ...................%%%%%%%%%%%.%%%%%%%.....................................%%%%%%%..........%%%%%%%%%%%%%%%%%%%%%%%%%%%%..........
m ..................%%%%%%%%%%%%%%%%%%%%......2..............................%%%%%%%.........%%%%%%%%%%%%%%%%%%%%%%%%%%%%%..........
m ..................%%%%%%%%%%%%%%%%%%%%%...................................%%%%%%%%%.......%%%%%%%%%%%%%%%%%%%%%%%%%%%%%...........
m ...................%%%%%%%%%%%%%%%%%%%%.........................%%%%%%%%%%%%%%%%%%%.....%%%%%%%%%%%%%%%%%%%%%%.......%............
m ....................%%%%%%%%%%%%%%%%%%.........................%%%%%%%%%%%%%%%%%%%%...%%%%%%%%%%%%%%%%%%%%%%%%....................
m .....................%%%%%%%%%%%%%%%%%.........................%%%%%%%%%%%%%%%%%%%%.%%%%%%%%%%%%%%%.%%%%%%%%%.....................
m ..........................%%%%%%%%%%%........%.................%%%%%%%%%%%%%%%%%%%%%%%%%%%%%%%%%%...%%%%%%%%%.....................
m .............................%%%%%%%%........%%%%%............%%%%%%%%%%%%%%%%%%%%%%%%%%%%%%%%%.....%%%%%%%%%.....................
m ...............................%%%%%........%%%%%%.............%%%%%%%%%%%%%%%%%%%%%%%%%%%%%%.......%%%%%%%%%.....................
m ....%%.............................%.......%%%%%%%.............%%%%%%%%%%%%%%%%%%%%%%%%%%%%%.........%%%%%%%..............%%...%..
m ..%%%%%%%%%%%%%............................%%%%%%%%............%%%%%%%%%%%%%%%%%%%%%%%%%%%%..........%%%%%%%.............%%%%%%%%.
m %%%%%%%%%%%%%%%.............................%%%%%%%............%.............%%%%%%%%%%%%%...........%%%%%%%.............%%%%%%%%%
m %%%%%%%%%%%%%%%%............................%%%%%%%%...........................%%%%%%%%%%............%%%%%%%....4.......%%%%%%%%%%
m %%%%%%%%%%%%%%%%............................%%%%%%%%%........%%...................%%...%.............%%%%%%%...........%%%%%%%%%%%
m %%%%%%%%%%%%%%%%.............................%%%%%%%%%%%.%%%%%%%.....................................%%%%%%%..........%%%%%%%%%%%%
m %%%%%%%%%%%%%%%%............................%%%%%%%%%%%%%%%%%%%%......3..............................%%%%%%%.........%%%%%%%%%%%%%
m %%%%%%%%%%%%%%%.............................%%%%%%%%%%%%%%%%%%%%%...................................%%%%%%%%%.......%%%%%%%%%%%%%%
m %%%%%%.......%...............................%%%%%%%%%%%%%%%%%%%%.........................%%%%%%%%%%%%%%%%%%%.....%%%%%%%%%%%%%%%%
m %%%%%%........................................%%%%%%%%%%%%%%%%%%.........................%%%%%%%%%%%%%%%%%%%%...%%%%%%%%%%%%%%%%%%
m %%%%%..........................................%%%%%%%%%%%%%%%%%.........................%%%%%%%%%%%%%%%%%%%%.%%%%%%%%%%%%%%%.%%%%
m %%%%%...............................................%%%%%%%%%%%........%.................%%%%%%%%%%%%%%%%%%%%%%%%%%%%%%%%%%...%%%%
m %%%%%..................................................%%%%%%%%........%%%%%............%%%%%%%%%%%%%%%%%%%%%%%%%%%%%%%%%.....%%%%
m %%%%%....................................................%%%%%........%%%%%%.............%%%%%%%%%%%%%%%%%%%%%%%%%%%%%%.......%%%%
m %%%%..............%%...%......%%.............................%.......%%%%%%%.............%%%%%%%%%%%%%%%%%%%%%%%%%%%%%.........%%%
m %%%%.............%%%%%%%%...%%%%%%%%%%%%%............................%%%%%%%%............%%%%%%%%%%%%%%%%%%%%%%%%%%%%..........%%%
m %%%%.............%%%%%%%%%%%%%%%%%%%%%%%%.............................%%%%%%%............%.............%%%%%%%%%%%%%...........%%%
m %%%%....0.......%%%%%%%%%%%%%%%%%%%%%%%%%%............................%%%%%%%%...........................%%%%%%%%%%............%%%
m %%%%...........%%%%%%%%%%%%%%%%%%%%%%%%%%%............................%%%%%%%%%........%%...................%%...%.............%%%
m %%%%..........%%%%%%%%%%%%%%%%%%%%%%%%%%%%.............................%%%%%%%%%%%.%%%%%%%.....................................%%%
m %%%%.........%%%%%%%%%%%%%%%%%%%%%%%%%%%%%............................%%%%%%%%%%%%%%%%%%%%......4..............................%%%
m %%%%%.......%%%%%%%%%%%%%%%%%%%%%%%%%%%%%.............................%%%%%%%%%%%%%%%%%%%%%...................................%%%%
m %%%%%.....%%%%%%%%%%%%%%%%%%%%%%.......%...............................%%%%%%%%%%%%%%%%%%%%.........................%%%%%%%%%%%%%%
m %%%%%...%%%%%%%%%%%%%%%%%%%%%%%%........................................%%%%%%%%%%%%%%%%%%.........................%%%%%%%%%%%%%%%
m %%%%%.%%%%%%%%%%%%%%%.%%%%%%%%%..........................................%%%%%%%%%%%%%%%%%.........................%%%%%%%%%%%%%%%
m %%%%%%%%%%%%%%%%%%%...%%%%%%%%%...............................................%%%%%%%%%%%........%.................%%%%%%%%%%%%%%%
m %%%%%%%%%%%%%%%%%.....%%%%%%%%%..................................................%%%%%%%%........%%%%%............%%%%%%%%%%%%%%%%
m %%%%%%%%%%%%%%%.......%%%%%%%%%....................................................%%%%%........%%%%%%.............%%%%%%%%%%%%%%%
m %%%%%%%%%%%%%%.........%%%%%%%..............%%...%......%%.............................%.......%%%%%%%.............%%%%%%%%%%%%%%%
m %%%%%%%%%%%%%..........%%%%%%%.............%%%%%%%%...%%%%%%%%%%%%%............................%%%%%%%%............%%%%%%%%%%%%%%%
m %%%%%%%%%%%%...........%%%%%%%.............%%%%%%%%%%%%%%%%%%%%%%%%.............................%%%%%%%............%.............%
