# map type: cell maze
# random seed: -74821737
# players 6
# area 16615, 2769 (52.6^2) per player
# cell width: 1.53617142822
# cell size: 7.79292057429
# openness: 0.235675446732
# maze type prims
# vert_mirror
# horz_copy
# final parameters
# area: 15552
# grid size: (2, 3)
# tile size: (81, 32) 0.395061728395
# map size: (162, 96) 0.592592592593
# hill distance  87, 68  83, 61  23, 93  41, 36  75,149  75, 12  51, 61  55, 93  83,100  73,125   9, 36  23, 68  19, 61  87, 93  51,100  41,125  11,149  11, 12  55, 68  19,100   9,125  73, 36  43,149  43, 12
#        87, 68       0      11      71     100     103      78      65      71      38      73      60      54      43      27      82     117     117     102      54      60      77      46     135     126 
#        83, 61      11       0      82      89      92      67      54      60      49      76      71      65      54      38      71     106     106      97      43      71      88      35     124     115 
#        23, 93      71      82       0      77     126     135      60      54      65     100      73      27      38      54      43      60      78     103      71      11      46     117     102     117 
#        41, 36     100      89      77       0      91      82      35      73     106     123     106      60      71     117      76      93      99      90      46      88     123     106      67      42 
#        75,149     103      92     126      91       0      25     106     102      67      42      99     135     124      78      97      82      48      57     117     115      90      67      48      57 
#        75, 12      78      67     135      82      25       0      97     117      92      67      90     126     115     103     106      91      57      48     102     124      99      42      57      48 
#        51, 61      65      54      60      35     106      97       0      38      71      88      89      43      54      82      49      76     124     115      11      71     106      71      92      67 
#        55, 93      71      60      54      73     102     117      38       0      43      60     117      71      82      54      11      46     126     135      27      65     100      77      78     103 
#        83,100      38      49      65     106      67      92      71      43       0      35      88      82      71      11      54      89      97     106      60      54      71      76     115     124 
#        73,125      73      76     100     123      42      67      88      60      35       0     123     117     106      46      71     106      82      91      77      89     106      93      90      99 
#         9, 36      60      71      73     106      99      90      89     117      88     123       0      46      35      77     106     123      67      42     100      76      93     106      91      82 
#        23, 68      54      65      27      60     135     126      43      71      82     117      46       0      11      71      60      77     103      78      54      38      73     100     117     102 
#        19, 61      43      54      38      71     124     115      54      82      71     106      35      11       0      60      71      88      92      67      65      49      76      89     106      97 
#        87, 93      27      38      54     117      78     103      82      54      11      46      77      71      60       0      65     100     102     117      71      43      60      73     126     135 
#        51,100      82      71      43      76      97     106      49      11      54      71     106      60      71      65       0      35     115     124      38      54      89      88      67      92 
#        41,125     117     106      60      93      82      91      76      46      89     106     123      77      88     100      35       0      90      99      73      71     106     123      42      67 
#        11,149     117     106      78      99      48      57     124     126      97      82      67     103      92     102     115      90       0      25     135      67      42      91      48      57 
#        11, 12     102      97     103      90      57      48     115     135     106      91      42      78      67     117     124      99      25       0     126      92      67      82      57      48 
#        55, 68      54      43      71      46     117     102      11      27      60      77     100      54      65      71      38      73     135     126       0      82     117      60     103      78 
#        19,100      60      71      11      88     115     124      71      65      54      89      76      38      49      43      54      71      67      92      82       0      35     106      97     106 
#         9,125      77      88      46     123      90      99     106     100      71     106      93      73      76      60      89     106      42      67     117      35       0     123      82      91 
#        73, 36      46      35     117     106      67      42      71      77      76      93     106     100      89      73      88     123      91      82      60     106     123       0      99      90 
#        43,149     135     124     102      67      48      57      92      78     115      90      91     117     106     126      67      42      48      57     103      97      82      99       0      25 
#        43, 12     126     115     117      42      57      48      67     103     124      99      82     102      97     135      92      67      57      48      78     106      91      90      25       0 
players 6
rows 96
cols 162
m ....................%%%................................%%...........%%%....................%%%...........%%................................%%%....................
m ..................%%%%..................................%............%%%..................%%%............%..................................%%%%..................
m .................%%%...............%....................%%.............%..................%.............%%....................%...............%%%.................
m .....%%.........%%.................%%%%.................%%..............................................%%.................%%%%.................%%.........%%.....
m ......%%........%%...................%%.................%%%............................................%%%.................%%...................%%........%%......
m ......%%........%%....................%%.................%%%%........................................%%%%.................%%....................%%........%%......
m .......%%....%%%%............%%........%%..................%%%......................................%%%..................%%........%%............%%%%....%%.......
m .......%%%%%%%%%%%...........%.........%%.......%............%......................................%............%.......%%.........%...........%%%%%%%%%%%.......
m ........%%%......%..........%%..........%%%%%%%%%%..............................................................%%%%%%%%%%..........%%..........%......%%%........
m .................%%..........%......0....%%%%%%%%%%............................................................%%%%%%%%%%....1......%..........%%.................
m ..................%%.........%%.........................................%%%............%%%.........................................%%.........%%..................
m ............5.....%%.........%%........................................%%%..............%%%........................................%%.........%%.....3............
m ..................%...........%%..............................%%......%%..................%%......%%..............................%%...........%..................
m ......%...........%...........%%%%%%%%%%.......................%%%..%%%....................%%%..%%%.......................%%%%%%%%%%...........%...........%......
m %%%%%%%%..........%...........%%%%%%%%%%.........................%%%%%......................%%%%%.........................%%%%%%%%%%...........%..........%%%%%%%%
m %%.....%%.....................%....................................%..........................%....................................%.....................%%.....%%
m ........%%...................%%..................%%%%..............%%........................%%..............%%%%..................%%...................%%........
m .........%%..................%.................%%%%%%%.............%%%......................%%%.............%%%%%%%.................%..................%%.........
m ..........%..........%%%%%%%%%.............%%%%%%....%%.............%%%....................%%%.............%%....%%%%%%.............%%%%%%%%%..........%..........
m .....................%%%%%%%%%...........%%%%........%%%.....0.......%%%..................%%%.......1.....%%%........%%%%...........%%%%%%%%%.....................
m .........................................%%...........%%%.............%%%................%%%.............%%%...........%%.........................................
m ........................................%%.............%%%.............%%%......%%......%%%.............%%%.............%%........................................
m .......................................%%%...............%%.............%%%%%%%%%%%%%%%%%%.............%%...............%%%.......................................
m ...................%................%%%%%.................%%........0....%%%%%%%%%%%%%%%%....1........%%.................%%%%%................%...................
m ..........%%%%%%%%%%%..........%%%%%%%.....................%%%......................................%%%.....................%%%%%%%..........%%%%%%%%%%%..........
m ..........%%%%%...............%%%%%.........................%%%....................................%%%.........................%%%%%...............%%%%%..........
m .........%%.................%%%..............................%%%..................................%%%..............................%%%.................%%.........
m .........%%...............%%%%.................................%%%..............................%%%.................................%%%%...............%%.........
m .........%%..............%%%.....................%%%............%%%............................%%%............%%%.....................%%%..............%%.........
m ..........%............%%%..................%%%%%%%%%.............%%..........................%%.............%%%%%%%%%..................%%%............%..........
m .......................%%...................%%%%....%%%............%%........................%%............%%%....%%%%...................%%.......................
m ......................%%%.............................%%%...........%%......................%%...........%%%.............................%%%......................
m ....................%%%................................%%...........%%%....................%%%...........%%................................%%%....................
m ..................%%%%..................................%............%%%..................%%%............%..................................%%%%..................
m .................%%%...............%....................%%.............%..................%.............%%....................%...............%%%.................
m .....%%.........%%.................%%%%.................%%..............................................%%.................%%%%.................%%.........%%.....
m ......%%........%%...................%%.................%%%............................................%%%.................%%...................%%........%%......
m ......%%........%%....................%%.................%%%%........................................%%%%.................%%....................%%........%%......
m .......%%....%%%%............%%........%%..................%%%......................................%%%..................%%........%%............%%%%....%%.......
m .......%%%%%%%%%%%...........%.........%%.......%............%......................................%............%.......%%.........%...........%%%%%%%%%%%.......
m ........%%%......%..........%%..........%%%%%%%%%%..............................................................%%%%%%%%%%..........%%..........%......%%%........
m .................%%..........%......2....%%%%%%%%%%............................................................%%%%%%%%%%....4......%..........%%.................
m ..................%%.........%%.........................................%%%............%%%.........................................%%.........%%..................
m ............1.....%%.........%%........................................%%%..............%%%........................................%%.........%%.....0............
m ..................%...........%%..............................%%......%%..................%%......%%..............................%%...........%..................
m ......%...........%...........%%%%%%%%%%.......................%%%..%%%....................%%%..%%%.......................%%%%%%%%%%...........%...........%......
m %%%%%%%%..........%...........%%%%%%%%%%.........................%%%%%......................%%%%%.........................%%%%%%%%%%...........%..........%%%%%%%%
m %%.....%%.....................%....................................%..........................%....................................%.....................%%.....%%
m ........%%...................%%..................%%%%..............%%........................%%..............%%%%..................%%...................%%........
m .........%%..................%.................%%%%%%%.............%%%......................%%%.............%%%%%%%.................%..................%%.........
m ..........%..........%%%%%%%%%.............%%%%%%....%%.............%%%....................%%%.............%%....%%%%%%.............%%%%%%%%%..........%..........
m .....................%%%%%%%%%...........%%%%........%%%.....2.......%%%..................%%%.......4.....%%%........%%%%...........%%%%%%%%%.....................
m .........................................%%...........%%%.............%%%................%%%.............%%%...........%%.........................................
m ........................................%%.............%%%.............%%%......%%......%%%.............%%%.............%%........................................
m .......................................%%%...............%%.............%%%%%%%%%%%%%%%%%%.............%%...............%%%.......................................
m ...................%................%%%%%.................%%........2....%%%%%%%%%%%%%%%%....4........%%.................%%%%%................%...................
m ..........%%%%%%%%%%%..........%%%%%%%.....................%%%......................................%%%.....................%%%%%%%..........%%%%%%%%%%%..........
m ..........%%%%%...............%%%%%.........................%%%....................................%%%.........................%%%%%...............%%%%%..........
m .........%%.................%%%..............................%%%..................................%%%..............................%%%.................%%.........
m .........%%...............%%%%.................................%%%..............................%%%.................................%%%%...............%%.........
m .........%%..............%%%.....................%%%............%%%............................%%%............%%%.....................%%%..............%%.........
m ..........%............%%%..................%%%%%%%%%.............%%..........................%%.............%%%%%%%%%..................%%%............%..........
m .......................%%...................%%%%....%%%............%%........................%%............%%%....%%%%...................%%.......................
m ......................%%%.............................%%%...........%%......................%%...........%%%.............................%%%......................
m ....................%%%................................%%...........%%%....................%%%...........%%................................%%%....................
m ..................%%%%..................................%............%%%..................%%%............%..................................%%%%..................
m .................%%%...............%....................%%.............%..................%.............%%....................%...............%%%.................
m .....%%.........%%.................%%%%.................%%..............................................%%.................%%%%.................%%.........%%.....
m ......%%........%%...................%%.................%%%............................................%%%.................%%...................%%........%%......
m ......%%........%%....................%%.................%%%%........................................%%%%.................%%....................%%........%%......
m .......%%....%%%%............%%........%%..................%%%......................................%%%..................%%........%%............%%%%....%%.......
m .......%%%%%%%%%%%...........%.........%%.......%............%......................................%............%.......%%.........%...........%%%%%%%%%%%.......
m ........%%%......%..........%%..........%%%%%%%%%%..............................................................%%%%%%%%%%..........%%..........%......%%%........
m .................%%..........%......3....%%%%%%%%%%............................................................%%%%%%%%%%....5......%..........%%.................
m ..................%%.........%%.........................................%%%............%%%.........................................%%.........%%..................
m ............4.....%%.........%%........................................%%%..............%%%........................................%%.........%%.....2............
m ..................%...........%%..............................%%......%%..................%%......%%..............................%%...........%..................
m ......%...........%...........%%%%%%%%%%.......................%%%..%%%....................%%%..%%%.......................%%%%%%%%%%...........%...........%......
m %%%%%%%%..........%...........%%%%%%%%%%.........................%%%%%......................%%%%%.........................%%%%%%%%%%...........%..........%%%%%%%%
m %%.....%%.....................%....................................%..........................%....................................%.....................%%.....%%
m ........%%...................%%..................%%%%..............%%........................%%..............%%%%..................%%...................%%........
m .........%%..................%.................%%%%%%%.............%%%......................%%%.............%%%%%%%.................%..................%%.........
m ..........%..........%%%%%%%%%.............%%%%%%....%%.............%%%....................%%%.............%%....%%%%%%.............%%%%%%%%%..........%..........
m .....................%%%%%%%%%...........%%%%........%%%.....3.......%%%..................%%%.......5.....%%%........%%%%...........%%%%%%%%%.....................
m .........................................%%...........%%%.............%%%................%%%.............%%%...........%%.........................................
m ........................................%%.............%%%.............%%%......%%......%%%.............%%%.............%%........................................
m .......................................%%%...............%%.............%%%%%%%%%%%%%%%%%%.............%%...............%%%.......................................
m ...................%................%%%%%.................%%........3....%%%%%%%%%%%%%%%%....5........%%.................%%%%%................%...................
m ..........%%%%%%%%%%%..........%%%%%%%.....................%%%......................................%%%.....................%%%%%%%..........%%%%%%%%%%%..........
m ..........%%%%%...............%%%%%.........................%%%....................................%%%.........................%%%%%...............%%%%%..........
m .........%%.................%%%..............................%%%..................................%%%..............................%%%.................%%.........
m .........%%...............%%%%.................................%%%..............................%%%.................................%%%%...............%%.........
m .........%%..............%%%.....................%%%............%%%............................%%%............%%%.....................%%%..............%%.........
m ..........%............%%%..................%%%%%%%%%.............%%..........................%%.............%%%%%%%%%..................%%%............%..........
m .......................%%...................%%%%....%%%............%%........................%%............%%%....%%%%...................%%.......................
m ......................%%%.............................%%%...........%%......................%%...........%%%.............................%%%......................
