# map type: cell maze
# random seed: 876010886
# players 2
# area 7981, 3990 (63.2^2) per player
# cell width: 1.97991142441
# cell size: 8.26155792721
# openness: 0.0905737185305
# maze type backtrack
# horz_mirror
# final parameters
# area: 7896
# grid size: (1, 2)
# tile size: (42, 94) 2.2380952381
# map size: (42, 188) 4.47619047619
# hill distance   1, 32   1,155
#         1, 32       0     149 
#         1,155     149       0 
players 2
rows 42
cols 188
m ................%%%.....%%%..................%%%................%%%...........%%%..........................%%%...........%%%................%%%..................%%%.....%%%................
m ................%%%.............0.......%%.......................%%......................................................%%.......................%%.......1.............%%%................
m .......%%.......%%.....................%%%.......................%%......................................................%%.......................%%%.....................%%.......%%.......
m .......%%%......%%.....................%%...........%%...........%%%%..................................................%%%%...........%%...........%%.....................%%......%%%.......
m .......%%.......%%.....................%%...........%%............%%%%......%%................................%%......%%%%............%%...........%%.....................%%.......%%.......
m .......%%.......%%....................%%%...........%%%.............%%%%....%%%..............................%%%....%%%%.............%%%...........%%%....................%%.......%%.......
m .......%%.......%%..........%%......%%%%%............%%..............%%%%....%%%............................%%%....%%%%..............%%............%%%%%......%%..........%%.......%%.......
m .......%%........%%.......%%%%%%%%%%%%%%%%..........%%%%%..............%%.....%%%..........%%%%%%..........%%%.....%%..............%%%%%..........%%%%%%%%%%%%%%%%.......%%........%%.......
m .......%%........%%......%%%%%%%%%%%%..%%%.........%%%%%%%%....................%%..........%%%%%%..........%%....................%%%%%%%%.........%%%..%%%%%%%%%%%%......%%........%%.......
m .......%%%.......%%%....%%%%....%%......%%%........%%...%%%%%...................%%........................%%...................%%%%%...%%........%%%......%%....%%%%....%%%.......%%%.......
m .......%%%%.......%%%%%%%%...............%%%......%%......%%%...................%%%......................%%%...................%%%......%%......%%%...............%%%%%%%%.......%%%%.......
m .........%%%%.......%%%%%.................%%%%%..%%%........%....................%%%....................%%%....................%........%%%..%%%%%.................%%%%%.......%%%%.........
m ..........%%%%.......%%%...................%%%%%%%%...............................%%%%................%%%%...............................%%%%%%%%...................%%%.......%%%%..........
m ...........%%%.......%%.......................%%%%.................................%%..................%%.................................%%%%.......................%%.......%%%...........
m %...........%.........%%...........................................................%%..................%%...........................................................%%.........%...........%
m ...........%%%........%%.............................................%%...........%%%..................%%%...........%%.............................................%%........%%%...........
m ...........%%%........%%...........................................%%%%%%.......%%%%%..................%%%%%.......%%%%%%...........................................%%........%%%...........
m ...........%%%........%%......................................%%.%%%%%%%%%%..%%%%%%%%%................%%%%%%%%%..%%%%%%%%%%.%%......................................%%........%%%...........
m ...........%%%.......%%%....................................%%%%%%%%.....%%%%%%%....%%................%%....%%%%%%%.....%%%%%%%%....................................%%%.......%%%...........
m ...........%%%......%%%.......%%%%%%%%%%%...........%%%...%%%%...%.........%%.......%%%..............%%%.......%%.........%...%%%%...%%%...........%%%%%%%%%%%.......%%%......%%%...........
m ...........%%%....%%%%.........%%%%%%%%%%..........%%%%%%%%%%........................%%%............%%%........................%%%%%%%%%%..........%%%%%%%%%%.........%%%%....%%%...........
m ..........%%%%...%%%%..........%%.................%%%..%%%%...........................%%............%%...........................%%%%..%%%.................%%..........%%%%...%%%%..........
m ..........%%.....%%%...........%%................%%%..................................%%%...%%%%...%%%..................................%%%................%%...........%%%.....%%..........
m .........%%%......%%%..........%%...............%%%....................................%%%%%%%%%%%%%%....................................%%%...............%%..........%%%......%%%.........
m .........%%........%%..........%%..............%%%.....................................%%%%%%..%%%%%%.....................................%%%..............%%..........%%........%%.........
m ........%%%........%%.........%%..............%%%..........................................................................................%%%..............%%.........%%........%%%........
m ........%%.........%%%........%%.............%%%............................................................................................%%%.............%%........%%%.........%%........
m .......%%%..........%%........%%............%%%....................%%%.....%%..................................%%.....%%%....................%%%............%%........%%..........%%%.......
m .......%%...........%%........%%.............%%%..........%%......%%%%%%%%%%%%%%%%%%....................%%%%%%%%%%%%%%%%%%......%%..........%%%.............%%........%%...........%%.......
m ......%%%...........%%%.......%%%.............%%%.........%%%%...%%%%.%%%%%%%%%%%%%%%%................%%%%%%%%%%%%%%%%.%%%%...%%%%.........%%%.............%%%.......%%%...........%%%......
m .....%%%.............%%%%......%%%%............%%%.........%%%%%%%%......%%.......%%%%%..............%%%%%.......%%......%%%%%%%%.........%%%............%%%%......%%%%.............%%%.....
m .....%%%%.............%%%........%%%............%%...........%%%%%...................%%..............%%...................%%%%%...........%%............%%%........%%%.............%%%%.....
m ...%%%%%%%%...........%%%.........%%%............%%%%%.........%%....................%%..............%%....................%%.........%%%%%............%%%.........%%%...........%%%%%%%%...
m %%%%%%%%%%%%%%.........%%..........%%%...........%%%%%%..............................%%..............%%..............................%%%%%%...........%%%..........%%.........%%%%%%%%%%%%%%
m %%%.......%%%%%........%%...........%%..........%%%..%...............................%%%............%%%...............................%..%%%..........%%...........%%........%%%%%.......%%%
m %%..........%%%........%%...........%%..........%%%.....................%%...........%%%............%%%...........%%.....................%%%..........%%...........%%........%%%..........%%
m .............%%%.......%%..........%%...........%%....................%%%%%..........%%..............%%..........%%%%%....................%%...........%%..........%%.......%%%.............
m ..............%%.......%%...........%...........%%..................%%%%%%%%........%%................%%........%%%%%%%%..................%%...........%...........%%.......%%..............
m ..............%%%......%%......................%%................%%%%%%....%%%......%%................%%......%%%....%%%%%%................%%......................%%......%%%..............
m ...............%%......%%%.....................%%.........%.%%%%%%%%%.......%%%...%%%..................%%%...%%%.......%%%%%%%%%.%.........%%.....................%%%......%%...............
m ...............%%%.....%%%....................%%%........%%%%%%%%%%%.........%%%%%%%%..................%%%%%%%%.........%%%%%%%%%%%........%%%....................%%%.....%%%...............
m ................%%%....%%%%...................%%%........%%.%%%%%%............%%%%%......................%%%%%............%%%%%%.%%........%%%...................%%%%....%%%................
