# map type: blank
# random seed: 1831722573
# hill distance  88, 39  88, 60  15, 89  15, 10  15,189  15,110  88,160  88,139
#        88, 39       0      25      85      60      85     110      89     114 
#        88, 60      25       0      60      85     110      85     114      89 
#        15, 89      85      60       0      89     114      25     110      85 
#        15, 10      60      85      89       0      25     114      85     110 
#        15,189      85     110     114      25       0      89      60      85 
#        15,110     110      85      25     114      89       0      85      60 
#        88,160      89     114     110      85      60      85       0      25 
#        88,139     114      89      85     110      85      60      25       0 
players 8
rows 104
cols 200
m ...............%%%.............%%%................................%%%.............%%%..............................%%%.............%%%................................%%%.............%%%...............
m ...............%%...............%%............%%....%%............%%...............%%..............................%%...............%%............%%....%%............%%...............%%...............
m ..............%%.................%%............%%%%%%............%%.................%%............................%%.................%%............%%%%%%............%%.................%%..............
m .............%%%..................%%............%%%%............%%..................%%%..........................%%%..................%%............%%%%............%%..................%%%.............
m .............%%....................%%............%%............%%....................%%..........................%%....................%%............%%............%%....................%%.............
m ............%%........................................................................%%........................%%........................................................................%%............
m ...........%%%........................................................................%%%......................%%%........................................................................%%%...........
m .......%%%%%%..........................................................................%%%%%%..............%%%%%%..........................................................................%%%%%%.......
m ......%%%%%%............................................................................%%%%%%............%%%%%%............................................................................%%%%%%......
m ......%%....................................................................................%%............%%....................................................................................%%......
m .....%%......................................................................................%%..........%%......................................................................................%%.....
m ....%%..............%%%%%%.........%%..........................%%.........%%%%%%..............%%........%%..............%%%%%%.........%%..........................%%.........%%%%%%..............%%....
m ...%%...........%%%%%%%%%%%.......%%%..........................%%%.......%%%%%%%%%%%...........%%......%%...........%%%%%%%%%%%.......%%%..........................%%%.......%%%%%%%%%%%...........%%...
m ..%%%...........%%%%.....%%%.....%%%............................%%%.....%%%.....%%%%...........%%%....%%%...........%%%%.....%%%.....%%%............................%%%.....%%%.....%%%%...........%%%..
m .%%%............%%........%%%%%%%%%..............................%%%%%%%%%........%%............%%%..%%%............%%........%%%%%%%%%..............................%%%%%%%%%........%%............%%%.
m %%%.......0....%%...........%%%%%%................................%%%%%%...........%%....2.......%%%%%%.......4....%%...........%%%%%%................................%%%%%%...........%%....6.......%%%
m %%.............%%..................................................................%%.............%%%%.............%%..................................................................%%.............%%
m ...............%%..................................................................%%..............................%%..................................................................%%...............
m ...............%%..................................................................%%..............................%%..................................................................%%...............
m ..............%%....................................................................%%............................%%....................................................................%%..............
m ..............%%....................................................................%%............................%%....................................................................%%..............
m ..............%%....................................................................%%............................%%....................................................................%%..............
m .............%%%.....................%........................%.....................%%%..........................%%%.....................%........................%.....................%%%.............
m ............%%%%....................%%........................%%....................%%%%........................%%%%....................%%........................%%....................%%%%............
m ............%.......................%%........................%%.......................%........................%.......................%%........................%%.......................%............
m ......................%............%%..........................%%............%............................................%............%%..........................%%............%......................
m ......................%%........%%%%%..........................%%%%%........%%............................................%%........%%%%%..........................%%%%%........%%......................
m .......................%%%%%%%%%%%%%............................%%%%%%%%%%%%%..............................................%%%%%%%%%%%%%............................%%%%%%%%%%%%%.......................
m .........%%............%%%%%%%........................................%%%%%%%............%%..................%%............%%%%%%%........................................%%%%%%%............%%.........
m .........%%............%%..................................................%%............%%..................%%............%%..................................................%%............%%.........
m .........%%%...........%%..................................................%%...........%%%..................%%%...........%%..................................................%%...........%%%.........
m ..........%%..........%%%..................................................%%%..........%%....................%%..........%%%..................................................%%%..........%%..........
m ...........%%........%%%....................................................%%%........%%......................%%........%%%....................................................%%%........%%...........
m ...........%%.......%%%......................................................%%%.......%%......................%%.......%%%......................................................%%%.......%%...........
m ...........%%......%%%.................%....................%.................%%%......%%......................%%......%%%.................%....................%.................%%%......%%...........
m ............%%....%%%................%%%....................%%%................%%%....%%........................%%....%%%................%%%....................%%%................%%%....%%............
m ............%%%%%%%%.............%%%%%%%....................%%%%%%%.............%%%%%%%%........................%%%%%%%%.............%%%%%%%....................%%%%%%%.............%%%%%%%%............
m .............%%%%%%..........%%%%%%%%%%%%..................%%%%%%%%%%%%..........%%%%%%..........................%%%%%%..........%%%%%%%%%%%%..................%%%%%%%%%%%%..........%%%%%%.............
m %%...............%%.........%%%%.......%%..................%%.......%%%%.........%%...............%%%%...............%%.........%%%%.......%%..................%%.......%%%%.........%%...............%%
m %%%%..............%%........%%.........%%..................%%.........%%........%%..............%%%%%%%%..............%%........%%.........%%..................%%.........%%........%%..............%%%%
m .%%%%%............%%........%...........%%................%%...........%........%%............%%%%%..%%%%%............%%........%...........%%................%%...........%........%%............%%%%%.
m ....%%%%%.........%%.......%%...........%..................%...........%%.......%%.........%%%%%........%%%%%.........%%.......%%...........%..................%...........%%.......%%.........%%%%%....
m ......%%%..........%%......%%..........................................%%......%%..........%%%............%%%..........%%......%%..........................................%%......%%..........%%%......
m .......%%..........%%%.....%%..........................................%%.....%%%..........%%..............%%..........%%%.....%%..........................................%%.....%%%..........%%.......
m ........%...........%%......%%........................................%%......%%...........%................%...........%%......%%........................................%%......%%...........%........
m ........%%.........%%.......%%%......................................%%%.......%%.........%%................%%.........%%.......%%%......................................%%%.......%%.........%%........
m ........%%........%%.........%%......................................%%.........%%........%%................%%........%%.........%%......................................%%.........%%........%%........
m ........%%%.......%%..........%%....................................%%..........%%.......%%%................%%%.......%%..........%%....................................%%..........%%.......%%%........
m .........%%......%%...........%%%..................................%%%...........%%......%%..................%%......%%...........%%%..................................%%%...........%%......%%.........
m .........%%......%%............%%%................................%%%............%%......%%..................%%......%%............%%%................................%%%............%%......%%.........
m ................%%%.............%%%..............................%%%.............%%%................................%%%.............%%%..............................%%%.............%%%................
m ..............%%%%..............%%%..............................%%%..............%%%%............................%%%%..............%%%..............................%%%..............%%%%..............
m ...............%%%..............%%%%............................%%%%..............%%%..............................%%%..............%%%%............................%%%%..............%%%...............
m ...............%%%.............%%%................................%%%.............%%%..............................%%%.............%%%................................%%%.............%%%...............
m ................%%%............%%......%%..................%%......%%............%%%................................%%%............%%......%%..................%%......%%............%%%................
m .................%%%...........%%......%%..................%%......%%...........%%%..................................%%%...........%%......%%..................%%......%%...........%%%.................
m ..................%%..........%%.......%%%................%%%.......%%..........%%....................................%%..........%%.......%%%................%%%.......%%..........%%..................
m ...................%%.........%%........%%................%%........%%.........%%......................................%%.........%%........%%................%%........%%.........%%...................
m ...................%%%.......%%.........%%................%%.........%%.......%%%......................................%%%.......%%.........%%................%%.........%%.......%%%...................
m ....................%%......%%...........%................%...........%%......%%........................................%%......%%...........%................%...........%%......%%....................
m .....................%%.....%%%..........%%..............%%..........%%%.....%%..........................................%%.....%%%..........%%..............%%..........%%%.....%%.....................
m .....................%%......%%..........%%%............%%%..........%%......%%..........................................%%......%%..........%%%............%%%..........%%......%%.....................
m .........%...........%%.......%%.........%%%%%........%%%%%.........%%.......%%...........%..................%...........%%.......%%.........%%%%%........%%%%%.........%%.......%%...........%.........
m ........%%...........%........%%............%%%%%..%%%%%............%%........%...........%%................%%...........%........%%............%%%%%..%%%%%............%%........%...........%%........
m .........%%.........%%........%%..............%%%%%%%%..............%%........%%.........%%..................%%.........%%........%%..............%%%%%%%%..............%%........%%.........%%.........
m .........%%.......%%%%.........%%...............%%%%...............%%.........%%%%.......%%..................%%.......%%%%.........%%...............%%%%...............%%.........%%%%.......%%.........
m .........%%%%%%%%%%%%..........%%%%%%..........................%%%%%%..........%%%%%%%%%%%%..................%%%%%%%%%%%%..........%%%%%%..........................%%%%%%..........%%%%%%%%%%%%.........
m ..........%%%%%%%.............%%%%%%%%........................%%%%%%%%.............%%%%%%%....................%%%%%%%.............%%%%%%%%........................%%%%%%%%.............%%%%%%%..........
m ..........%%%................%%%....%%........................%%....%%%................%%%....................%%%................%%%....%%........................%%....%%%................%%%..........
m ..........%.................%%%......%%......................%%......%%%.................%....................%.................%%%......%%......................%%......%%%.................%..........
m ...........................%%%.......%%......................%%.......%%%......................................................%%%.......%%......................%%.......%%%...........................
m ..........................%%%........%%......................%%........%%%....................................................%%%........%%......................%%........%%%..........................
m .........................%%%..........%%....................%%..........%%%..................................................%%%..........%%....................%%..........%%%.........................
m .........................%%...........%%%..................%%%...........%%..................................................%%...........%%%..................%%%...........%%.........................
m .........................%%............%%..................%%............%%..................................................%%............%%..................%%............%%.........................
m ....................%%%%%%%............%%..................%%............%%%%%%%........................................%%%%%%%............%%..................%%............%%%%%%%....................
m ..............%%%%%%%%%%%%%..............................................%%%%%%%%%%%%%............................%%%%%%%%%%%%%..............................................%%%%%%%%%%%%%..............
m .............%%%%%........%%............................................%%........%%%%%..........................%%%%%........%%............................................%%........%%%%%.............
m .............%%............%............................................%............%%..........................%%............%............................................%............%%.............
m ............%%.......................%........................%.......................%%........................%%.......................%........................%.......................%%............
m ............%%....................%%%%........................%%%%....................%%........................%%....................%%%%........................%%%%....................%%............
m ............%.....................%%%..........................%%%.....................%........................%.....................%%%..........................%%%.....................%............
m ..................................%%............................%%....................................................................%%............................%%..................................
m ..................................%%............................%%....................................................................%%............................%%..................................
m ..................................%%............................%%....................................................................%%............................%%..................................
m .................................%%..............................%%..................................................................%%..............................%%.................................
m .................................%%..............................%%..................................................................%%..............................%%.................................
m .................................%%.............%%%%.............%%..................................................................%%.............%%%%.............%%.................................
m ................%%%%%%...........%%....1.......%%%%%%.......3....%%...........%%%%%%................................%%%%%%...........%%....5.......%%%%%%.......7....%%...........%%%%%%................
m ...............%%%%%%%%%........%%............%%%..%%%............%%........%%%%%%%%%..............................%%%%%%%%%........%%............%%%..%%%............%%........%%%%%%%%%...............
m ..............%%%.....%%%.....%%%%...........%%%....%%%...........%%%%.....%%%.....%%%............................%%%.....%%%.....%%%%...........%%%....%%%...........%%%%.....%%%.....%%%..............
m .............%%%.......%%%%%%%%%%%...........%%......%%...........%%%%%%%%%%%.......%%%..........................%%%.......%%%%%%%%%%%...........%%......%%...........%%%%%%%%%%%.......%%%.............
m .............%%.........%%%%%%..............%%........%%..............%%%%%%.........%%..........................%%.........%%%%%%..............%%........%%..............%%%%%%.........%%.............
m ...........................................%%..........%%......................................................................................%%..........%%...........................................
m ..........................................%%............%%....................................................................................%%............%%..........................................
m ......................................%%%%%%............%%%%%%............................................................................%%%%%%............%%%%%%......................................
m .....................................%%%%%%..............%%%%%%..........................................................................%%%%%%..............%%%%%%.....................................
m ....................................%%%......................%%%........................................................................%%%......................%%%....................................
m ....................................%%........................%%........................................................................%%........................%%....................................
m %............%%....................%%..........................%%....................%%............%%............%%....................%%..........................%%....................%%............%
m %%............%%..................%%%..........................%%%..................%%............%%%%............%%..................%%%..........................%%%..................%%............%%
m %%%............%%.................%%............................%%.................%%............%%%%%%............%%.................%%............................%%.................%%............%%%
m ..%%............%%...............%%..............................%%...............%%............%%....%%............%%...............%%..............................%%...............%%............%%..
m ................%%%.............%%%..............................%%%.............%%%................................%%%.............%%%..............................%%%.............%%%................
