# map type: blank
# random seed: 266599629
# hill distance  17, 98  86,178 109,138  40, 58  63, 18
#        17, 98       0     150      87      87     150 
#        86,178     150       0      87     150      87 
#       109,138      87      87       0     150     150 
#        40, 58      87     150     150       0      87 
#        63, 18     150      87     150      87       0 
players 5
rows 115
cols 200
m ....%...........%............%.......%...........%%..........%%...........%%%%.........%%.................%%%..........%%......%........%%%%%%..............................%..........%.............%%%
m %%%%.............%...........%%.....%...........%%.........%%%%%...........%%%..........%%.................%.........%%%%.....%%.......%%....%..............................%..........%...............%
m ..%%.............%%%..........%%...............%%..............%%...........%%...........%%................%........%%.......%%.......%......%%.............................%..........%%...............
m ..%%.............%............%%...............%................%%...........%%...........%%%..%...........%........%.......%%................%........%%%%.................%...........%...............
m ..%.............%%............%................%.................%..........%%%%...........%%%%............%........%.......%%.................%......%%..%%%%%%%..........%%...........%%..............
m ..%.............%%............%................%............................%%%%%..........................%........%.......%%.......................%%.......%%%..........%%%%...........%%............
m .%%.............%%...........%%................%%%..........................%...%%.......................%%%%...............%%.......................%..........%..........%..%%%...........%%..........
m .%.........%.....%...........%................%..%%%.......................%.....%%....................%%%..%%..............%%..................................%..........%.....%%%.........%%%........
m %%........%%.....%%..........%...............%.....%%%.....................%......%......%...........%%%.....%%.............%%%................................%%..........%.......%....................
m %.........%.......%..........%..............%........%%%..................%..............%..........%%........%%............%.%%%%%............................%%.........%%............................
m %.........%.......%..........%.............%..............................%..............%..........%..........%%%%........%......%%%%.........................%..........%%............................
m %.........%.......%%........%............%%......................%%......%...............%%.........%...........%%........%..........%%%%%%....................%%.........%.............................
m %........%%........%........%...........%%%....................%%.%%%%...%................%.........%%..........%.........%..........%...%%%%...................%%..................%...................
m %........%.........%.....................%...........................%%%%.................%..........%..........%....................%.......%.......%%...........%%...............%%%%.................
m %........%........%......................%..............................%.................%%..........%.........%...................%%................%............%%............%%...%%%...............
m %........%%.......%%.....................%...............................%...............%%%%%.........%.......%....................%.................%........................%%.......%%%%............
m %.........%%.......%........%............%%.......%%%%...........................%%%%...%..............%%......%%..................%%.................%........................%..........%%...........%
m ...........%.......%........%%............%.%%%%%%%.............................%%..%%%%..........2.....%%...%%%%%%................%..................%...................................%............%
m ...........%........%........%%...........%%%%%.................................%%......................%%........%%%......%.......%..................%...................................%%...........%
m ...........%........%.........%%..........%%%...................................%......................%%............%%%..%........%..................%%..................................%%...........%
m ...........%........%%.........%%.........%%%%.............%%%%.................%......................%...............%%%.........%%...................%.....................%............%%..........%
m ...........%.........%..........%%%.........%%%..........%%...%%%.....%%........%.....................%.............................%....%%%%%...........%%..........%%.......%%............%.........%%
m ..........%%.........%%..........%%%.........%%%................%%%.%%%.........%....................%%.............................%%%%%%%...%%..........%%%%......%%.........%%...........%%.......%%.
m .........%%..........%%...........%%%%.........%%.................%%%..........%%......%........%%%%%%..............................%..........%.............%%%....%...........%............%.......%..
m ........%%.........%%%%%...........%%%..........%%.................%.........%%%%.....%%.......%%....%..............................%..........%...............%%%%%.............%...........%%.....%...
m .......%%..............%%...........%%...........%%................%........%%.......%%.......%......%%.............................%..........%%.................%%.............%%%..........%%........
m .......%................%%...........%%...........%%%..%...........%........%.......%%................%........%%%%.................%...........%.................%%.............%............%%........
m .......%.................%..........%%%%...........%%%%............%........%.......%%.................%......%%..%%%%%%%..........%%...........%%................%.............%%............%.........
m .......%............................%%%%%..........................%........%.......%%.......................%%.......%%%..........%%%%...........%%..............%.............%%............%.........
m .......%%%..........................%...%%.......................%%%%...............%%.......................%..........%..........%..%%%...........%%...........%%.............%%...........%%.........
m ......%..%%%.......................%.....%%....................%%%..%%..............%%..................................%..........%.....%%%.........%%%.........%.........%.....%...........%..........
m .....%.....%%%.....................%......%......%...........%%%.....%%.............%%%................................%%..........%.......%....................%%........%%.....%%..........%..........
m ....%........%%%..................%..............%..........%%........%%............%.%%%%%............................%%.........%%............................%.........%.......%..........%..........
m ...%..............................%..............%..........%..........%%%%........%......%%%%.........................%..........%%............................%.........%.......%..........%..........
m .%%......................%%......%...............%%.........%...........%%........%..........%%%%%%....................%%.........%.............................%.........%.......%%........%...........
m %%%....................%%.%%%%...%................%.........%%..........%.........%..........%...%%%%...................%%..................%...................%........%%........%........%...........
m .%...........................%%%%.................%..........%..........%....................%.......%.......%%...........%%...............%%%%.................%........%.........%....................
m .%..............................%.................%%..........%.........%...................%%................%............%%............%%...%%%...............%........%........%.....................
m .%...............................%...............%%%%%.........%.......%....................%.................%........................%%.......%%%%............%........%%.......%%....................
m .%%.......%%%%...........................%%%%...%..............%%......%%..................%%.................%........................%..........%%...........%%.........%%.......%........%...........
m ..%.%%%%%%%.............................%%..%%%%..........1.....%%...%%%%%%................%..................%...................................%............%...........%.......%........%%..........
m ..%%%%%.................................%%......................%%........%%%......%.......%..................%...................................%%...........%...........%........%........%%.........
m ..%%%...................................%......................%%............%%%..%........%..................%%..................................%%...........%...........%........%.........%%........
m ..%%%%.............%%%%.................%......................%...............%%%.........%%...................%.....................%............%%..........%...........%........%%.........%%.......
m ....%%%..........%%...%%%.....%%........%.....................%.............................%....%%%%%...........%%..........%%.......%%............%.........%%...........%.........%..........%%%.....
m .....%%%................%%%.%%%.........%....................%%.............................%%%%%%%...%%..........%%%%......%%.........%%...........%%.......%%...........%%.........%%..........%%%....
m .......%%.................%%%..........%%......%........%%%%%%..............................%..........%.............%%%....%...........%............%.......%...........%%..........%%...........%%%%..
m ........%%.................%.........%%%%.....%%.......%%....%..............................%..........%...............%%%%%.............%...........%%.....%...........%%.........%%%%%...........%%%..
m .........%%................%........%%.......%%.......%......%%.............................%..........%%.................%%.............%%%..........%%...............%%..............%%...........%%..
m ..........%%%..%...........%........%.......%%................%........%%%%.................%...........%.................%%.............%............%%...............%................%%...........%%.
m ...........%%%%............%........%.......%%.................%......%%..%%%%%%%..........%%...........%%................%.............%%............%................%.................%..........%%%%
m %..........................%........%.......%%.......................%%.......%%%..........%%%%...........%%..............%.............%%............%................%............................%%%%
m %%.......................%%%%...............%%.......................%..........%..........%..%%%...........%%...........%%.............%%...........%%................%%%..........................%...
m .%%....................%%%..%%..............%%..................................%..........%.....%%%.........%%%.........%.........%.....%...........%................%..%%%.......................%....
m ..%......%...........%%%.....%%.............%%%................................%%..........%.......%....................%%........%%.....%%..........%...............%.....%%%.....................%....
m .........%..........%%........%%............%.%%%%%............................%%.........%%............................%.........%.......%..........%..............%........%%%..................%.....
m .........%..........%..........%%%%........%......%%%%.........................%..........%%............................%.........%.......%..........%.............%..............................%.....
m .........%%.........%...........%%........%..........%%%%%%....................%%.........%.............................%.........%.......%%........%............%%......................%%......%......
m ..........%.........%%..........%.........%..........%...%%%%...................%%..................%...................%........%%........%........%...........%%%....................%%.%%%%...%......
m ..........%..........%..........%....................%.......%.......%%...........%%...............%%%%.................%........%.........%.....................%...........................%%%%.......
m ..........%%..........%.........%...................%%................%............%%............%%...%%%...............%........%........%......................%..............................%.......
m .........%%%%%.........%.......%....................%.................%........................%%.......%%%%............%........%%.......%%.....................%...............................%......
m .%%%%...%..............%%......%%..................%%.................%........................%..........%%...........%%.........%%.......%........%............%%.......%%%%..........................
m %%..%%%%..........0.....%%...%%%%%%................%..................%...................................%............%...........%.......%........%%............%.%%%%%%%.............................
m %%......................%%........%%%......%.......%..................%...................................%%...........%...........%........%........%%...........%%%%%.................................
m %......................%%............%%%..%........%..................%%..................................%%...........%...........%........%.........%%..........%%%...................................
m %......................%...............%%%.........%%...................%.....................%............%%..........%...........%........%%.........%%.........%%%%.............%%%%.................
m %.....................%.............................%....%%%%%...........%%..........%%.......%%............%.........%%...........%.........%..........%%%.........%%%..........%%...%%%.....%%........
m %....................%%.............................%%%%%%%...%%..........%%%%......%%.........%%...........%%.......%%...........%%.........%%..........%%%.........%%%................%%%.%%%.........
m %......%........%%%%%%..............................%..........%.............%%%....%...........%............%.......%...........%%..........%%...........%%%%.........%%.................%%%..........%
m %.....%%.......%%....%..............................%..........%...............%%%%%.............%...........%%.....%...........%%.........%%%%%...........%%%..........%%.................%.........%%%
m .....%%.......%......%%.............................%..........%%.................%%.............%%%..........%%...............%%..............%%...........%%...........%%................%........%%..
m ....%%................%........%%%%.................%...........%.................%%.............%............%%...............%................%%...........%%...........%%%..%...........%........%...
m ....%%.................%......%%..%%%%%%%..........%%...........%%................%.............%%............%................%.................%..........%%%%...........%%%%............%........%...
m ....%%.......................%%.......%%%..........%%%%...........%%..............%.............%%............%................%............................%%%%%..........................%........%...
m ....%%.......................%..........%..........%..%%%...........%%...........%%.............%%...........%%................%%%..........................%...%%.......................%%%%...........
m ....%%..................................%..........%.....%%%.........%%%.........%.........%.....%...........%................%..%%%.......................%.....%%....................%%%..%%..........
m ....%%%................................%%..........%.......%....................%%........%%.....%%..........%...............%.....%%%.....................%......%......%...........%%%.....%%.........
m ....%.%%%%%............................%%.........%%............................%.........%.......%..........%..............%........%%%..................%..............%..........%%........%%........
m ...%......%%%%.........................%..........%%............................%.........%.......%..........%.............%..............................%..............%..........%..........%%%%.....
m ..%..........%%%%%%....................%%.........%.............................%.........%.......%%........%............%%......................%%......%...............%%.........%...........%%......
m ..%..........%...%%%%...................%%..................%...................%........%%........%........%...........%%%....................%%.%%%%...%................%.........%%..........%.......
m .............%.......%.......%%...........%%...............%%%%.................%........%.........%.....................%...........................%%%%.................%..........%..........%.......
m ............%%................%............%%............%%...%%%...............%........%........%......................%..............................%.................%%..........%.........%.......
m ............%.................%........................%%.......%%%%............%........%%.......%%.....................%...............................%...............%%%%%.........%.......%........
m ...........%%.................%........................%..........%%...........%%.........%%.......%........%............%%.......%%%%...........................%%%%...%..............%%......%%.......
m ...........%..................%...................................%............%...........%.......%........%%............%.%%%%%%%.............................%%..%%%%..........4.....%%...%%%%%%.....
m ...%.......%..................%...................................%%...........%...........%........%........%%...........%%%%%.................................%%......................%%........%%%...
m ..%........%..................%%..................................%%...........%...........%........%.........%%..........%%%...................................%......................%%............%%%
m %%.........%%...................%.....................%............%%..........%...........%........%%.........%%.........%%%%.............%%%%.................%......................%...............%
m ............%....%%%%%...........%%..........%%.......%%............%.........%%...........%.........%..........%%%.........%%%..........%%...%%%.....%%........%.....................%.................
m ............%%%%%%%...%%..........%%%%......%%.........%%...........%%.......%%...........%%.........%%..........%%%.........%%%................%%%.%%%.........%....................%%.................
m ............%..........%.............%%%....%...........%............%.......%...........%%..........%%...........%%%%.........%%.................%%%..........%%......%........%%%%%%..................
m ............%..........%...............%%%%%.............%...........%%.....%...........%%.........%%%%%...........%%%..........%%.................%.........%%%%.....%%.......%%....%..................
m ............%..........%%.................%%.............%%%..........%%...............%%..............%%...........%%...........%%................%........%%.......%%.......%......%%.................
m ............%...........%.................%%.............%............%%...............%................%%...........%%...........%%%..%...........%........%.......%%................%........%%%%.....
m %..........%%...........%%................%.............%%............%................%.................%..........%%%%...........%%%%............%........%.......%%.................%......%%..%%%%%%
m %..........%%%%...........%%..............%.............%%............%................%............................%%%%%..........................%........%.......%%.......................%%.......%%
m %..........%..%%%...........%%...........%%.............%%...........%%................%%%..........................%...%%.......................%%%%...............%%.......................%..........
m %..........%.....%%%.........%%%.........%.........%.....%...........%................%..%%%.......................%.....%%....................%%%..%%..............%%..................................
m %..........%.......%....................%%........%%.....%%..........%...............%.....%%%.....................%......%......%...........%%%.....%%.............%%%................................%
m %.........%%............................%.........%.......%..........%..............%........%%%..................%..............%..........%%........%%............%.%%%%%............................%
m ..........%%............................%.........%.......%..........%.............%..............................%..............%..........%..........%%%%........%......%%%%.........................%
m %.........%.............................%.........%.......%%........%............%%......................%%......%...............%%.........%...........%%........%..........%%%%%%....................%
m %%..................%...................%........%%........%........%...........%%%....................%%.%%%%...%................%.........%%..........%.........%..........%...%%%%...................
m ..%%...............%%%%.................%........%.........%.....................%...........................%%%%.................%..........%..........%....................%.......%.......%%.........
m ...%%............%%...%%%...............%........%........%......................%..............................%.................%%..........%.........%...................%%................%.........
m ...............%%.......%%%%............%........%%.......%%.....................%...............................%...............%%%%%.........%.......%....................%.................%.........
m ...............%..........%%...........%%.........%%.......%........%............%%.......%%%%...........................%%%%...%..............%%......%%..................%%.................%.........
m ..........................%............%...........%.......%........%%............%.%%%%%%%.............................%%..%%%%..........3.....%%...%%%%%%................%..................%.........
m ..........................%%...........%...........%........%........%%...........%%%%%.................................%%......................%%........%%%......%.......%..................%.........
m ..........................%%...........%...........%........%.........%%..........%%%...................................%......................%%............%%%..%........%..................%%........
m ..............%............%%..........%...........%........%%.........%%.........%%%%.............%%%%.................%......................%...............%%%.........%%...................%.......
m .....%%.......%%............%.........%%...........%.........%..........%%%.........%%%..........%%...%%%.....%%........%.....................%.............................%....%%%%%...........%%.....
m ....%%.........%%...........%%.......%%...........%%.........%%..........%%%.........%%%................%%%.%%%.........%....................%%.............................%%%%%%%...%%..........%%%%..
