# map type: cell maze
# random seed: 624232883
# players 2
# area 6054, 3027 (55.0^2) per player
# cell width: 1.31837814817
# cell size: 13.5432036408
# openness: 0.0176862418981
# maze type growing
# horz_mirror
# final parameters
# area: 5964
# grid size: (1, 2)
# tile size: (42, 71) 1.69047619048
# map size: (42, 142) 3.38095238095
# hill distance   1, 42   1, 99   2,123   2, 18
#         1, 42       0      59      90      47 
#         1, 99      59       0      47      90 
#         2,123      90      47       0      67 
#         2, 18      47      90      67       0 
players 2
rows 42
cols 142
m .......%%%....................%......................%..................................%......................%....................%%%.......
m ........%%....................%%..........1..........%%................................%%..........0..........%%....................%%........
m .........%%.......0............%%............................................................................%%............1.......%%.........
m ..........%%....................%%..........................................................................%%....................%%..........
m ...........%.....................%..........................................................................%.....................%...........
m ...........%%....................%%........................................................................%%....................%%...........
m ............%%....................%%......................................................................%%....................%%............
m .............%%....................%%........................%%%%%%%%%%%%%%%%%%%%........................%%....................%%.............
m ..............%.....................%%.......................%%%%%%%%%..%%%%%%%%%.......................%%.....................%..............
m ..............%%.....................%..................................................................%.....................%%..............
m ...............%%....................%%................................................................%%....................%%...............
m ................%%....................%%%%..........................................................%%%%....................%%................
m ................%%%....................%%%..........................................................%%%....................%%%................
m .................%..........................................................................................................%.................
m .................%..........................................................................................................%.................
m ..............................................................................................................................................
m ..............................................................................................................................................
m ..............................................................................................................................................
m .................%..........................................................................................................%.................
m ............%%%%%%%%%%..................................................................................................%%%%%%%%%%............
m %%%%%%%%%%%%%%%%%..%%%%%%..............................%%............................%%..............................%%%%%%..%%%%%%%%%%%%%%%%%
m %%%%%..................%%%%%%....................%%.....%%..........................%%.....%%....................%%%%%%..................%%%%%
m ...........................%%%%%.................%.......%%........................%%.......%.................%%%%%...........................
m ..............................%.................%%........%%......................%%........%%.................%..............................
m ................................................%..........%%....................%%..........%................................................
m ...............................................%%...........%%..................%%...........%%...............................................
m ..............................................%%.............%%................%%.............%%..............................................
m ..............................................%...............%%..............%%...............%..............................................
m .............................................%%................%%%%%%%..%%%%%%%................%%.............................................
m .............................................%................%%%%%%%%%%%%%%%%%%................%.............................................
m ............................................%%................%%..............%%................%%............................................
m ...........................................%%................%%................%%................%%...........................................
m .....................................%%%%%%%%...............%%..................%%...............%%%%%%%%.....................................
m ...................................%%%%%%%%%%..............%%....................%%..............%%%%%%%%%%...................................
m ..................................%%........%%%...........%%......................%%...........%%%........%%..................................
m ................%%...............%%...........%%.........%%........................%%.........%%...........%%...............%%................
m ..............%%%%%%.............%.............%%.......%%..........................%%.......%%.............%.............%%%%%%..............
m .............%%....%%%%.........%...............%%.....%%............................%%.....%%...............%.........%%%%....%%.............
m ...........%%%........%%%%.....%%................%%%..%%..............................%%..%%%................%%.....%%%%........%%%...........
m .........%%%............%%%%%%%%...................%%%%%..............................%%%%%...................%%%%%%%%............%%%.........
m %%%%%...%%%................%%%%.....................%%%................................%%%.....................%%%%................%%%...%%%%%
m %%%%%%%%%....................%%......................%..................................%......................%%....................%%%%%%%%%
