# random seed -8125195904899587178
# players 6
# area 6000, 1000 (31.6^2) per player
# cell width: 2.5887608576
# cell size: 8
# openness: 0.02
# grid size: (2, 3)
# tile size: (24, 40) 1.66666666667
# map size: (48, 120) 10.0
# vert shear step: 1
# vert_shear
# horz_copy
# maze type recursive backtracker
# final openness 0.02
# map_type cell_maze
# random_seed -8125195904899587178
players 6
rows 48
cols 120
m .....%%%%%%%%%%%%%%%%%..........%%%..........%%%%%%%%%%%%%%%%%..........%%%..........%%%%%%%%%%%%%%%%%..........%%%.....
m ......%%%%%%%.....%%%%%%.........%%%..........%%%%%%%.....%%%%%%.........%%%..........%%%%%%%.....%%%%%%.........%%%....
m ......%%%%%%........%%%%%........%%%..........%%%%%%........%%%%%........%%%..........%%%%%%........%%%%%........%%%....
m ....%%%%%%............%%%%.......%%%........%%%%%%............%%%%.......%%%........%%%%%%............%%%%.......%%%....
m ...%%%%%%..............%%%%......%%%.......%%%%%%..............%%%%......%%%.......%%%%%%..............%%%%......%%%....
m .%%%%%%%................%%%......%%%.....%%%%%%%................%%%......%%%.....%%%%%%%................%%%......%%%....
m ....%%%.................%%%......%%%%.......%%%.................%%%......%%%%.......%%%.................%%%......%%%%...
m .........................%%%.....%%%%%...........................%%%.....%%%%%...........................%%%.....%%%%%..
m .........................%%%%.....%%%%...........................%%%%.....%%%%...........................%%%%.....%%%%..
m .........................%%%%%......%............................%%%%%......%............................%%%%%......%...
m ..........................%%%%....................................%%%%....................................%%%%..........
m ........................................................................................................................
m ........................................................................................................................
m ................%%......................................%%......................................%%......................
m ................%%%.....................................%%%.....................................%%%.....................
m ....%%.........%%%%%........................%%.........%%%%%........................%%.........%%%%%....................
m ..%%%%%%%.....%%%%%.......................%%%%%%%.....%%%%%.......................%%%%%%%.....%%%%%.....................
m %%%%%%%%%%%%%%%%%......................%%%%%%%%%%%%%%%%%%......................%%%%%%%%%%%%%%%%%%......................%
m %%%%...%%%%%%%%.......................%%%%%%...%%%%%%%%.......................%%%%%%...%%%%%%%%.......................%%
m %%........%%%%.......................%%%%%........%%%%.......................%%%%%........%%%%.......................%%%
m ...........%%%.......%%%............%%%%...........%%%.......%%%............%%%%...........%%%.......%%%............%%%%
m ...........%%%........%%%...........%%%............%%%........%%%...........%%%............%%%........%%%...........%%%.
m ...........%%%%........%%%%%.....%%%%%%%...........%%%%........%%%%%.....%%%%%%%...........%%%%........%%%%%.....%%%%%%%
m %...........%%%...5.....%%%%%%%%%%%%%%%%%...........%%%...2.....%%%%%%%%%%%%%%%%%...........%%%...0.....%%%%%%%%%%%%%%%%
m %%..........%%%..........%%%%%%%%%%%%%%%%%..........%%%..........%%%%%%%%%%%%%%%%%..........%%%..........%%%%%%%%%%%%%%%
m %%%%.........%%%..........%%%%%%%.....%%%%%%.........%%%..........%%%%%%%.....%%%%%%.........%%%..........%%%%%%%.....%%
m %%%%%........%%%..........%%%%%%........%%%%%........%%%..........%%%%%%........%%%%%........%%%..........%%%%%%........
m ..%%%%.......%%%........%%%%%%............%%%%.......%%%........%%%%%%............%%%%.......%%%........%%%%%%..........
m ...%%%%......%%%.......%%%%%%..............%%%%......%%%.......%%%%%%..............%%%%......%%%.......%%%%%%...........
m ....%%%......%%%.....%%%%%%%................%%%......%%%.....%%%%%%%................%%%......%%%.....%%%%%%%............
m ....%%%......%%%%.......%%%.................%%%......%%%%.......%%%.................%%%......%%%%.......%%%.............
m .....%%%.....%%%%%...........................%%%.....%%%%%...........................%%%.....%%%%%......................
m .....%%%%.....%%%%...........................%%%%.....%%%%...........................%%%%.....%%%%......................
m .....%%%%%......%............................%%%%%......%............................%%%%%......%.......................
m ......%%%%....................................%%%%....................................%%%%..............................
m ........................................................................................................................
m ........................................................................................................................
m ....................................%%......................................%%......................................%%..
m ....................................%%%.....................................%%%.....................................%%%.
m ........................%%.........%%%%%........................%%.........%%%%%........................%%.........%%%%%
m ......................%%%%%%%.....%%%%%.......................%%%%%%%.....%%%%%.......................%%%%%%%.....%%%%%.
m ...................%%%%%%%%%%%%%%%%%%......................%%%%%%%%%%%%%%%%%%......................%%%%%%%%%%%%%%%%%%...
m ..................%%%%%%...%%%%%%%%.......................%%%%%%...%%%%%%%%.......................%%%%%%...%%%%%%%%.....
m .................%%%%%........%%%%.......................%%%%%........%%%%.......................%%%%%........%%%%......
m .%%%............%%%%...........%%%.......%%%............%%%%...........%%%.......%%%............%%%%...........%%%......
m ..%%%...........%%%............%%%........%%%...........%%%............%%%........%%%...........%%%............%%%......
m ...%%%%%.....%%%%%%%...........%%%%........%%%%%.....%%%%%%%...........%%%%........%%%%%.....%%%%%%%...........%%%%.....
m ....%%%%%%%%%%%%%%%%%...........%%%...1.....%%%%%%%%%%%%%%%%%...........%%%...3.....%%%%%%%%%%%%%%%%%...........%%%...4.
