# map type: cell maze
# random seed: -590533506
# players 8
# area 15031, 1878 (43.3^2) per player
# cell width: 1.12927813916
# cell size: 7.31466327486
# openness: 0.523953580398
# maze type prims
# horz shear step: 4
# horz_shear
# final parameters
# area: 14336
# grid size: (1, 8)
# tile size: (128, 14) 0.109375
# map size: (128, 112) 0.875
# hill distance  94, 91  95, 75  25, 11  11, 75 108, 27  24, 27  81, 11  67, 75  80, 27  10, 91  53, 11  38, 91  39, 75  66, 91  52, 27 109, 11
#        94, 91       0      27      91      45      78     106      65      43      78      28      93      56      71      28     106      63 
#        95, 75      27       0     106      48      65      93      78      48      63      43     106      71      80      45      91      78 
#        25, 11      91     106       0      78      45      27      80     106      71      63      48      65      78      93      43      48 
#        11, 75      45      48      78       0      63      65     106      80      91      27     106      43      48      71      93      78 
#       108, 27      78      65      45      63       0      28      43      93      28      78      71     106      91     106      56      27 
#        24, 27     106      93      27      65      28       0      71      91      56      78      45      78      63     106      28      43 
#        81, 11      65      78      80     106      43      71       0      78      27      93      48      91     106      63      45      48 
#        67, 75      43      48     106      80      93      91      78       0      65      71      78      45      48      27      63     106 
#        80, 27      78      63      71      91      28      56      27      65       0     106      43     106      93      78      28      45 
#        10, 91      28      43      63      27      78      78      93      71     106       0      91      28      45      56     106      65 
#        53, 11      93     106      48     106      71      45      48      78      43      91       0      63      78      65      27      80 
#        38, 91      56      71      65      43     106      78      91      45     106      28      63       0      27      28      78      93 
#        39, 75      71      80      78      48      91      63     106      48      93      45      78      27       0      43      65     106 
#        66, 91      28      45      93      71     106     106      63      27      78      56      65      28      43       0      78      91 
#        52, 27     106      91      43      93      56      28      45      63      28     106      27      78      65      78       0      71 
#       109, 11      63      78      48      78      27      43      48     106      45      65      80      93     106      91      71       0 
players 8
rows 112
cols 128
m ......%%%%%%%%%%%...%%.........%..................................%%.%%%...............................%%%........%%%......%%...
m .....%%.........%...%.........%%...................%.............%%....%%%%.................................................%...
m .....%.............................................%............%%........%.................................................%%..
m .....%%..................................%.........%%......%%%%%%.........%.....................................................
m ......%...................................%..........%%.......%%..........%.....................................................
m .........................%.................%...........%.......%..........%%........%........%........%%%.......................
m ........................%%.........%........%..................%%..........%%.......%%........%.....%%%..........%%.............
m .............%%.........%..........%.........%%.................%............%%.......%%.......%.%%%............%%..........%...
m ..............%.........%..........%.........%%.................%..............%.......%........%%.............%%.........%%....
m ..............%.........%..........%.........%%........................................%.....................%%%........%%%.....
m ..............%%........%..........%.........%%.......................%................%...2...............%%%%..........%......
m ...%...........%%%%%%............%%%........%%%.......................%....0..........%%...................%....................
m ...%................%..........%%%.........%%.........%%%%............%...............%.........%.........%.....................
m ...%%%.......................%%%.........%%.........%%%..%%%..........%%%%%%%%%%.....%%.........%.........%.....................
m ..%%.%%%...............................%%%........%%%......%%.........%%%%%%%%%%%...%%.........%................................
m .%%....%%%%.................................................%........%%.........%...%.........%%...................%............
m %%........%.................................................%%.......%.............................................%............
m %.........%..........................................................%%..................................%.........%%......%%%%%
m ..........%...........................................................%...................................%..........%%.......%%
m ..........%%........%........%........%%%................................................%.................%...........%.......%
m %..........%%.......%%........%.....%%%..........%%.....................................%%.........%........%..................%
m %............%%.......%%.......%.%%%............%%..........%................%%.........%..........%.........%%.................
m %..............%.......%........%%.............%%.........%%..................%.........%..........%.........%%.................
m .......................%.....................%%%........%%%...................%.........%..........%.........%%.................
m ......%................%...3...............%%%%..........%....................%%........%..........%.........%%.................
m ......%....1..........%%...................%.......................%...........%%%%%%............%%%........%%%.................
m ......%...............%.........%.........%........................%................%..........%%%.........%%.........%%%%......
m ......%%%%%%%%%%.....%%.........%.........%........................%%%.......................%%%.........%%.........%%%..%%%....
m ......%%%%%%%%%%%...%%.........%..................................%%.%%%...............................%%%........%%%......%%...
m .....%%.........%...%.........%%...................%.............%%....%%%%.................................................%...
m .....%.............................................%............%%........%.................................................%%..
m .....%%..................................%.........%%......%%%%%%.........%.....................................................
m ......%...................................%..........%%.......%%..........%.....................................................
m .........................%.................%...........%.......%..........%%........%........%........%%%.......................
m ........................%%.........%........%..................%%..........%%.......%%........%.....%%%..........%%.............
m .............%%.........%..........%.........%%.................%............%%.......%%.......%.%%%............%%..........%...
m ..............%.........%..........%.........%%.................%..............%.......%........%%.............%%.........%%....
m ..............%.........%..........%.........%%........................................%.....................%%%........%%%.....
m ..............%%........%..........%.........%%.......................%................%...4...............%%%%..........%......
m ...%...........%%%%%%............%%%........%%%.......................%....2..........%%...................%....................
m ...%................%..........%%%.........%%.........%%%%............%...............%.........%.........%.....................
m ...%%%.......................%%%.........%%.........%%%..%%%..........%%%%%%%%%%.....%%.........%.........%.....................
m ..%%.%%%...............................%%%........%%%......%%.........%%%%%%%%%%%...%%.........%................................
m .%%....%%%%.................................................%........%%.........%...%.........%%...................%............
m %%........%.................................................%%.......%.............................................%............
m %.........%..........................................................%%..................................%.........%%......%%%%%
m ..........%...........................................................%...................................%..........%%.......%%
m ..........%%........%........%........%%%................................................%.................%...........%.......%
m %..........%%.......%%........%.....%%%..........%%.....................................%%.........%........%..................%
m %............%%.......%%.......%.%%%............%%..........%................%%.........%..........%.........%%.................
m %..............%.......%........%%.............%%.........%%..................%.........%..........%.........%%.................
m .......................%.....................%%%........%%%...................%.........%..........%.........%%.................
m ......%................%...5...............%%%%..........%....................%%........%..........%.........%%.................
m ......%....3..........%%...................%.......................%...........%%%%%%............%%%........%%%.................
m ......%...............%.........%.........%........................%................%..........%%%.........%%.........%%%%......
m ......%%%%%%%%%%.....%%.........%.........%........................%%%.......................%%%.........%%.........%%%..%%%....
m ......%%%%%%%%%%%...%%.........%..................................%%.%%%...............................%%%........%%%......%%...
m .....%%.........%...%.........%%...................%.............%%....%%%%.................................................%...
m .....%.............................................%............%%........%.................................................%%..
m .....%%..................................%.........%%......%%%%%%.........%.....................................................
m ......%...................................%..........%%.......%%..........%.....................................................
m .........................%.................%...........%.......%..........%%........%........%........%%%.......................
m ........................%%.........%........%..................%%..........%%.......%%........%.....%%%..........%%.............
m .............%%.........%..........%.........%%.................%............%%.......%%.......%.%%%............%%..........%...
m ..............%.........%..........%.........%%.................%..............%.......%........%%.............%%.........%%....
m ..............%.........%..........%.........%%........................................%.....................%%%........%%%.....
m ..............%%........%..........%.........%%.......................%................%...6...............%%%%..........%......
m ...%...........%%%%%%............%%%........%%%.......................%....4..........%%...................%....................
m ...%................%..........%%%.........%%.........%%%%............%...............%.........%.........%.....................
m ...%%%.......................%%%.........%%.........%%%..%%%..........%%%%%%%%%%.....%%.........%.........%.....................
m ..%%.%%%...............................%%%........%%%......%%.........%%%%%%%%%%%...%%.........%................................
m .%%....%%%%.................................................%........%%.........%...%.........%%...................%............
m %%........%.................................................%%.......%.............................................%............
m %.........%..........................................................%%..................................%.........%%......%%%%%
m ..........%...........................................................%...................................%..........%%.......%%
m ..........%%........%........%........%%%................................................%.................%...........%.......%
m %..........%%.......%%........%.....%%%..........%%.....................................%%.........%........%..................%
m %............%%.......%%.......%.%%%............%%..........%................%%.........%..........%.........%%.................
m %..............%.......%........%%.............%%.........%%..................%.........%..........%.........%%.................
m .......................%.....................%%%........%%%...................%.........%..........%.........%%.................
m ......%................%...7...............%%%%..........%....................%%........%..........%.........%%.................
m ......%....5..........%%...................%.......................%...........%%%%%%............%%%........%%%.................
m ......%...............%.........%.........%........................%................%..........%%%.........%%.........%%%%......
m ......%%%%%%%%%%.....%%.........%.........%........................%%%.......................%%%.........%%.........%%%..%%%....
m ......%%%%%%%%%%%...%%.........%..................................%%.%%%...............................%%%........%%%......%%...
m .....%%.........%...%.........%%...................%.............%%....%%%%.................................................%...
m .....%.............................................%............%%........%.................................................%%..
m .....%%..................................%.........%%......%%%%%%.........%.....................................................
m ......%...................................%..........%%.......%%..........%.....................................................
m .........................%.................%...........%.......%..........%%........%........%........%%%.......................
m ........................%%.........%........%..................%%..........%%.......%%........%.....%%%..........%%.............
m .............%%.........%..........%.........%%.................%............%%.......%%.......%.%%%............%%..........%...
m ..............%.........%..........%.........%%.................%..............%.......%........%%.............%%.........%%....
m ..............%.........%..........%.........%%........................................%.....................%%%........%%%.....
m ..............%%........%..........%.........%%.......................%................%...0...............%%%%..........%......
m ...%...........%%%%%%............%%%........%%%.......................%....6..........%%...................%....................
m ...%................%..........%%%.........%%.........%%%%............%...............%.........%.........%.....................
m ...%%%.......................%%%.........%%.........%%%..%%%..........%%%%%%%%%%.....%%.........%.........%.....................
m ..%%.%%%...............................%%%........%%%......%%.........%%%%%%%%%%%...%%.........%................................
m .%%....%%%%.................................................%........%%.........%...%.........%%...................%............
m %%........%.................................................%%.......%.............................................%............
m %.........%..........................................................%%..................................%.........%%......%%%%%
m ..........%...........................................................%...................................%..........%%.......%%
m ..........%%........%........%........%%%................................................%.................%...........%.......%
m %..........%%.......%%........%.....%%%..........%%.....................................%%.........%........%..................%
m %............%%.......%%.......%.%%%............%%..........%................%%.........%..........%.........%%.................
m %..............%.......%........%%.............%%.........%%..................%.........%..........%.........%%.................
m .......................%.....................%%%........%%%...................%.........%..........%.........%%.................
m ......%................%...1...............%%%%..........%....................%%........%..........%.........%%.................
m ......%....7..........%%...................%.......................%...........%%%%%%............%%%........%%%.................
m ......%...............%.........%.........%........................%................%..........%%%.........%%.........%%%%......
m ......%%%%%%%%%%.....%%.........%.........%........................%%%.......................%%%.........%%.........%%%..%%%....
