# map type: cell maze
# random seed: -1927842577
# players 5
# area 21473, 4294 (65.5^2) per player
# cell width: 1.02974436588
# cell size: 7.84331999061
# openness: 0.160364291277
# maze type prims
# horz shear step: 3
# horz_shear
# final parameters
# area: 21000
# grid size: (1, 5)
# tile size: (105, 40) 0.380952380952
# map size: (105, 200) 1.90476190476
# hill distance  88, 14  25,174   4, 94  67,134  46, 54
#        88, 14       0     137     139     139     137 
#        25,174     137       0     139     137     139 
#         4, 94     139     139       0     137     137 
#        67,134     139     137     137       0     139 
#        46, 54     137     139     137     139       0 
players 5
rows 105
cols 200
m ...................%%...............................%.....................%......%................%%.......%..................%%%%....................%..............................%%%%%..............
m ....................%%%%%%%.............%%..........%............................%................%%......%%.....................%%..................%%........................%%%%%%%..................
m ..........................%............%%..........%.............................%%...............%........%......................%%.................%........................%%%%...................%..
m ......................................%............%..............................%...............%........%%%......%%%%...........%%.......%........%.....................%%%%......................%..
m ..........%...........................%............%%.............................%%..........2...%..........%%%%%.%....%%%%........%%......%%%.....%%................%%%%%%.........................%..
m .........%%.....%....................%..............%...........%%%%%%%%%..........%..............%..............%%........%.........%%.......%%%%..%................%.....................%%........%..
m .........%.......%..........%%.....%%%...............%.........%...................%%.............%...............%........%..........%%.........%%%%................%....................%%.........%..
m ........%........%............%%%%%%.%%...............%%......%%...................%%%%%%.........%...............%.........%.........%%%..........%%...............%.....................%..........%..
m .....%%%%.........%............%%.....%.................%.....%....................%.....%.......%%................%........%........%%.............%........%%%%%%%%..........%%........%...........%..
m %%%%%%.%%.........%............%.......%.................%%%%%....................%.......%%.......%...............%................%%......................%%......%%.........%%.......%%............%%
m %.......%%.........%...........%.......%%.................%%..................%%%%..................%%.............%...............%%......................%.........%........%%.......%%.............%%
m .........%.........%%.........%%........%..................................%%%.......................%%%%..........%%.............%%.......................%.........%.......%%......%%%..............%.
m .........%%........%..........%..........%................................%%..........................%...........%...........%%.%%.......................%%.........%%.....%%.......%...............%%.
m ..........%........%..........%..........%%%%............................%%..........................%%..........%..........%%.%%%........................%...........%....%%........%...............%..
m ..........%%.......%..........%...........%.%%%.........................%%..........................%%.........%%..........%%.............................%...........%%..%%........%%..............%...
m ...........%%.%%%%%%.........%%...............%%%.....................%%%...........................%........%%...........................................%...........%%%%%.........%...................
m ...........%%%%.....%........%..................%%%................%%%%.....................%......%..........................................%..........%..........%%....%.........%........%%.........
m .....................%.......%....................%%%......................................%%%%%%%%%..........................................%..........%.........%......%%........%........%..........
m .............................%%........%%...........%%.............................%%.....%%......%%...........................................%%%%%%%%%%%.................%.......%%.......%%..........
m ..............................%%%%...%%%............................................%%%%.%%........%.....................................................%.................%%......%........%...........
m .......%%%....................%%..%%%%...........................%.....................%%%.........%................................%.....................%.................%%%%%%%%.......%%...........
m ......%%%%....................%..............................%%%%%.................................%%...............................%.....................%......%................%%.......%............
m .........%%..................%%........................%%%%%%%......................................%%%%%%%.............%%..........%............................%................%%......%%............
m ..........%%.................%........................%%%%...................%............................%............%%..........%.............................%%...............%........%............
m ...........%%.......%........%.....................%%%%......................%........................................%............%..............................%...............%........%%%......%%%%
m %%%%........%%......%%%.....%%................%%%%%%.........................%............%...........................%............%%.............................%%..........4...%..........%%%%%.%....
m ...%.........%%.......%%%%..%................%.....................%%........%...........%%.....%....................%..............%...........%%%%%%%%%..........%..............%..............%%.....
m ...%..........%%.........%%%%................%....................%%.........%...........%.......%..........%%.....%%%...............%.........%...................%%.............%...............%.....
m ....%.........%%%..........%%...............%.....................%..........%..........%........%............%%%%%%.%%...............%%......%%...................%%%%%%.........%...............%.....
m ....%........%%.............%........%%%%%%%%..........%%........%...........%.......%%%%.........%............%%.....%.................%.....%....................%.....%.......%%................%....
m ............%%......................%%......%%.........%%.......%%............%%%%%%%%.%%.........%............%.......%.................%%%%%....................%.......%%.......%...............%....
m ...........%%......................%.........%........%%.......%%.............%%%.......%%.........%...........%.......%%.................%%..................%%%%..................%%.............%....
m ..........%%.......................%.........%.......%%......%%%..............%..........%.........%%.........%%........%..................................%%%.......................%%%%..........%%...
m ......%%.%%.......................%%.........%%.....%%.......%...............%%..........%%........%..........%..........%................................%%..........................%...........%.....
m ....%%.%%%........................%...........%....%%........%...............%............%........%..........%..........%%%%............................%%..........................%%..........%......
m ...%%.............................%...........%%..%%........%%..............%.............%%.......%..........%...........%.%%%.........................%%..........................%%.........%%.......
m ..................................%...........%%%%%.........%..............................%%.%%%%%%.........%%...............%%%.....................%%%...........................%........%%.........
m ......................%..........%..........%%....%.........%........%%....................%%%%.....%........%..................%%%................%%%%.....................%......%....................
m ......................%..........%.........%......%%........%........%...............................%.......%....................%%%......................................%%%%%%%%%....................
m .......................%%%%%%%%%%%.................%.......%%.......%%.......................................%%........%%...........%%.............................%%.....%%......%%....................
m .................................%.................%%......%........%.........................................%%%%...%%%............................................%%%%.%%........%....................
m ............%.....................%.................%%%%%%%%.......%%..................%%%....................%%..%%%%...........................%.....................%%%.........%....................
m ............%.....................%......%................%%.......%..................%%%%....................%..............................%%%%%.................................%%...................
m %%..........%............................%................%%......%%.....................%%..................%%........................%%%%%%%......................................%%%%%%%.............
m %..........%.............................%%...............%........%......................%%.................%........................%%%%...................%............................%............%
m ...........%..............................%...............%........%%%......%%%%...........%%.......%........%.....................%%%%......................%........................................%.
m ...........%%.............................%%..........1...%..........%%%%%.%....%%%%........%%......%%%.....%%................%%%%%%.........................%............%...........................%.
m ............%...........%%%%%%%%%..........%..............%..............%%........%.........%%.......%%%%..%................%.....................%%........%...........%%.....%....................%..
m .............%.........%...................%%.............%...............%........%..........%%.........%%%%................%....................%%.........%...........%.......%..........%%.....%%%..
m ..............%%......%%...................%%%%%%.........%...............%.........%.........%%%..........%%...............%.....................%..........%..........%........%............%%%%%%.%%.
m ................%.....%....................%.....%.......%%................%........%........%%.............%........%%%%%%%%..........%%........%...........%.......%%%%.........%............%%.....%.
m .................%%%%%....................%.......%%.......%...............%................%%......................%%......%%.........%%.......%%............%%%%%%%%.%%.........%............%.......%
m %.................%%..................%%%%..................%%.............%...............%%......................%.........%........%%.......%%.............%%%.......%%.........%...........%.......%
m %..................................%%%.......................%%%%..........%%.............%%.......................%.........%.......%%......%%%..............%..........%.........%%.........%%........
m .%................................%%..........................%...........%...........%%.%%.......................%%.........%%.....%%.......%...............%%..........%%........%..........%.........
m .%%%%............................%%..........................%%..........%..........%%.%%%........................%...........%....%%........%...............%............%........%..........%.........
m ..%.%%%.........................%%..........................%%.........%%..........%%.............................%...........%%..%%........%%..............%.............%%.......%..........%.........
m ......%%%.....................%%%...........................%........%%...........................................%...........%%%%%.........%..............................%%.%%%%%%.........%%.........
m ........%%%................%%%%.....................%......%..........................................%..........%..........%%....%.........%........%%....................%%%%.....%........%..........
m ..........%%%......................................%%%%%%%%%..........................................%..........%.........%......%%........%........%...............................%.......%..........
m %...........%%.............................%%.....%%......%%...........................................%%%%%%%%%%%.................%.......%%.......%%.......................................%%........%
m ............................................%%%%.%%........%.....................................................%.................%%......%........%.........................................%%%%...%%%
m .........................%.....................%%%.........%................................%.....................%.................%%%%%%%%.......%%..................%%%....................%%..%%%%..
m .....................%%%%%.................................%%...............................%.....................%......%................%%.......%..................%%%%....................%.........
m ...............%%%%%%%......................................%%%%%%%.............%%..........%............................%................%%......%%.....................%%..................%%.........
m ..............%%%%...................%............................%............%%..........%.............................%%...............%........%......................%%.................%..........
m ...........%%%%......................%........................................%............%..............................%...............%........%%%......%%%%...........%%.......%........%..........
m ......%%%%%%.........................%............%...........................%............%%.............................%%..........3...%..........%%%%%.%....%%%%........%%......%%%.....%%..........
m .....%.....................%%........%...........%%.....%....................%..............%...........%%%%%%%%%..........%..............%..............%%........%.........%%.......%%%%..%...........
m .....%....................%%.........%...........%.......%..........%%.....%%%...............%.........%...................%%.............%...............%........%..........%%.........%%%%...........
m ....%.....................%..........%..........%........%............%%%%%%.%%...............%%......%%...................%%%%%%.........%...............%.........%.........%%%..........%%...........
m %%%%%..........%%........%...........%.......%%%%.........%............%%.....%.................%.....%....................%.....%.......%%................%........%........%%.............%........%%%
m ....%%.........%%.......%%............%%%%%%%%.%%.........%............%.......%.................%%%%%....................%.......%%.......%...............%................%%......................%%..
m .....%........%%.......%%.............%%%.......%%.........%...........%.......%%.................%%..................%%%%..................%%.............%...............%%......................%....
m .....%.......%%......%%%..............%..........%.........%%.........%%........%..................................%%%.......................%%%%..........%%.............%%.......................%....
m .....%%.....%%.......%...............%%..........%%........%..........%..........%................................%%..........................%...........%...........%%.%%.......................%%....
m ......%....%%........%...............%............%........%..........%..........%%%%............................%%..........................%%..........%..........%%.%%%........................%.....
m ......%%..%%........%%..............%.............%%.......%..........%...........%.%%%.........................%%..........................%%.........%%..........%%.............................%.....
m ......%%%%%.........%..............................%%.%%%%%%.........%%...............%%%.....................%%%...........................%........%%...........................................%.....
m ....%%....%.........%........%%....................%%%%.....%........%..................%%%................%%%%.....................%......%..........................................%..........%......
m ...%......%%........%........%...............................%.......%....................%%%......................................%%%%%%%%%..........................................%..........%......
m ...........%.......%%.......%%.......................................%%........%%...........%%.............................%%.....%%......%%...........................................%%%%%%%%%%%......
m ...........%%......%........%.........................................%%%%...%%%............................................%%%%.%%........%.....................................................%......
m ............%%%%%%%%.......%%..................%%%....................%%..%%%%...........................%.....................%%%.........%................................%.....................%.....
m .%................%%.......%..................%%%%....................%..............................%%%%%.................................%%...............................%.....................%.....
m .%................%%......%%.....................%%..................%%........................%%%%%%%......................................%%%%%%%.............%%..........%...........................
m .%%...............%........%......................%%.................%........................%%%%...................%............................%............%%..........%............................
m ..%...............%........%%%......%%%%...........%%.......%........%.....................%%%%......................%........................................%............%............................
m ..%%..........0...%..........%%%%%.%....%%%%........%%......%%%.....%%................%%%%%%.........................%............%...........................%............%%...........................
m ...%..............%..............%%........%.........%%.......%%%%..%................%.....................%%........%...........%%.....%....................%..............%...........%%%%%%%%%.......
m ...%%.............%...............%........%..........%%.........%%%%................%....................%%.........%...........%.......%..........%%.....%%%...............%.........%................
m ...%%%%%%.........%...............%.........%.........%%%..........%%...............%.....................%..........%..........%........%............%%%%%%.%%...............%%......%%................
m ...%.....%.......%%................%........%........%%.............%........%%%%%%%%..........%%........%...........%.......%%%%.........%............%%.....%.................%.....%.................
m ..%.......%%.......%...............%................%%......................%%......%%.........%%.......%%............%%%%%%%%.%%.........%............%.......%.................%%%%%..................
m %%..................%%.............%...............%%......................%.........%........%%.......%%.............%%%.......%%.........%...........%.......%%.................%%..................%%
m .....................%%%%..........%%.............%%.......................%.........%.......%%......%%%..............%..........%.........%%.........%%........%..................................%%%..
m ......................%...........%...........%%.%%.......................%%.........%%.....%%.......%...............%%..........%%........%..........%..........%................................%%....
m .....................%%..........%..........%%.%%%........................%...........%....%%........%...............%............%........%..........%..........%%%%............................%%.....
m ....................%%.........%%..........%%.............................%...........%%..%%........%%..............%.............%%.......%..........%...........%.%%%.........................%%......
m ....................%........%%...........................................%...........%%%%%.........%..............................%%.%%%%%%.........%%...............%%%.....................%%%.......
m ............%......%..........................................%..........%..........%%....%.........%........%%....................%%%%.....%........%..................%%%................%%%%.........
m ...........%%%%%%%%%..........................................%..........%.........%......%%........%........%...............................%.......%....................%%%...........................
m ...%%.....%%......%%...........................................%%%%%%%%%%%.................%.......%%.......%%.......................................%%........%%...........%%..........................
m ....%%%%.%%........%.....................................................%.................%%......%........%.........................................%%%%...%%%........................................
m .......%%%.........%................................%.....................%.................%%%%%%%%.......%%..................%%%....................%%..%%%%...........................%..............
