# map type: cell maze
# random seed: 200524943
# players 6
# area 12352, 2058 (45.4^2) per player
# cell width: 2.79657350323
# cell size: 9.11996859427
# openness: 0.414094437785
# maze type growing
# horz_rotate
# horz_copy
# final parameters
# area: 11664
# grid size: (1, 6)
# tile size: (72, 27) 0.375
# map size: (72, 162) 2.25
# hill distance  26,120  26, 66  45, 41  45, 95  45,149  26, 12
#        26,120       0      88     106      76      52      88 
#        26, 66      88       0      76      52     106      88 
#        45, 41     106      76       0      88      88      52 
#        45, 95      76      52      88       0      88     106 
#        45,149      52     106      88      88       0      76 
#        26, 12      88      88      52     106      76       0 
players 6
rows 72
cols 162
m ......%%%%...%%%%.....................%%%....%%%%...........%%%%...%%%%.....................%%%....%%%%...........%%%%...%%%%.....................%%%....%%%%.....
m ......%%%%....%%%%....................%%%.....%%%%..........%%%%....%%%%....................%%%.....%%%%..........%%%%....%%%%....................%%%.....%%%%....
m ......%%%......%%%%...................%%%......%%%%.........%%%......%%%%...................%%%......%%%%.........%%%......%%%%...................%%%......%%%%...
m .....%%%%.......%%%%..................%%........%%%%.......%%%%.......%%%%..................%%........%%%%.......%%%%.......%%%%..................%%........%%%%..
m .....%%%.........%%%%%%%%............%%%........%%%%.......%%%.........%%%%%%%%............%%%........%%%%.......%%%.........%%%%%%%%............%%%........%%%%..
m ....%%%%.........%%%%%%%%%...........%%%.........%%%......%%%%.........%%%%%%%%%...........%%%.........%%%......%%%%.........%%%%%%%%%...........%%%.........%%%..
m ....%%%...........%%%%%%%%%..........%%%..................%%%...........%%%%%%%%%..........%%%..................%%%...........%%%%%%%%%..........%%%..............
m ....%%%................%%%%.........%%%%..................%%%................%%%%.........%%%%..................%%%................%%%%.........%%%%..............
m ....%%%..................%%%........%%%%%%%...............%%%..................%%%........%%%%%%%...............%%%..................%%%........%%%%%%%...........
m .....%%%.................%%%........%%%%%%%%%%%%...........%%%.................%%%........%%%%%%%%%%%%...........%%%.................%%%........%%%%%%%%%%%%......
m .....%%%%.................%%........%%%%%%%%%%%%%..........%%%%.................%%........%%%%%%%%%%%%%..........%%%%.................%%........%%%%%%%%%%%%%.....
m .....%%%%%%..................................%%%%%.........%%%%%%..................................%%%%%.........%%%%%%..................................%%%%%....
m .......%%%%%...................................%%%...........%%%%%...................................%%%...........%%%%%...................................%%%....
m .........%%%...................................%%%%............%%%...................................%%%%............%%%...................................%%%%...
m ..........%%%...................................%%%%............%%%...................................%%%%............%%%...................................%%%%..
m ..........%%%............%.......................%%.............%%%............%.......................%%.............%%%............%.......................%%...
m ..........%%%...........%%%...........%.........................%%%...........%%%...........%.........................%%%...........%%%...........%...............
m ...........%%%..........%%%.........%%%%.........................%%%..........%%%.........%%%%.........................%%%..........%%%.........%%%%..............
m ..........%%%%%%........%%%%.......%%%%%........................%%%%%%........%%%%.......%%%%%........................%%%%%%........%%%%.......%%%%%..............
m .........%%%%%%%%%.......%%%%....%%%%%%........................%%%%%%%%%.......%%%%....%%%%%%........................%%%%%%%%%.......%%%%....%%%%%%...............
m ........%%%%%%%%%%........%%%%%%%%%%%.........................%%%%%%%%%%........%%%%%%%%%%%.........................%%%%%%%%%%........%%%%%%%%%%%.................
m .......%%%%....%%..........%%%%%%%%%.........................%%%%....%%..........%%%%%%%%%.........................%%%%....%%..........%%%%%%%%%..................
m ......%%%%..................%%%%%%..........................%%%%..................%%%%%%..........................%%%%..................%%%%%%....................
m ....%%%%%...................%%%%%.........................%%%%%...................%%%%%.........................%%%%%...................%%%%%.....................
m .....%%%.....................%%%...........................%%%.....................%%%...........................%%%.....................%%%......................
m .....%%%.....................%%%..............%............%%%.....................%%%..............%............%%%.....................%%%..............%.......
m .....%%%%...0....%...........%%%...........................%%%%...2....%...........%%%...........................%%%%...3....%...........%%%......................
m ......%%%.......%%%..........%%%............................%%%.......%%%..........%%%............................%%%.......%%%..........%%%......................
m ......%%%......%%%%..........%%%%...........................%%%......%%%%..........%%%%...........................%%%......%%%%..........%%%%.....................
m ......%%%%....%%%%%..........%%%%%%%%.......................%%%%....%%%%%..........%%%%%%%%.......................%%%%....%%%%%..........%%%%%%%%.................
m .......%%%%%%%%%%............%%%%%%%%%%%%....................%%%%%%%%%%............%%%%%%%%%%%%....................%%%%%%%%%%............%%%%%%%%%%%%.............
m .......%%%%%%%%%..............%%%%%%%%%%%....................%%%%%%%%%..............%%%%%%%%%%%....................%%%%%%%%%..............%%%%%%%%%%%.............
m .........%%%%%%......................%%%.......................%%%%%%......................%%%.......................%%%%%%......................%%%..............
m ............%%....................................................%%....................................................%%........................................
m ..................................................................................................................................................................
m ..................................................................................................................................................................
m ..................................................................................................................................................................
m ..................................................................................................................................................................
m ........................................%%....................................................%%....................................................%%............
m ..............%%%......................%%%%%%.......................%%%......................%%%%%%.......................%%%......................%%%%%%.........
m .............%%%%%%%%%%%..............%%%%%%%%%....................%%%%%%%%%%%..............%%%%%%%%%....................%%%%%%%%%%%..............%%%%%%%%%.......
m .............%%%%%%%%%%%%............%%%%%%%%%%....................%%%%%%%%%%%%............%%%%%%%%%%....................%%%%%%%%%%%%............%%%%%%%%%%.......
m .................%%%%%%%%..........%%%%%....%%%%.......................%%%%%%%%..........%%%%%....%%%%.......................%%%%%%%%..........%%%%%....%%%%......
m .....................%%%%..........%%%%......%%%...........................%%%%..........%%%%......%%%...........................%%%%..........%%%%......%%%......
m ......................%%%..........%%%.......%%%............................%%%..........%%%.......%%%............................%%%..........%%%.......%%%......
m ......................%%%...........%....1...%%%%...........................%%%...........%....4...%%%%...........................%%%...........%....5...%%%%.....
m .......%..............%%%.....................%%%............%..............%%%.....................%%%............%..............%%%.....................%%%.....
m ......................%%%.....................%%%...........................%%%.....................%%%...........................%%%.....................%%%.....
m .....................%%%%%...................%%%%%.........................%%%%%...................%%%%%.........................%%%%%...................%%%%%....
m ....................%%%%%%..................%%%%..........................%%%%%%..................%%%%..........................%%%%%%..................%%%%......
m ..................%%%%%%%%%..........%%....%%%%.........................%%%%%%%%%..........%%....%%%%.........................%%%%%%%%%..........%%....%%%%.......
m .................%%%%%%%%%%%........%%%%%%%%%%.........................%%%%%%%%%%%........%%%%%%%%%%.........................%%%%%%%%%%%........%%%%%%%%%%........
m ...............%%%%%%....%%%%.......%%%%%%%%%........................%%%%%%....%%%%.......%%%%%%%%%........................%%%%%%....%%%%.......%%%%%%%%%.........
m ..............%%%%%.......%%%%........%%%%%%........................%%%%%.......%%%%........%%%%%%........................%%%%%.......%%%%........%%%%%%..........
m ..............%%%%.........%%%..........%%%.........................%%%%.........%%%..........%%%.........................%%%%.........%%%..........%%%...........
m ...............%...........%%%...........%%%.........................%...........%%%...........%%%.........................%...........%%%...........%%%..........
m ...%%.......................%............%%%.............%%.......................%............%%%.............%%.......................%............%%%..........
m ..%%%%...................................%%%............%%%%...................................%%%............%%%%...................................%%%..........
m ...%%%%...................................%%%............%%%%...................................%%%............%%%%...................................%%%.........
m ....%%%...................................%%%%%...........%%%...................................%%%%%...........%%%...................................%%%%%.......
m ....%%%%%..................................%%%%%%.........%%%%%..................................%%%%%%.........%%%%%..................................%%%%%%.....
m .....%%%%%%%%%%%%%........%%.................%%%%..........%%%%%%%%%%%%%........%%.................%%%%..........%%%%%%%%%%%%%........%%.................%%%%.....
m ......%%%%%%%%%%%%........%%%.................%%%...........%%%%%%%%%%%%........%%%.................%%%...........%%%%%%%%%%%%........%%%.................%%%.....
m ...........%%%%%%%........%%%..................%%%...............%%%%%%%........%%%..................%%%...............%%%%%%%........%%%..................%%%....
m ..............%%%%.........%%%%................%%%..................%%%%.........%%%%................%%%..................%%%%.........%%%%................%%%....
m ..............%%%..........%%%%%%%%%...........%%%..................%%%..........%%%%%%%%%...........%%%..................%%%..........%%%%%%%%%...........%%%....
m ..%%%.........%%%...........%%%%%%%%%.........%%%%......%%%.........%%%...........%%%%%%%%%.........%%%%......%%%.........%%%...........%%%%%%%%%.........%%%%....
m ..%%%%........%%%............%%%%%%%%.........%%%.......%%%%........%%%............%%%%%%%%.........%%%.......%%%%........%%%............%%%%%%%%.........%%%.....
m ..%%%%........%%..................%%%%.......%%%%.......%%%%........%%..................%%%%.......%%%%.......%%%%........%%..................%%%%.......%%%%.....
m ...%%%%......%%%...................%%%%......%%%.........%%%%......%%%...................%%%%......%%%.........%%%%......%%%...................%%%%......%%%......
m ....%%%%.....%%%....................%%%%....%%%%..........%%%%.....%%%....................%%%%....%%%%..........%%%%.....%%%....................%%%%....%%%%......
m .....%%%%....%%%.....................%%%%...%%%%...........%%%%....%%%.....................%%%%...%%%%...........%%%%....%%%.....................%%%%...%%%%......
