# random seed -1758196569140904676
# players 7
# area 22365
# cell width: 1.27737755063
# cell size: 9
# openness: 0.336518700251
# grid size: (1, 7)
# tile size: (126, 24) 0.190476190476
# map size: (126, 168) 1.33333333333
# horz shear step: 3
# horz_shear
# maze type recursive backtracker
# final openness 0.336518700251
# map_type cell_maze
# random_seed -1758196569140904676
players 7
rows 126
cols 168
m .......................................%%.............%............%%%%................%.....................%......................%%...........%%%...........%%.......
m ........................%..............%%.............%%.............%%%%.............%%......0.............%%.....................%%%%%%%%%%%%%%%%%...........%........
m ......................%%%..............%%..............%................%%.............%...................%%.....................%%%%...........%%..........%%%%%......
m ................%.......%%.............................%.................%.............%..................%%%....................%%%.............................%%%....
m ..%%............%........%.............................%.................%..............%.................%%...................%%%.................................%%%..
m .%%.........................................%..........%%................%%.............%..................%..................%%.....................................%%%
m %%%..........................................%.........%%.................%.............%%..................................%%%........................................%
m .%...........................................%%........%%%%%%.............%..............%%%%%.........................%..%%%...........................................
m .%%...........................................%.............%%............%.................%%%.......................%%%%%%............................................
m .%%...........................%%%%............%%.............%............%.......................................%......%%.............................................
m %%%%.........%.................................%%............%%...........%%.....................................%%.......%%...........%%%%.............................
m %%.%%%......%%..................................%%%...........%...........%%.....................................%%.......................%%%%%%%......................%
m %....%%...........................................%............%.........%%.......................%%.............%............................%%%%....................%%
m .....%%...........................................%%...........%%.......%%........................%%.............%...............................%...................%%.
m .....%%............................................%...........%%......%%.........%%............................%%...............................%%................%%%..
m .....%%............................................%%..........%.......%...........%............................%...............%%%..............%%%%%%%%%%%%.....%%....
m ......%...........%%...................%............%.........%%...................%%...........................%...............%%%%.........................%%.%%%.....
m ......%............%%..................%............%........%%....................%%..........................%%.............................................%%%%......
m ......%............%%%%................%.....................%......................%%...........%%%...........%%..............................................%%.......
m ......%%.............%%%%.............%%......6.............%%.....................%%%%%%%%%%%%%%%%%...........%................................%..............%%.......
m .......%................%%.............%...................%%.....................%%%%...........%%..........%%%%%............................%%%..............%%.......
m .......%.................%.............%..................%%%....................%%%.............................%%%....................%.......%%......................
m .......%.................%..............%.................%%...................%%%.................................%%%....%%............%........%......................
m .......%%................%%.............%..................%..................%%.....................................%%%.%%.........................................%...
m .......%%.................%.............%%..................................%%%........................................%%%%..........................................%..
m .......%%%%%%.............%..............%%%%%.........................%..%%%............................................%...........................................%%.
m ............%%............%.................%%%.......................%%%%%%.............................................%%...........................................%.
m .............%............%.......................................%......%%..............................................%%...........................%%%%............%%
m %............%%...........%%.....................................%%.......%%...........%%%%.............................%%%%.........%.................................%
m %%%...........%...........%%.....................................%%.......................%%%%%%%......................%%%.%%%......%%..................................
m ..%............%.........%%.......................%%.............%............................%%%%....................%%%....%%.........................................
m ..%%...........%%.......%%........................%%.............%...............................%...................%%......%%.........................................
m ...%...........%%......%%.........%%............................%%...............................%%................%%%.......%%.........................................
m ...%%..........%.......%...........%............................%...............%%%..............%%%%%%%%%%%%.....%%.........%%.........................................
m ....%.........%%...................%%...........................%...............%%%%.........................%%.%%%...........%...........%%...................%........
m ....%........%%....................%%..........................%%.............................................%%%%............%............%%..................%........
m .............%......................%%...........%%%...........%%..............................................%%.............%............%%%%................%........
m ............%%.....................%%%%%%%%%%%%%%%%%...........%................................%..............%%.............%%.............%%%%.............%%......3.
m ...........%%.....................%%%%...........%%..........%%%%%............................%%%..............%%..............%................%%.............%........
m ..........%%%....................%%%.............................%%%....................%.......%%.............................%.................%.............%........
m ..........%%...................%%%.................................%%%....%%............%........%.............................%.................%..............%.......
m ...........%..................%%.....................................%%%.%%.........................................%..........%%................%%.............%.......
m ............................%%%........................................%%%%..........................................%.........%%.................%.............%%......
m .......................%..%%%............................................%...........................................%%........%%%%%%.............%..............%%%%%..
m ......................%%%%%%.............................................%%...........................................%.............%%............%.................%%%.
m ..................%......%%..............................................%%...........................%%%%............%%.............%............%.....................
m .................%%.......%%...........%%%%.............................%%%%.........%.................................%%............%%...........%%....................
m .................%%.......................%%%%%%%......................%%%.%%%......%%..................................%%%...........%...........%%....................
m ..%%.............%............................%%%%....................%%%....%%...........................................%............%.........%%.....................
m ..%%.............%...............................%...................%%......%%...........................................%%...........%%.......%%......................
m ................%%...............................%%................%%%.......%%............................................%...........%%......%%.........%%............
m ................%...............%%%..............%%%%%%%%%%%%.....%%.........%%............................................%%..........%.......%...........%............
m ................%...............%%%%.........................%%.%%%...........%...........%%...................%............%.........%%...................%%...........
m ...............%%.............................................%%%%............%............%%..................%............%........%%....................%%...........
m .%%%...........%%..............................................%%.............%............%%%%................%.....................%......................%%..........
m %%%%...........%................................%..............%%.............%%.............%%%%.............%%......4.............%%.....................%%%%%%%%%%%%%
m .%%..........%%%%%............................%%%..............%%..............%................%%.............%...................%%.....................%%%%..........
m .................%%%....................%.......%%.............................%.................%.............%..................%%%....................%%%............
m ...................%%%....%%............%........%.............................%.................%..............%.................%%...................%%%..............
m .....................%%%.%%.........................................%..........%%................%%.............%..................%..................%%................
m .......................%%%%..........................................%.........%%.................%.............%%..................................%%%.................
m .........................%...........................................%%........%%%%%%.............%..............%%%%%.........................%..%%%...................
m .........................%%...........................................%.............%%............%.................%%%.......................%%%%%%....................
m .........................%%...........................%%%%............%%.............%............%.......................................%......%%.....................
m ........................%%%%.........%.................................%%............%%...........%%.....................................%%.......%%...........%%%%.....
m %......................%%%.%%%......%%..................................%%%...........%...........%%.....................................%%.......................%%%%%%
m %%....................%%%....%%...........................................%............%.........%%.......................%%.............%............................%%
m .%...................%%......%%...........................................%%...........%%.......%%........................%%.............%..............................
m .%%................%%%.......%%............................................%...........%%......%%.........%%............................%%..............................
m .%%%%%%%%%%%%.....%%.........%%............................................%%..........%.......%...........%............................%...............%%%.............
m .............%%.%%%...........%...........%%...................%............%.........%%...................%%...........................%...............%%%%............
m ..............%%%%............%............%%..................%............%........%%....................%%..........................%%...............................
m ...............%%.............%............%%%%................%.....................%......................%%...........%%%...........%%...............................
m %..............%%.............%%.............%%%%.............%%......1.............%%.....................%%%%%%%%%%%%%%%%%...........%................................
m %..............%%..............%................%%.............%...................%%.....................%%%%...........%%..........%%%%%............................%%
m %%.............................%.................%.............%..................%%%....................%%%.............................%%%....................%.......
m .%.............................%.................%..............%.................%%...................%%%.................................%%%....%%............%.......
m ....................%..........%%................%%.............%..................%..................%%.....................................%%%.%%.....................
m .....................%.........%%.................%.............%%..................................%%%........................................%%%%.....................
m .....................%%........%%%%%%.............%..............%%%%%.........................%..%%%............................................%......................
m ......................%.............%%............%.................%%%.......................%%%%%%.............................................%%.....................
m ......%%%%............%%.............%............%.......................................%......%%..............................................%%.....................
m .......................%%............%%...........%%.....................................%%.......%%...........%%%%.............................%%%%.........%..........
m ........................%%%...........%...........%%.....................................%%.......................%%%%%%%......................%%%.%%%......%%..........
m ..........................%............%.........%%.......................%%.............%............................%%%%....................%%%....%%.................
m ..........................%%...........%%.......%%........................%%.............%...............................%...................%%......%%.................
m ...........................%...........%%......%%.........%%............................%%...............................%%................%%%.......%%.................
m ...........................%%..........%.......%...........%............................%...............%%%..............%%%%%%%%%%%%.....%%.........%%.................
m ...............%............%.........%%...................%%...........................%...............%%%%.........................%%.%%%...........%...........%%....
m ...............%............%........%%....................%%..........................%%.............................................%%%%............%............%%...
m ...............%.....................%......................%%...........%%%...........%%..............................................%%.............%............%%%%.
m %.............%%......2.............%%.....................%%%%%%%%%%%%%%%%%...........%................................%..............%%.............%%.............%%%
m %%.............%...................%%.....................%%%%...........%%..........%%%%%............................%%%..............%%..............%................
m .%.............%..................%%%....................%%%.............................%%%....................%.......%%.............................%................
m .%..............%.................%%...................%%%.................................%%%....%%............%........%.............................%................
m .%%.............%..................%..................%%.....................................%%%.%%.........................................%..........%%...............
m ..%.............%%..................................%%%........................................%%%%..........................................%.........%%...............
m ..%..............%%%%%.........................%..%%%............................................%...........................................%%........%%%%%%...........
m ..%.................%%%.......................%%%%%%.............................................%%...........................................%.............%%..........
m ..%.......................................%......%%..............................................%%...........................%%%%............%%.............%..........
m ..%%.....................................%%.......%%...........%%%%.............................%%%%.........%.................................%%............%%.........
m ..%%.....................................%%.......................%%%%%%%......................%%%.%%%......%%..................................%%%...........%.........
m .%%.......................%%.............%............................%%%%....................%%%....%%...........................................%............%........
m %%........................%%.............%...............................%...................%%......%%...........................................%%...........%%.......
m %.........%%............................%%...............................%%................%%%.......%%............................................%...........%%......%
m ...........%............................%...............%%%..............%%%%%%%%%%%%.....%%.........%%............................................%%..........%.......%
m ...........%%...........................%...............%%%%.........................%%.%%%...........%...........%%...................%............%.........%%........
m ...........%%..........................%%.............................................%%%%............%............%%..................%............%........%%.........
m ............%%...........%%%...........%%..............................................%%.............%............%%%%................%.....................%..........
m ...........%%%%%%%%%%%%%%%%%...........%................................%..............%%.............%%.............%%%%.............%%......5.............%%..........
m ..........%%%%...........%%..........%%%%%............................%%%..............%%..............%................%%.............%...................%%...........
m .........%%%.............................%%%....................%.......%%.............................%.................%.............%..................%%%...........
m .......%%%.................................%%%....%%............%........%.............................%.................%..............%.................%%............
m ......%%.....................................%%%.%%.........................................%..........%%................%%.............%..................%............
m ....%%%........................................%%%%..........................................%.........%%.................%.............%%..............................
m ..%%%............................................%...........................................%%........%%%%%%.............%..............%%%%%.........................%
m %%%%.............................................%%...........................................%.............%%............%.................%%%.......................%%
m .%%..............................................%%...........................%%%%............%%.............%............%.......................................%.....
m ..%%...........%%%%.............................%%%%.........%.................................%%............%%...........%%.....................................%%.....
m ..................%%%%%%%......................%%%.%%%......%%..................................%%%...........%...........%%.....................................%%.....
m ......................%%%%....................%%%....%%...........................................%............%.........%%.......................%%.............%......
m .........................%...................%%......%%...........................................%%...........%%.......%%........................%%.............%......
m .........................%%................%%%.......%%............................................%...........%%......%%.........%%............................%%......
m ........%%%..............%%%%%%%%%%%%.....%%.........%%............................................%%..........%.......%...........%............................%.......
m ........%%%%.........................%%.%%%...........%...........%%...................%............%.........%%...................%%...........................%.......
m ......................................%%%%............%............%%..................%............%........%%....................%%..........................%%.......
