# map type: blank
# random seed: 630662271
# hill distance  42,  5  32, 85  42, 71  32, 19  42,137  15, 38   5,184   5, 52  15,104  15,170   5,118  32,151
#        42,  5       0     124      90      40      90      60      36      64     150      60     126      86 
#        32, 85     124       0      40     100      86      64     150      60      36     126      60     100 
#        42, 71      90      40       0      86      90      60     126      36      60     150      64     124 
#        32, 19      40     100      86       0     124      36      60      60     126      64     150     100 
#        42,137      90      86      90     124       0     150      64     126      60      60      36      40 
#        15, 38      60      64      60      36     150       0      86      40      90      90     124     126 
#         5,184      36     150     126      60      64      86       0     100     124      40     100      60 
#         5, 52      64      60      36      60     126      40     100       0      86     124     100     150 
#        15,104     150      36      60     126      60      90     124      86       0      90      40      64 
#        15,170      60     126     150      64      60      90      40     124      90       0      86      36 
#         5,118     126      60      64     150      36     124     100     100      40      86       0      60 
#        32,151      86     100     124     100      40     126      60     150      64      36      60       0 
players 6
rows 54
cols 198
m ..%%%......%%%.......%..............................................%%%......%%%.......%..............................................%%%......%%%.......%............................................
m ..%%.....%%%%.......................................................%%.....%%%%.......................................................%%.....%%%%.....................................................
m .%%%....%%%%.......................................................%%%....%%%%.......................................................%%%....%%%%......................................................
m .%%......%%%...................%%..................................%%......%%%...................%%..................................%%......%%%...................%%.................................
m %%........%%%..................%%%................................%%........%%%..................%%%................................%%........%%%..................%%%................................
m ...........%%........%..........%%%..........%%.....4........................%%........%..........%%%..........%%.....5........................%%........%..........%%%..........%%.....1.............
m ...........%%%%%%%%%%%...........%%.........%%%%..........%%.................%%%%%%%%%%%...........%%.........%%%%..........%%.................%%%%%%%%%%%...........%%.........%%%%..........%%......
m ............%%%%%%%%%%%...........%%.......%%%%%%.........%%..................%%%%%%%%%%%...........%%.......%%%%%%.........%%..................%%%%%%%%%%%...........%%.......%%%%%%.........%%......
m .....................%%%..........%%%%%%%%%%%.%%%%.......%%............................%%%..........%%%%%%%%%%%.%%%%.......%%............................%%%..........%%%%%%%%%%%.%%%%.......%%.......
m ......................%%...........%%%%%%%%.....%%%%.....%%.............................%%...........%%%%%%%%.....%%%%.....%%.............................%%...........%%%%%%%%.....%%%%.....%%.......
m ......................%%%...........%%%%%%........%%%%..%%%.............................%%%...........%%%%%%........%%%%..%%%.............................%%%...........%%%%%%........%%%%..%%%.......
m ......................%%%..........................%%%%%%%..............................%%%..........................%%%%%%%..............................%%%..........................%%%%%%%........
m ...%%..................%%...........................%%%%%%...........%%..................%%...........................%%%%%%...........%%..................%%...........................%%%%%%........
m ..%%%%%%%%%............%%%...........................%%%%%..........%%%%%%%%%............%%%...........................%%%%%..........%%%%%%%%%............%%%...........................%%%%%........
m .%%%%%%%%%%%............%%%%...%%%.....................%%%.........%%%%%%%%%%%............%%%%...%%%.....................%%%.........%%%%%%%%%%%............%%%%...%%%.....................%%%........
m %%%.....%%%%.............%%%%%%%%%....0...........................%%%.....%%%%.............%%%%%%%%%....2...........................%%%.....%%%%.............%%%%%%%%%....3...........................
m %%........%%%.............%%%%%............%.....................%%%........%%%.............%%%%%............%.....................%%%........%%%.............%%%%%............%.....................%
m %..........%%%............%%..............%%%%....................%..........%%%............%%..............%%%%....................%..........%%%............%%..............%%%%....................
m ............%%%...........%%..............%%%%%%..............................%%%...........%%..............%%%%%%..............................%%%...........%%..............%%%%%%..................
m ............%%%...........%%.................%%%..............................%%%...........%%.................%%%..............................%%%...........%%.................%%%..................
m .............%%...........%%.........%%.......%%%..............................%%...........%%.........%%.......%%%..............................%%...........%%.........%%.......%%%.................
m .............%%...........%%.........%%........%%..............................%%...........%%.........%%........%%..............................%%...........%%.........%%........%%.................
m .............%%...........%%........%%.........%%..............................%%...........%%........%%.........%%..............................%%...........%%........%%.........%%.................
m ...........%%%%.........%%%%........%%.........%%%......%%%..................%%%%.........%%%%........%%.........%%%......%%%..................%%%%.........%%%%........%%.........%%%......%%%.......
m %%%%%%%%%%%%%%%.......%%%%..........%%.........%%%%%%..%%%.......%%%%%%%%%%%%%%%%.......%%%%..........%%.........%%%%%%..%%%.......%%%%%%%%%%%%%%%%.......%%%%..........%%.........%%%%%%..%%%.......%
m %%%%%%%%%%%%%%%....%%%%%...........%%%........%%%%%%%%%%%........%%%%%%%%%%%%%%%%....%%%%%...........%%%........%%%%%%%%%%%........%%%%%%%%%%%%%%%%....%%%%%...........%%%........%%%%%%%%%%%........%
m ...........%%.......%%%............%%%.......%%%....%%%%.........%...........%%.......%%%............%%%.......%%%....%%%%.........%...........%%.......%%%............%%%.......%%%....%%%%.........%
m ...................................%%%......%%%.......%..............................................%%%......%%%.......%..............................................%%%......%%%.......%...........
m ...................................%%.....%%%%.......................................................%%.....%%%%.......................................................%%.....%%%%....................
m ..................................%%%....%%%%.......................................................%%%....%%%%.......................................................%%%....%%%%.....................
m ..................................%%......%%%...................%%..................................%%......%%%...................%%..................................%%......%%%...................%%
m %................................%%........%%%..................%%%................................%%........%%%..................%%%................................%%........%%%..................%%
m %%..........%%.....0........................%%........%..........%%%..........%%.....2........................%%........%..........%%%..........%%.....3........................%%........%..........%
m %%.........%%%%..........%%.................%%%%%%%%%%%...........%%.........%%%%..........%%.................%%%%%%%%%%%...........%%.........%%%%..........%%.................%%%%%%%%%%%...........
m .%%.......%%%%%%.........%%..................%%%%%%%%%%%...........%%.......%%%%%%.........%%..................%%%%%%%%%%%...........%%.......%%%%%%.........%%..................%%%%%%%%%%%..........
m .%%%%%%%%%%%.%%%%.......%%............................%%%..........%%%%%%%%%%%.%%%%.......%%............................%%%..........%%%%%%%%%%%.%%%%.......%%............................%%%.........
m ..%%%%%%%%.....%%%%.....%%.............................%%...........%%%%%%%%.....%%%%.....%%.............................%%...........%%%%%%%%.....%%%%.....%%.............................%%.........
m ...%%%%%%........%%%%..%%%.............................%%%...........%%%%%%........%%%%..%%%.............................%%%...........%%%%%%........%%%%..%%%.............................%%%........
m ..................%%%%%%%..............................%%%..........................%%%%%%%..............................%%%..........................%%%%%%%..............................%%%........
m ...................%%%%%%...........%%..................%%...........................%%%%%%...........%%..................%%...........................%%%%%%...........%%..................%%........
m ....................%%%%%..........%%%%%%%%%............%%%...........................%%%%%..........%%%%%%%%%............%%%...........................%%%%%..........%%%%%%%%%............%%%.......
m %.....................%%%.........%%%%%%%%%%%............%%%%...%%%.....................%%%.........%%%%%%%%%%%............%%%%...%%%.....................%%%.........%%%%%%%%%%%............%%%%...%%
m %....1...........................%%%.....%%%%.............%%%%%%%%%....4...........................%%%.....%%%%.............%%%%%%%%%....5...........................%%%.....%%%%.............%%%%%%%%
m ..........%.....................%%%........%%%.............%%%%%............%.....................%%%........%%%.............%%%%%............%.....................%%%........%%%.............%%%%%..
m .........%%%%....................%..........%%%............%%..............%%%%....................%..........%%%............%%..............%%%%....................%..........%%%............%%.....
m .........%%%%%%..............................%%%...........%%..............%%%%%%..............................%%%...........%%..............%%%%%%..............................%%%...........%%.....
m ............%%%..............................%%%...........%%.................%%%..............................%%%...........%%.................%%%..............................%%%...........%%.....
m ....%%.......%%%..............................%%...........%%.........%%.......%%%..............................%%...........%%.........%%.......%%%..............................%%...........%%.....
m ....%%........%%..............................%%...........%%.........%%........%%..............................%%...........%%.........%%........%%..............................%%...........%%.....
m ...%%.........%%..............................%%...........%%........%%.........%%..............................%%...........%%........%%.........%%..............................%%...........%%.....
m ...%%.........%%%......%%%..................%%%%.........%%%%........%%.........%%%......%%%..................%%%%.........%%%%........%%.........%%%......%%%..................%%%%.........%%%%.....
m ...%%.........%%%%%%..%%%.......%%%%%%%%%%%%%%%%.......%%%%..........%%.........%%%%%%..%%%.......%%%%%%%%%%%%%%%%.......%%%%..........%%.........%%%%%%..%%%.......%%%%%%%%%%%%%%%%.......%%%%.......
m ..%%%........%%%%%%%%%%%........%%%%%%%%%%%%%%%%....%%%%%...........%%%........%%%%%%%%%%%........%%%%%%%%%%%%%%%%....%%%%%...........%%%........%%%%%%%%%%%........%%%%%%%%%%%%%%%%....%%%%%.........
m ..%%%.......%%%....%%%%.........%...........%%.......%%%............%%%.......%%%....%%%%.........%...........%%.......%%%............%%%.......%%%....%%%%.........%...........%%.......%%%..........
