# map type: blank
# random seed: 358884422
# hill distance  18,183  22, 23 106,144   0,179  62, 66  84,105  44, 62  88,140  40, 27  66,101
#        18,183       0      61      61      24     122     122     122      85      61     146 
#        22, 23      61       0     122      85      85     146      85     146      24     146 
#       106,144      61     122       0      61     122      61     146      24     122      85 
#         0,179      24      85      61       0     146     122     146      85      85     146 
#        62, 66     122      85     122     146       0      61      24     122      61      61 
#        84,105     122     146      61     122      61       0      85      61     122      24 
#        44, 62     122      85     146     146      24      85       0     146      61      85 
#        88,140      85     146      24      85     122      61     146       0     146      85 
#        40, 27      61      24     122      85      61     122      61     146       0     122 
#        66,101     146     146      85     146      61      24      85      85     122       0 
players 5
rows 110
cols 195
m ....%.................%...........%..........%.......%%..........%.........%.................%%%%..........%..........%.......%%%%........%.........................%.......%......4.......%.......
m ...%%............%%%.%%..........%%...........%.....%%............%%.........................%%%...........%..........%....................%.........%%..............%%.....%..............%%%.....
m ...%.............%%%%%%..........%............%%...%%..............%%.......................%..............%%........%.....................%%........%%%%%%%..........%%...%%................%%....
m ..%%............%%....%%.........%%............%%%%%...............%.......................%................%........%......................%%.............%...........%%%.%%..................%%..
m ..%............%%......%%.........%%..............%................%...........%..........%.................%.......%%.......................%%%%..........%%...........%%%%%%%..................%%
m %%%...........%%........%..........%%.............................%...........%%%........%..................%%......%........................%%%%%..........%.................%%%%................%
m .%...........%%.........%...........%%............................%...........%%%.......%...................%%.....%%.......................%%...%..........%%...................%%%%..............
m ..%.........%%..........%............%%...........................%..........%%%......%%..................%%%.%%%..%.......................%%....%%..........%......................%%.............
m ..%........%%...........%.............%%.........................%...........%%......%%%................%%.......%%%.......................%......%..........%%........%%..........................
m ..%%......%%............%%............%%.........................%...........%%......%%..............%%%...........%......................%.......%%..........%......%%%%..........................
m .%%%%....%%..............%............%%.............%...........%..........%%.......%...............%.........................%%........%.........%..........%%..%%%...%..........................
m %%..%%...................%............%%.............%...........%%.........%.......%%..............%%........................%%....................%.........%%%%.......%............%...........%
m ....%%...................%.............%%............%............%........%........%...............%........................%%.....................%%........%%.........%............%%%.......%%%
m ....%%...................%..............%%..........%%............%%......%%........%..............%%.................%%%%%%%%.......................%........%...........%.............%%.....%%..
m ....%%...................%...............%%.........%............%%.%%...%%........%%..............%..................%%%...%%%......................%%......%............%...............%%.%%....
m ....%%....................................%%........%............%....%%.%%........%..............%%.................%.......%%......................%.......%.............%...............%%%.....
m ....%%.......................%.............%%......%%...........%%......%%%.......%%..............%..................%........%%....................%......................%.......................
m ....%%............%...........%.............%%.%%%%%............%........%%.......%..............%%.................%%.........%%..................%........................%......................
m ....%%............%...........%..............%%%...............%..........%.......%.............%%%%................%...........%%........%%......%.........................%%.........2...........
m ....%%...........%............%..............%................%%..........%.......%%...........%%...%..............%%............%%......%%......%............%%............%%%%...................
m .....%%..........%............%%............%%................%..........%%........%..........%%.....%%............%..............%%....%%.......%............%%%%%.......%%%..%%..................
m ......%%.........%.............%............%................%%..........%.........%%........%%.......%%...........%...............%%..%%........%%..........%%...%%%%...%%.....%%.................
m ........%.......%......0.......%...........%.................%...........%..........%.......%%..........%.........%.................%%%%..........%..........%.......%%%%........%.................
m .........%%.....%..............%%%........%%............%%%.%%..........%%...........%.....%%............%%.........................%%%...........%..........%....................%.........%%.....
m ..........%%...%%................%%.......%.............%%%%%%..........%............%%...%%..............%%.......................%..............%%........%.....................%%........%%%%%%%
m ...........%%%.%%..................%%....%%............%%....%%.........%%............%%%%%...............%.......................%................%........%......................%%.............%
m %...........%%%%%%%..................%%..%............%%......%%.........%%..............%................%...........%..........%.................%.......%%.......................%%%%..........%
m %.................%%%%................%%%%...........%%........%..........%%.............................%...........%%%........%..................%%......%........................%%%%%..........
m %%...................%%%%...............%...........%%.........%...........%%............................%...........%%%.......%...................%%.....%%.......................%%...%..........
m .%......................%%...............%.........%%..........%............%%...........................%..........%%%......%%..................%%%.%%%..%.......................%%....%%.........
m .%%........%%............................%........%%...........%.............%%.........................%...........%%......%%%................%%.......%%%.......................%......%.........
m ..%......%%%%............................%%......%%............%%............%%.........................%...........%%......%%..............%%%...........%......................%.......%%........
m ..%%..%%%...%...........................%%%%....%%..............%............%%.............%...........%..........%%.......%...............%.........................%%........%.........%........
m ..%%%%.......%............%...........%%%..%%...................%............%%.............%...........%%.........%.......%%..............%%........................%%....................%.......
m ..%%.........%............%%%.......%%%....%%...................%.............%%............%............%........%........%...............%........................%%.....................%%......
m ..%...........%.............%%.....%%......%%...................%..............%%..........%%............%%......%%........%..............%%.................%%%%%%%%.......................%......
m .%............%...............%%.%%........%%...................%...............%%.........%............%%.%%...%%........%%..............%..................%%%...%%%......................%%.....
m .%.............%...............%%%.........%%....................................%%........%............%....%%.%%........%..............%%.................%.......%%......................%......
m ...............%...........................%%.......................%.............%%......%%...........%%......%%%.......%%..............%..................%........%%....................%.......
m ................%..........................%%............%...........%.............%%.%%%%%............%........%%.......%..............%%.................%%.........%%..................%........
m ................%%.........3...............%%............%...........%..............%%%...............%..........%.......%.............%%%%................%...........%%........%%......%.........
m ..%%............%%%%.......................%%...........%............%..............%................%%..........%.......%%...........%%...%..............%%............%%......%%......%..........
m ..%%%%%.......%%%..%%.......................%%..........%............%%............%%................%..........%%........%..........%%.....%%............%..............%%....%%.......%..........
m .%%...%%%%...%%.....%%.......................%%.........%.............%............%................%%..........%.........%%........%%.......%%...........%...............%%..%%........%%.........
m .%.......%%%%........%.........................%.......%......1.......%...........%.................%...........%..........%.......%%..........%.........%.................%%%%..........%.........
m .%....................%.........%%..............%%.....%..............%%%........%%............%%%.%%..........%%...........%.....%%............%%.........................%%%...........%.........
m %.....................%%........%%%%%%%..........%%...%%................%%.......%.............%%%%%%..........%............%%...%%..............%%.......................%..............%%........
m %......................%%.............%...........%%%.%%..................%%....%%............%%....%%.........%%............%%%%%...............%.......................%................%........
m %.......................%%%%..........%%...........%%%%%%%..................%%..%............%%......%%.........%%..............%................%...........%..........%.................%.......%
m ........................%%%%%..........%.................%%%%................%%%%...........%%........%..........%%.............................%...........%%%........%..................%%......%
m .......................%%...%..........%%...................%%%%...............%...........%%.........%...........%%............................%...........%%%.......%...................%%.....%%
m ......................%%....%%..........%......................%%...............%.........%%..........%............%%...........................%..........%%%......%%..................%%%.%%%..%.
m ......................%......%..........%%........%%............................%........%%...........%.............%%.........................%...........%%......%%%................%%.......%%%.
m .....................%.......%%..........%......%%%%............................%%......%%............%%............%%.........................%...........%%......%%..............%%%...........%.
m ..........%%........%.........%..........%%..%%%...%...........................%%%%....%%..............%............%%.............%...........%..........%%.......%...............%...............
m .........%%....................%.........%%%%.......%............%...........%%%..%%...................%............%%.............%...........%%.........%.......%%..............%%...............
m ........%%.....................%%........%%.........%............%%%.......%%%....%%...................%.............%%............%............%........%........%...............%................
m .%%%%%%%%.......................%........%...........%.............%%.....%%......%%...................%..............%%..........%%............%%......%%........%..............%%................
m .%%%...%%%......................%%......%............%...............%%.%%........%%...................%...............%%.........%............%%.%%...%%........%%..............%.................
m %.......%%......................%.......%.............%...............%%%.........%%....................................%%........%............%....%%.%%........%..............%%.................
m %........%%....................%......................%...........................%%.......................%.............%%......%%...........%%......%%%.......%%..............%..................
m %.........%%..................%........................%..........................%%............%...........%.............%%.%%%%%............%........%%.......%..............%%.................%
m ...........%%........%%......%.........................%%.........4...............%%............%...........%..............%%%...............%..........%.......%.............%%%%................%
m ............%%......%%......%............%%............%%%%.......................%%...........%............%..............%................%%..........%.......%%...........%%...%..............%%
m .............%%....%%.......%............%%%%%.......%%%..%%.......................%%..........%............%%............%%................%..........%%........%..........%%.....%%............%.
m ..............%%..%%........%%..........%%...%%%%...%%.....%%.......................%%.........%.............%............%................%%..........%.........%%........%%.......%%...........%.
m ...............%%%%..........%..........%.......%%%%........%.........................%.......%......2.......%...........%.................%...........%..........%.......%%..........%.........%..
m ...............%%%...........%..........%....................%.........%%..............%%.....%..............%%%........%%............%%%.%%..........%%...........%.....%%............%%..........
m ..............%..............%%........%.....................%%........%%%%%%%..........%%...%%................%%.......%.............%%%%%%..........%............%%...%%..............%%.........
m .............%................%........%......................%%.............%...........%%%.%%..................%%....%%............%%....%%.........%%............%%%%%...............%..........
m .%..........%.................%.......%%.......................%%%%..........%%...........%%%%%%%..................%%..%............%%......%%.........%%..............%................%..........
m %%%........%..................%%......%........................%%%%%..........%.................%%%%................%%%%...........%%........%..........%%.............................%...........
m %%%.......%...................%%.....%%.......................%%...%..........%%...................%%%%...............%...........%%.........%...........%%............................%...........
m %%......%%..................%%%.%%%..%.......................%%....%%..........%......................%%...............%.........%%..........%............%%...........................%..........%
m %......%%%................%%.......%%%.......................%......%..........%%........%%............................%........%%...........%.............%%.........................%...........%
m %......%%..............%%%...........%......................%.......%%..........%......%%%%............................%%......%%............%%............%%.........................%...........%
m .......%...............%.........................%%........%.........%..........%%..%%%...%...........................%%%%....%%..............%............%%.............%...........%..........%%
m ......%%..............%%........................%%....................%.........%%%%.......%............%...........%%%..%%...................%............%%.............%...........%%.........%.
m ......%...............%........................%%.....................%%........%%.........%............%%%.......%%%....%%...................%.............%%............%............%........%..
m ......%..............%%.................%%%%%%%%.......................%........%...........%.............%%.....%%......%%...................%..............%%..........%%............%%......%%..
m .....%%..............%..................%%%...%%%......................%%......%............%...............%%.%%........%%...................%...............%%.........%............%%.%%...%%...
m .....%..............%%.................%.......%%......................%.......%.............%...............%%%.........%%....................................%%........%............%....%%.%%...
m ....%%..............%..................%........%%....................%......................%...........................%%.......................%.............%%......%%...........%%......%%%...
m ....%..............%%.................%%.........%%..................%........................%..........................%%............%...........%.............%%.%%%%%............%........%%...
m ....%.............%%%%................%...........%%........%%......%.........................%%.........0...............%%............%...........%..............%%%...............%..........%...
m ....%%...........%%...%..............%%............%%......%%......%............%%............%%%%.......................%%...........%............%..............%................%%..........%...
m .....%..........%%.....%%............%..............%%....%%.......%............%%%%%.......%%%..%%.......................%%..........%............%%............%%................%..........%%...
m .....%%........%%.......%%...........%...............%%..%%........%%..........%%...%%%%...%%.....%%.......................%%.........%.............%............%................%%..........%....
m ......%.......%%..........%.........%.................%%%%..........%..........%.......%%%%........%.........................%.......%......3.......%...........%.................%...........%....
m .......%.....%%............%%.........................%%%...........%..........%....................%.........%%..............%%.....%..............%%%........%%............%%%.%%..........%%....
m .......%%...%%..............%%.......................%..............%%........%.....................%%........%%%%%%%..........%%...%%................%%.......%.............%%%%%%..........%.....
m ........%%%%%...............%.......................%................%........%......................%%.............%...........%%%.%%..................%%....%%............%%....%%.........%%....
m ...........%................%...........%..........%.................%.......%%.......................%%%%..........%%...........%%%%%%%..................%%..%............%%......%%.........%%...
m ...........................%...........%%%........%..................%%......%........................%%%%%..........%.................%%%%................%%%%...........%%........%..........%%..
m ...........................%...........%%%.......%...................%%.....%%.......................%%...%..........%%...................%%%%...............%...........%%.........%...........%%.
m ...........................%..........%%%......%%..................%%%.%%%..%.......................%%....%%..........%......................%%...............%.........%%..........%............%%
m %.........................%...........%%......%%%................%%.......%%%.......................%......%..........%%........%%............................%........%%...........%.............%
m %.........................%...........%%......%%..............%%%...........%......................%.......%%..........%......%%%%............................%%......%%............%%............%
m %.............%...........%..........%%.......%...............%.........................%%........%.........%..........%%..%%%...%...........................%%%%....%%..............%............%
m %.............%...........%%.........%.......%%..............%%........................%%....................%.........%%%%.......%............%...........%%%..%%...................%............%
m %%............%............%........%........%...............%........................%%.....................%%........%%.........%............%%%.......%%%....%%...................%.............
m .%%..........%%............%%......%%........%..............%%.................%%%%%%%%.......................%........%...........%.............%%.....%%......%%...................%.............
m ..%%.........%............%%.%%...%%........%%..............%..................%%%...%%%......................%%......%............%...............%%.%%........%%...................%.............
m ...%%........%............%....%%.%%........%..............%%.................%.......%%......................%.......%.............%...............%%%.........%%.................................
m ....%%......%%...........%%......%%%.......%%..............%..................%........%%....................%......................%...........................%%.......................%.........
m .....%%.%%%%%............%........%%.......%..............%%.................%%.........%%..................%........................%..........................%%............%...........%........
m ......%%%...............%..........%.......%.............%%%%................%...........%%........%%......%.........................%%.........1...............%%............%...........%........
m ......%................%%..........%.......%%...........%%...%..............%%............%%......%%......%............%%............%%%%.......................%%...........%............%........
m .....%%................%..........%%........%..........%%.....%%............%..............%%....%%.......%............%%%%%.......%%%..%%.......................%%..........%............%%.......
m .....%................%%..........%.........%%........%%.......%%...........%...............%%..%%........%%..........%%...%%%%...%%.....%%.......................%%.........%.............%.......
