# random seed -8359750729241209574
# players 4
# area 8740
# cell width: 1.12060704098
# cell size: 7
# openness: 0.521863744602
# grid size: (2, 2)
# tile size: (26, 82) 3.15384615385
# map size: (52, 164) 12.6153846154
# vert shear step: 1
# vert_shear
# horz_copy
# maze type recursive backtracker
# final openness 0.521863744602
# map_type cell_maze
# random_seed -8359750729241209574
players 4
rows 52
cols 164
m ............%%.......................%......................%...........%%....................%%.......................%......................%...........%%........
m .............%%......................%..................%%%%%%%%........%......................%%......................%..................%%%%%%%%........%.........
m ..............%......................%..................%%.....%%%%%...%........................%......................%..................%%.....%%%%%...%..........
m ..............%......................%.............................%%%%%........................%......................%.............................%%%%%..........
m ...............%............%%......%%.......%...................................................%............%%......%%.......%....................................
m ...............%.........%%%.......%%.........%..................................................%.........%%%.......%%.........%...................................
m ........................%.........%%..........%%..........................................................%.........%%..........%%..................................
m %...%..................%.......................%%%%%..............................%...%..................%.......................%%%%%..............................
m %....%.................%........................%................................%%....%.................%........................%................................%
m ......%....%%.........%%...............................................3........%%......%....%%.........%%...............................................0........%%
m .......%...%..........%%....................................................%%%%%........%...%..........%%....................................................%%%%%.
m ......................%............%.........................%%.%%%.....................................%............%.........................%%.%%%...............
m ..................................%%....................%%.....%%...................................................%%....................%%.....%%.................
m .................................%%..........%%.........%..........................................................%%..........%%.........%.........................
m .................%........%.....%%.........%%..........................%...........................%........%.....%%.........%%..........................%..........
m ......%.........%%.........................%............................................%.........%%.........................%......................................
m .....%%........%%................................................................%.....%%........%%................................................................%
m %%%%%........%%%................................................................%%%%%%%........%%%................................................................%%
m ...%.......%%%........................................%.................%%%%...%.....%.......%%%........................................%.................%%%%...%..
m ...%.......%..........................................%%%%%............%....%%%......%.......%..........................................%%%%%............%....%%%...
m ...%.....................%...........................%%....%%%%%......%.......%......%.....................%...........................%%....%%%%%......%.......%...
m ....%.....................................%..........%.........%......%.......%.......%.....................................%..........%.........%......%.......%...
m ....%...............%.....................%.........%%.........%......%%.......%......%...............%.....................%.........%%.........%......%%.......%..
m ....%...%%%%........%...............................%..........%.......%.......%......%...%%%%........%...............................%..........%.......%.......%..
m .....%%%%..........%%............%%%%%%.............%.........%%...............%.......%%%%..........%%............%%%%%%.............%.........%%...............%..
m ...................%............%...............%%%%%%........................%%.....................%............%...............%%%%%%........................%%..
m ...................%...........%%....................%%.......................%......................%...........%%....................%%.......................%...
m ...............%%%%%%%%........%......................%%......................%..................%%%%%%%%........%......................%%......................%...
m ...............%%.....%%%%%...%........................%......................%..................%%.....%%%%%...%........................%......................%...
m ..........................%%%%%........................%......................%.............................%%%%%........................%......................%...
m ....%...................................................%............%%......%%.......%...................................................%............%%......%%...
m .....%..................................................%.........%%%.......%%.........%..................................................%.........%%%.......%%....
m .....%%..........................................................%.........%%..........%%..........................................................%.........%%.....
m ......%%%%%..............................%...%..................%.......................%%%%%..............................%...%..................%.................
m .......%................................%%....%.................%........................%................................%%....%.................%.................
m ..............................2........%%......%....%%.........%%...............................................1........%%......%....%%.........%%.................
m ...................................%%%%%........%...%..........%%....................................................%%%%%........%...%..........%%.................
m ....................%%.%%%.....................................%............%.........................%%.%%%.....................................%............%.....
m ...............%%.....%%...................................................%%....................%%.....%%...................................................%%.....
m ....%%.........%..........................................................%%..........%%.........%..........................................................%%......
m ..%%..........................%...........................%........%.....%%.........%%..........................%...........................%........%.....%%.......
m ..%............................................%.........%%.........................%............................................%.........%%.......................
m ........................................%.....%%........%%................................................................%.....%%........%%........................
m .......................................%%%%%%%........%%%................................................................%%%%%%%........%%%.........................
m .............%.................%%%%...%.....%.......%%%........................................%.................%%%%...%.....%.......%%%...........................
m .............%%%%%............%....%%%......%.......%..........................................%%%%%............%....%%%......%.......%.............................
m ............%%....%%%%%......%.......%......%.....................%...........................%%....%%%%%......%.......%......%.....................%...............
m .%..........%.........%......%.......%.......%.....................................%..........%.........%......%.......%.......%....................................
m .%.........%%.........%......%%.......%......%...............%.....................%.........%%.........%......%%.......%......%...............%....................
m ...........%..........%.......%.......%......%...%%%%........%...............................%..........%.......%.......%......%...%%%%........%....................
m ...........%.........%%...............%.......%%%%..........%%............%%%%%%.............%.........%%...............%.......%%%%..........%%............%%%%%%..
m .......%%%%%%........................%%.....................%............%...............%%%%%%........................%%.....................%............%........
