# map type: cell maze
# random seed: -1911054015
# players 5
# area 16243, 3248 (57.0^2) per player
# cell width: 1.44997326749
# cell size: 7.47018961295
# openness: 0.127744186014
# maze type prims
# horz shear step: 3
# horz_shear
# final parameters
# area: 16000
# grid size: (1, 5)
# tile size: (80, 40) 0.5
# map size: (80, 200) 2.5
# hill distance  58, 90  74,170  19, 11   3,131  42, 10  67, 51  10, 50  51,171  35, 91  26,130
#        58, 90       0     144     148      84     144     122     118     112      34     118 
#        74,170     144       0      84     122     118     112     144      34     148     118 
#        19, 11     148      84       0     116      34      88     122      88     116     112 
#         3,131      84     122     116       0     148     116     112      88      88      34 
#        42, 10     144     118      34     148       0      84     118     122     112     144 
#        67, 51     122     112      88     116      84       0      34     116      88     148 
#        10, 50     118     144     122     112     118      34       0     148      84     144 
#        51,171     112      34      88      88     122     116     148       0     116      84 
#        35, 91      34     148     116      88     112      88      84     116       0     122 
#        26,130     118     118     112      34     144     148     144      84     122       0 
players 5
rows 80
cols 200
m ............%%%..........%%.....%%.......%%......%%%.%%%................%..........%%%%%%%%%...............%..................................%%...%%.......%%........%%%..............%%%%.............
m ..............%%.........%.......%%.......%.......%%%%%.................%%.......%%%%%%%%%.................%%................................%%.....%%.....%%.........%%...............%%...............
m ..............%%........%%.......%%.......%........%%........%..........%%%......%.....%...................%%%%..............................%%......%%....%%.........%................%%...............
m ...............%........%........%%.......%%.......%.........%...........%%%.................................%%%%%%%%..............1........%%.......%%%%%%%..........%...............%%................
m ...............%%......%%........%%........%.......%.........%%...........%%%....................%.............%%%..........................%%........%%%%%...........%.................................
m %%%............%%%%%%%%%.........%%........%......%%.........%%%%%%........%%%.................%%%%%.......................%...............%%%........................%.........%%................%%%%%%
m .%%.............%%%..............%%........%%................%..%%%%........%%...............%%%%%%%%%.....................%%..............%%........................%%.........%.................%%%%%%
m ..%%.............................%%........%%%..............%%...............%............%%%%%.....%%.....................%%...........%%%%%........................%%........%%.......................
m ...%%............................%%.........%%.............%%................%%.........%%%%%.......%%......................%...........%...%%%...................%%%%.........%%.......................
m ....%%............................%%.........%.............%.................%%.........%%%.........%%......................%.................%%%................%%%%%........%%........................
m .....%%.......%%%.........%%.................%....1.....%%%%.................%%.....................%%.....................%%..................%%..............%%%%.%%.........%...........%............
m ......%%.....%%%%%%.......%%.................%.........%%%%%%........%..............................%%.....................%%%..................%%...........%%%%....%.........%%%%.......%%............
m .......%%%%%%%..%%%%%....%%..................%........%%...%%%......%%...............................%%...................%%%%%.................%%........%%%%%......%.........%%%%%%%%%%%%%............
m ...................%%%%%%%%..................%%.......%.....%%%.....%%................................%%%................%%..%%%.........................%%..........%........%%.......%%%%.............
m .....................%%%%%%%.................%%......%%......%%%...%%.....................%%............%%...%%%.........%%...%%%.......................%%...........%......%%%%..........%%............
m ......................%%..%%........%%.......%%%%%%%%%........%%%.%%%.....................%%%%...........%%%%%%%%........%%.....%%......................%............%%...%%%%%............%............
m ......................%%...%%.......%%........%%%..............%%%%.........................%%%..........%%.....%%.......%%......%%%.%%%................%..........%%%%%%%%%...............%............
m .....................%%.....%%.....%%.........%%...............%%.............................%%.........%.......%%.......%.......%%%%%.................%%.......%%%%%%%%%.................%%...........
m .....................%%......%%....%%.........%................%%.............................%%........%%.......%%.......%........%%........%..........%%%......%.....%...................%%%%.........
m ...........3........%%.......%%%%%%%..........%...............%%...............................%........%........%%.......%%.......%.........%...........%%%.................................%%%%%%%%...
m ....................%%........%%%%%...........%................................................%%......%%........%%........%.......%.........%%...........%%%....................%.............%%%......
m ...%...............%%%........................%.........%%................%%%%%%%%%............%%%%%%%%%.........%%........%......%%.........%%%%%%........%%%.................%%%%%....................
m ...%%..............%%........................%%.........%.................%%%%%%.%%.............%%%..............%%........%%................%..%%%%........%%...............%%%%%%%%%..................
m ...%%...........%%%%%........................%%........%%.........................%%.............................%%........%%%..............%%...............%............%%%%%.....%%..................
m ....%...........%...%%%...................%%%%.........%%..........................%%............................%%.........%%.............%%................%%.........%%%%%.......%%..................
m ....%.................%%%................%%%%%........%%............................%%............................%%.........%.............%.................%%.........%%%.........%%..................
m ...%%..................%%..............%%%%.%%.........%...........%.................%%.......%%%.........%%.................%....3.....%%%%.................%%.....................%%..................
m ...%%%..................%%...........%%%%....%.........%%%%.......%%..................%%.....%%%%%%.......%%.................%.........%%%%%%........%..............................%%..................
m ..%%%%%.................%%........%%%%%......%.........%%%%%%%%%%%%%...................%%%%%%%..%%%%%....%%..................%........%%...%%%......%%...............................%%.................
m .%%..%%%.........................%%..........%........%%.......%%%%................................%%%%%%%%..................%%.......%.....%%%.....%%................................%%%...............
m .%%...%%%.......................%%...........%......%%%%..........%%.................................%%%%%%%.................%%......%%......%%%...%%.....................%%............%%...%%%........
m .%%.....%%......................%............%%...%%%%%............%..................................%%..%%........%%.......%%%%%%%%%........%%%.%%%.....................%%%%...........%%%%%%%%.......
m .%%......%%%.%%%................%..........%%%%%%%%%...............%..................................%%...%%.......%%........%%%..............%%%%.........................%%%..........%%.....%%......
m ..%.......%%%%%.................%%.......%%%%%%%%%.................%%................................%%.....%%.....%%.........%%...............%%.............................%%.........%.......%%.....
m ..%........%%........%..........%%%......%.....%...................%%%%..............................%%......%%....%%.........%................%%.............................%%........%%.......%%.....
m ..%%.......%.........%...........%%%.................................%%%%%%%%..............0........%%.......%%%%%%%..........%...............%%...............................%........%........%%.....
m ...%.......%.........%%...........%%%....................%.............%%%..........................%%........%%%%%...........%................................................%%......%%........%%.....
m ...%......%%.........%%%%%%........%%%.................%%%%%.......................%...............%%%........................%.........%%................%%%%%%%%%............%%%%%%%%%.........%%.....
m ...%%................%..%%%%........%%...............%%%%%%%%%.....................%%..............%%........................%%.........%.................%%%%%%.%%.............%%%..............%%.....
m ...%%%..............%%...............%............%%%%%.....%%.....................%%...........%%%%%........................%%........%%.........................%%.............................%%.....
m ....%%.............%%................%%.........%%%%%.......%%......................%...........%...%%%...................%%%%.........%%..........................%%............................%%.....
m .....%.............%.................%%.........%%%.........%%......................%.................%%%................%%%%%........%%............................%%............................%%....
m .....%....0.....%%%%.................%%.....................%%.....................%%..................%%..............%%%%.%%.........%...........%.................%%.......%%%.........%%............
m .....%.........%%%%%%........%..............................%%.....................%%%..................%%...........%%%%....%.........%%%%.......%%..................%%.....%%%%%%.......%%............
m .....%........%%...%%%......%%...............................%%...................%%%%%.................%%........%%%%%......%.........%%%%%%%%%%%%%...................%%%%%%%..%%%%%....%%.............
m .....%%.......%.....%%%.....%%................................%%%................%%..%%%.........................%%..........%........%%.......%%%%................................%%%%%%%%.............
m .....%%......%%......%%%...%%.....................%%............%%...%%%.........%%...%%%.......................%%...........%......%%%%..........%%.................................%%%%%%%............
m .....%%%%%%%%%........%%%.%%%.....................%%%%...........%%%%%%%%........%%.....%%......................%............%%...%%%%%............%..................................%%..%%........%%..
m ......%%%..............%%%%.........................%%%..........%%.....%%.......%%......%%%.%%%................%..........%%%%%%%%%...............%..................................%%...%%.......%%..
m ......%%...............%%.............................%%.........%.......%%.......%.......%%%%%.................%%.......%%%%%%%%%.................%%................................%%.....%%.....%%...
m ......%................%%.............................%%........%%.......%%.......%........%%........%..........%%%......%.....%...................%%%%..............................%%......%%....%%...
m ......%...............%%...............................%........%........%%.......%%.......%.........%...........%%%.................................%%%%%%%%..............2........%%.......%%%%%%%....
m ......%................................................%%......%%........%%........%.......%.........%%...........%%%....................%.............%%%..........................%%........%%%%%.....
m ......%.........%%................%%%%%%%%%............%%%%%%%%%.........%%........%......%%.........%%%%%%........%%%.................%%%%%.......................%...............%%%..................
m .....%%.........%.................%%%%%%.%%.............%%%..............%%........%%................%..%%%%........%%...............%%%%%%%%%.....................%%..............%%...................
m .....%%........%%.........................%%.............................%%........%%%..............%%...............%............%%%%%.....%%.....................%%...........%%%%%...................
m ..%%%%.........%%..........................%%............................%%.........%%.............%%................%%.........%%%%%.......%%......................%...........%...%%%.................
m .%%%%%........%%............................%%............................%%.........%.............%.................%%.........%%%.........%%......................%.................%%%...............
m %%%.%%.........%...........%.................%%.......%%%.........%%.................%....2.....%%%%.................%%.....................%%.....................%%..................%%..............%
m %....%.........%%%%.......%%..................%%.....%%%%%%.......%%.................%.........%%%%%%........%..............................%%.....................%%%..................%%...........%%%
m .....%.........%%%%%%%%%%%%%...................%%%%%%%..%%%%%....%%..................%........%%...%%%......%%...............................%%...................%%%%%.................%%........%%%%%.
m .....%........%%.......%%%%................................%%%%%%%%..................%%.......%.....%%%.....%%................................%%%................%%..%%%.........................%%.....
m .....%......%%%%..........%%.................................%%%%%%%.................%%......%%......%%%...%%.....................%%............%%...%%%.........%%...%%%.......................%%......
m .....%%...%%%%%............%..................................%%..%%........%%.......%%%%%%%%%........%%%.%%%.....................%%%%...........%%%%%%%%........%%.....%%......................%.......
m ...%%%%%%%%%...............%..................................%%...%%.......%%........%%%..............%%%%.........................%%%..........%%.....%%.......%%......%%%.%%%................%.......
m .%%%%%%%%%.................%%................................%%.....%%.....%%.........%%...............%%.............................%%.........%.......%%.......%.......%%%%%.................%%......
m .%.....%...................%%%%..............................%%......%%....%%.........%................%%.............................%%........%%.......%%.......%........%%........%..........%%%.....
m .............................%%%%%%%%..............4........%%.......%%%%%%%..........%...............%%...............................%........%........%%.......%%.......%.........%...........%%%....
m .................%.............%%%..........................%%........%%%%%...........%................................................%%......%%........%%........%.......%.........%%...........%%%...
m ...............%%%%%.......................%...............%%%........................%.........%%................%%%%%%%%%............%%%%%%%%%.........%%........%......%%.........%%%%%%........%%%..
m .............%%%%%%%%%.....................%%..............%%........................%%.........%.................%%%%%%.%%.............%%%..............%%........%%................%..%%%%........%%..
m ..........%%%%%.....%%.....................%%...........%%%%%........................%%........%%.........................%%.............................%%........%%%..............%%...............%..
m ........%%%%%.......%%......................%...........%...%%%...................%%%%.........%%..........................%%............................%%.........%%.............%%................%%.
m ........%%%.........%%......................%.................%%%................%%%%%........%%............................%%............................%%.........%.............%.................%%.
m ....................%%.....................%%..................%%..............%%%%.%%.........%...........%.................%%.......%%%.........%%.................%....4.....%%%%.................%%.
m ....................%%.....................%%%..................%%...........%%%%....%.........%%%%.......%%..................%%.....%%%%%%.......%%.................%.........%%%%%%........%..........
m .....................%%...................%%%%%.................%%........%%%%%......%.........%%%%%%%%%%%%%...................%%%%%%%..%%%%%....%%..................%........%%...%%%......%%..........
m ......................%%%................%%..%%%.........................%%..........%........%%.......%%%%................................%%%%%%%%..................%%.......%.....%%%.....%%..........
m ..........%%............%%...%%%.........%%...%%%.......................%%...........%......%%%%..........%%.................................%%%%%%%.................%%......%%......%%%...%%...........
m ..........%%%%...........%%%%%%%%........%%.....%%......................%............%%...%%%%%............%..................................%%..%%........%%.......%%%%%%%%%........%%%.%%%...........
