# random seed -7642162493488272845
# players 7
# area 15764
# cell width: 2.59135387607
# cell size: 8
# openness: 0.0670478456235
# grid size: (1, 7)
# tile size: (91, 24) 0.263736263736
# map size: (91, 168) 1.84615384615
# horz shear step: 5
# horz_shear
# maze type recursive backtracker
# final openness 0.0670478456235
# map_type cell_maze
# random_seed -7642162493488272845
players 7
rows 91
cols 168
m .......%%%.........%%%%%%%%%%%%...%%%%.........%%%%%%..%%%......%%%%%...............%%%......%%%%%%%%%.%%%%%%.......%%%%%.............................%%%.....%%%%......
m ..4....%%%........%%%%.............%%%........%%%%%.....%%%%%%%%%%%%...............%%%.....%%%%%%%%%%%%%%%%%.........%%%%.............................%%%......%%%%.....
m .......%%%.......%%%%...............%%%.......%%%%.......%%%%%%%%%%%..............%%%......%%%%%....%%%%%%%%.........%%%%.............................%%%.......%%%%%%..
m .......%%%......%%%%.................%%%.....%%%%........%%%%%%%%%%%.............%%%........%.......%%%..............%%%%..........%..................%%........%%%%%%..
m ...............%%%%..................%%%%....%%%................%%%%............%%%%................%%%.............%%%%.........%%%%.................%%........%%%.....
m .............%%%%%....................%%%%..%%%%................%%%.............%%%.................%%%............%%%.........%%%%%%................%%%.......%%%......
m .%%%.........%%%%.....................%%%%%%%%%%................%%%.............%%%.................%%%.......%%%%%%%........%%%%%%........%........%%%%.......%%%......
m .%%%.........%%%......................%%%%%%%%%................%%%..............%%%.................%%%.......%%%%%%.........%%%%.........%%%.....%%%%%%......%%%.......
m .%%%.........%%%%..........%%%%%....%%%%%%%%%%%%...............%%%...........%%%%%%.................%%%......................%%...........%%%...%%%%%%........%%%.......
m .%%%........%%%%%%%.......%%%%%%%%%%%%%%.....%%%....%%%........%%%......%%%%%%%%%%........%%%.......%%%......................%%............%%%%%%%%%.........%%%........
m .%%%........%%%%%%%%....%%%%%%%%%%%%%%.........%....%%%%......%%%.......%%%%%%%%%%........%%%.......%%%.....................%%%%...........%%%%%%%%..........%%%........
m .%%%.......%%%...%%%%%%.%%%%....%%%%%................%%%%.....%%%............%%%%%.........%%%%%%%%%%%%....................%%%%%...........%%%%%%%...........%%.........
m %%%%%.....%%%.....%%%%%%%%............................%%%....%%%%..............%%%..........%%%%%%%%%%%...%%%............%%%%%%%%..........%%%..............%%%%........
m %%%%%%.%%%%%%.......%%%%%.............................%%%.....%%%%.............%%%.........%%%%%%%%%%%%...%%%%.........%%%%%%..%%%......%%%%%...............%%%......%%%
m %%%%%%%%%%%%.........%%%%.............................%%%......%%%%.......1....%%%........%%%%.............%%%........%%%%%.....%%%%%%%%%%%%...............%%%.....%%%%%
m ....%%%%%%%%.........%%%%.............................%%%.......%%%%%%.........%%%.......%%%%...............%%%.......%%%%.......%%%%%%%%%%%..............%%%......%%%%%
m ....%%%..............%%%%..........%..................%%........%%%%%%.........%%%......%%%%.................%%%.....%%%%........%%%%%%%%%%%.............%%%........%...
m ....%%%.............%%%%.........%%%%.................%%........%%%....................%%%%..................%%%%....%%%................%%%%............%%%%............
m ....%%%............%%%.........%%%%%%................%%%.......%%%...................%%%%%....................%%%%..%%%%................%%%.............%%%.............
m ....%%%.......%%%%%%%........%%%%%%........%........%%%%.......%%%.......%%%.........%%%%.....................%%%%%%%%%%................%%%.............%%%.............
m ....%%%.......%%%%%%.........%%%%.........%%%.....%%%%%%......%%%........%%%.........%%%......................%%%%%%%%%................%%%..............%%%.............
m ....%%%......................%%...........%%%...%%%%%%........%%%........%%%.........%%%%..........%%%%%....%%%%%%%%%%%%...............%%%...........%%%%%%.............
m ....%%%......................%%............%%%%%%%%%.........%%%.........%%%........%%%%%%%.......%%%%%%%%%%%%%%.....%%%....%%%........%%%......%%%%%%%%%%........%%%...
m ....%%%.....................%%%%...........%%%%%%%%..........%%%.........%%%........%%%%%%%%....%%%%%%%%%%%%%%.........%....%%%%......%%%.......%%%%%%%%%%........%%%...
m %%%%%%%....................%%%%%...........%%%%%%%...........%%..........%%%.......%%%...%%%%%%.%%%%....%%%%%................%%%%.....%%%............%%%%%.........%%%%%
m %%%%%%%...%%%............%%%%%%%%..........%%%..............%%%%........%%%%%.....%%%.....%%%%%%%%............................%%%....%%%%..............%%%..........%%%%
m %%%%%%%...%%%%.........%%%%%%..%%%......%%%%%...............%%%......%%%%%%%%%.%%%%%%.......%%%%%.............................%%%.....%%%%.............%%%.........%%%%%
m ...........%%%........%%%%%.....%%%%%%%%%%%%...............%%%.....%%%%%%%%%%%%%%%%%.........%%%%.............................%%%......%%%%.......3....%%%........%%%%..
m ............%%%.......%%%%.......%%%%%%%%%%%..............%%%......%%%%%....%%%%%%%%.........%%%%.............................%%%.......%%%%%%.........%%%.......%%%%...
m .............%%%.....%%%%........%%%%%%%%%%%.............%%%........%.......%%%..............%%%%..........%..................%%........%%%%%%.........%%%......%%%%....
m .............%%%%....%%%................%%%%............%%%%................%%%.............%%%%.........%%%%.................%%........%%%....................%%%%.....
m ..............%%%%..%%%%................%%%.............%%%.................%%%............%%%.........%%%%%%................%%%.......%%%...................%%%%%......
m ..............%%%%%%%%%%................%%%.............%%%.................%%%.......%%%%%%%........%%%%%%........%........%%%%.......%%%.......%%%.........%%%%.......
m ..............%%%%%%%%%................%%%..............%%%.................%%%.......%%%%%%.........%%%%.........%%%.....%%%%%%......%%%........%%%.........%%%........
m ...%%%%%....%%%%%%%%%%%%...............%%%...........%%%%%%.................%%%......................%%...........%%%...%%%%%%........%%%........%%%.........%%%%.......
m ..%%%%%%%%%%%%%%.....%%%....%%%........%%%......%%%%%%%%%%........%%%.......%%%......................%%............%%%%%%%%%.........%%%.........%%%........%%%%%%%.....
m %%%%%%%%%%%%%%.........%....%%%%......%%%.......%%%%%%%%%%........%%%.......%%%.....................%%%%...........%%%%%%%%..........%%%.........%%%........%%%%%%%%....
m %%%%....%%%%%................%%%%.....%%%............%%%%%.........%%%%%%%%%%%%....................%%%%%...........%%%%%%%...........%%..........%%%.......%%%...%%%%%%.
m %%............................%%%....%%%%..............%%%..........%%%%%%%%%%%...%%%............%%%%%%%%..........%%%..............%%%%........%%%%%.....%%%.....%%%%%%
m %.............................%%%.....%%%%.............%%%.........%%%%%%%%%%%%...%%%%.........%%%%%%..%%%......%%%%%...............%%%......%%%%%%%%%.%%%%%%.......%%%%
m %.............................%%%......%%%%.......6....%%%........%%%%.............%%%........%%%%%.....%%%%%%%%%%%%...............%%%.....%%%%%%%%%%%%%%%%%.........%%%
m %.............................%%%.......%%%%%%.........%%%.......%%%%...............%%%.......%%%%.......%%%%%%%%%%%..............%%%......%%%%%....%%%%%%%%.........%%%
m %..........%..................%%........%%%%%%.........%%%......%%%%.................%%%.....%%%%........%%%%%%%%%%%.............%%%........%.......%%%..............%%%
m .........%%%%.................%%........%%%....................%%%%..................%%%%....%%%................%%%%............%%%%................%%%.............%%%%
m .......%%%%%%................%%%.......%%%...................%%%%%....................%%%%..%%%%................%%%.............%%%.................%%%............%%%..
m .....%%%%%%........%........%%%%.......%%%.......%%%.........%%%%.....................%%%%%%%%%%................%%%.............%%%.................%%%.......%%%%%%%...
m .....%%%%.........%%%.....%%%%%%......%%%........%%%.........%%%......................%%%%%%%%%................%%%..............%%%.................%%%.......%%%%%%....
m .....%%...........%%%...%%%%%%........%%%........%%%.........%%%%..........%%%%%....%%%%%%%%%%%%...............%%%...........%%%%%%.................%%%.................
m .....%%............%%%%%%%%%.........%%%.........%%%........%%%%%%%.......%%%%%%%%%%%%%%.....%%%....%%%........%%%......%%%%%%%%%%........%%%.......%%%.................
m ....%%%%...........%%%%%%%%..........%%%.........%%%........%%%%%%%%....%%%%%%%%%%%%%%.........%....%%%%......%%%.......%%%%%%%%%%........%%%.......%%%.................
m ...%%%%%...........%%%%%%%...........%%..........%%%.......%%%...%%%%%%.%%%%....%%%%%................%%%%.....%%%............%%%%%.........%%%%%%%%%%%%.................
m .%%%%%%%%..........%%%..............%%%%........%%%%%.....%%%.....%%%%%%%%............................%%%....%%%%..............%%%..........%%%%%%%%%%%...%%%...........
m %%%%%..%%%......%%%%%...............%%%......%%%%%%%%%.%%%%%%.......%%%%%.............................%%%.....%%%%.............%%%.........%%%%%%%%%%%%...%%%%.........%
m %%%.....%%%%%%%%%%%%...............%%%.....%%%%%%%%%%%%%%%%%.........%%%%.............................%%%......%%%%.......0....%%%........%%%%.............%%%........%%
m %%.......%%%%%%%%%%%..............%%%......%%%%%....%%%%%%%%.........%%%%.............................%%%.......%%%%%%.........%%%.......%%%%...............%%%.......%%
m %........%%%%%%%%%%%.............%%%........%.......%%%..............%%%%..........%..................%%........%%%%%%.........%%%......%%%%.................%%%.....%%%
m ................%%%%............%%%%................%%%.............%%%%.........%%%%.................%%........%%%....................%%%%..................%%%%....%%%
m ................%%%.............%%%.................%%%............%%%.........%%%%%%................%%%.......%%%...................%%%%%....................%%%%..%%%%
m ................%%%.............%%%.................%%%.......%%%%%%%........%%%%%%........%........%%%%.......%%%.......%%%.........%%%%.....................%%%%%%%%%%
m ...............%%%..............%%%.................%%%.......%%%%%%.........%%%%.........%%%.....%%%%%%......%%%........%%%.........%%%......................%%%%%%%%%.
m ...............%%%...........%%%%%%.................%%%......................%%...........%%%...%%%%%%........%%%........%%%.........%%%%..........%%%%%....%%%%%%%%%%%%
m ....%%%........%%%......%%%%%%%%%%........%%%.......%%%......................%%............%%%%%%%%%.........%%%.........%%%........%%%%%%%.......%%%%%%%%%%%%%%.....%%%
m ....%%%%......%%%.......%%%%%%%%%%........%%%.......%%%.....................%%%%...........%%%%%%%%..........%%%.........%%%........%%%%%%%%....%%%%%%%%%%%%%%.........%
m .....%%%%.....%%%............%%%%%.........%%%%%%%%%%%%....................%%%%%...........%%%%%%%...........%%..........%%%.......%%%...%%%%%%.%%%%....%%%%%...........
m ......%%%....%%%%..............%%%..........%%%%%%%%%%%...%%%............%%%%%%%%..........%%%..............%%%%........%%%%%.....%%%.....%%%%%%%%......................
m ......%%%.....%%%%.............%%%.........%%%%%%%%%%%%...%%%%.........%%%%%%..%%%......%%%%%...............%%%......%%%%%%%%%.%%%%%%.......%%%%%.......................
m ......%%%......%%%%.......5....%%%........%%%%.............%%%........%%%%%.....%%%%%%%%%%%%...............%%%.....%%%%%%%%%%%%%%%%%.........%%%%.......................
m ......%%%.......%%%%%%.........%%%.......%%%%...............%%%.......%%%%.......%%%%%%%%%%%..............%%%......%%%%%....%%%%%%%%.........%%%%.......................
m ......%%........%%%%%%.........%%%......%%%%.................%%%.....%%%%........%%%%%%%%%%%.............%%%........%.......%%%..............%%%%..........%............
m ......%%........%%%....................%%%%..................%%%%....%%%................%%%%............%%%%................%%%.............%%%%.........%%%%...........
m .....%%%.......%%%...................%%%%%....................%%%%..%%%%................%%%.............%%%.................%%%............%%%.........%%%%%%...........
m ....%%%%.......%%%.......%%%.........%%%%.....................%%%%%%%%%%................%%%.............%%%.................%%%.......%%%%%%%........%%%%%%........%....
m ..%%%%%%......%%%........%%%.........%%%......................%%%%%%%%%................%%%..............%%%.................%%%.......%%%%%%.........%%%%.........%%%...
m %%%%%%........%%%........%%%.........%%%%..........%%%%%....%%%%%%%%%%%%...............%%%...........%%%%%%.................%%%......................%%...........%%%...
m %%%%.........%%%.........%%%........%%%%%%%.......%%%%%%%%%%%%%%.....%%%....%%%........%%%......%%%%%%%%%%........%%%.......%%%......................%%............%%%%%
m %%%..........%%%.........%%%........%%%%%%%%....%%%%%%%%%%%%%%.........%....%%%%......%%%.......%%%%%%%%%%........%%%.......%%%.....................%%%%...........%%%%%
m %%...........%%..........%%%.......%%%...%%%%%%.%%%%....%%%%%................%%%%.....%%%............%%%%%.........%%%%%%%%%%%%....................%%%%%...........%%%%%
m ............%%%%........%%%%%.....%%%.....%%%%%%%%............................%%%....%%%%..............%%%..........%%%%%%%%%%%...%%%............%%%%%%%%..........%%%..
m ............%%%......%%%%%%%%%.%%%%%%.......%%%%%.............................%%%.....%%%%.............%%%.........%%%%%%%%%%%%...%%%%.........%%%%%%..%%%......%%%%%...
m ...........%%%.....%%%%%%%%%%%%%%%%%.........%%%%.............................%%%......%%%%.......2....%%%........%%%%.............%%%........%%%%%.....%%%%%%%%%%%%....
m ..........%%%......%%%%%....%%%%%%%%.........%%%%.............................%%%.......%%%%%%.........%%%.......%%%%...............%%%.......%%%%.......%%%%%%%%%%%....
m .........%%%........%.......%%%..............%%%%..........%..................%%........%%%%%%.........%%%......%%%%.................%%%.....%%%%........%%%%%%%%%%%....
m ........%%%%................%%%.............%%%%.........%%%%.................%%........%%%....................%%%%..................%%%%....%%%................%%%%....
m ........%%%.................%%%............%%%.........%%%%%%................%%%.......%%%...................%%%%%....................%%%%..%%%%................%%%.....
m ........%%%.................%%%.......%%%%%%%........%%%%%%........%........%%%%.......%%%.......%%%.........%%%%.....................%%%%%%%%%%................%%%.....
m ........%%%.................%%%.......%%%%%%.........%%%%.........%%%.....%%%%%%......%%%........%%%.........%%%......................%%%%%%%%%................%%%......
m .....%%%%%%.................%%%......................%%...........%%%...%%%%%%........%%%........%%%.........%%%%..........%%%%%....%%%%%%%%%%%%...............%%%......
m %%%%%%%%%%........%%%.......%%%......................%%............%%%%%%%%%.........%%%.........%%%........%%%%%%%.......%%%%%%%%%%%%%%.....%%%....%%%........%%%......
m %%%%%%%%%%........%%%.......%%%.....................%%%%...........%%%%%%%%..........%%%.........%%%........%%%%%%%%....%%%%%%%%%%%%%%.........%....%%%%......%%%.......
m .....%%%%%.........%%%%%%%%%%%%....................%%%%%...........%%%%%%%...........%%..........%%%.......%%%...%%%%%%.%%%%....%%%%%................%%%%.....%%%.......
m .......%%%..........%%%%%%%%%%%...%%%............%%%%%%%%..........%%%..............%%%%........%%%%%.....%%%.....%%%%%%%%............................%%%....%%%%.......
