# map type: cell maze
# random seed: -964880585
# players 6
# area 7746, 1291 (35.9^2) per player
# cell width: 1.07119355427
# cell size: 7.1171789356
# openness: 0.37177526913
# maze type prims
# horz_rotate
# horz_copy
# final parameters
# area: 6804
# grid size: (1, 6)
# tile size: (42, 27) 0.642857142857
# map size: (42, 162) 3.85714285714
# hill distance  12,114  12, 60  29,101  29, 47  12,  6  29,155
#        12,114       0      70      30      84      70      66 
#        12, 60      70       0      66      30      70      84 
#        29,101      30      66       0      70      84      70 
#        29, 47      84      30      70       0      66      70 
#        12,  6      70      70      84      66       0      30 
#        29,155      66      84      70      70      30       0 
players 6
rows 42
cols 162
m ........%%...........%%....................%%.................%%...........%%....................%%.................%%...........%%....................%%.........
m ......%%.%%%..........%%%..................%................%%.%%%..........%%%..................%................%%.%%%..........%%%..................%..........
m ......%%...%%..........%%.................%.................%%...%%..........%%.................%.................%%...%%..........%%.................%...........
m ......%%.....%..........%................%..................%%.....%..........%................%..................%%.....%..........%................%............
m ......%%......%%........%..........%....%%..................%%......%%........%..........%....%%..................%%......%%........%..........%....%%............
m ......%%.......%%.......%..........%........................%%.......%%.......%..........%........................%%.......%%.......%..........%..................
m ......%%........%.......%%........%.........................%%........%.......%%........%.........................%%........%.......%%........%...................
m ......%%.......%.........%........%.........................%%.......%.........%........%.........................%%.......%.........%........%...................
m ...............%.........%........%..................................%.........%........%..................................%.........%........%...................
m .........................%.......%.............................................%.......%.............................................%.......%....................
m .........................%%......%.............................................%%......%.............................................%%......%....................
m %%.........%.............%.......%..............%%%%%%%%.........%.............%.......%..............%%%%%%%%.........%.............%.......%..............%%%%%%
m ......0....%............%........%%..........%%%............2....%............%........%%..........%%%............3....%............%........%%..........%%%......
m ..........%..........%%%..........%%........%%..................%..........%%%..........%%........%%..................%..........%%%..........%%........%%........
m ..........%........................%............................%........................%............................%........................%..................
m ..........%........................%............................%........................%............................%........................%..................
m ..........%........................%............................%........................%............................%........................%..................
m ..........%%.......................%............................%%.......................%............................%%.......................%..................
m .....%%%%%.%%%%............................................%%%%%.%%%%............................................%%%%%.%%%%.......................................
m ..................................................................................................................................................................
m ..................................................................................................................................................................
m ..................................................................................................................................................................
m ..................................................................................................................................................................
m .......................................%%%%.%%%%%............................................%%%%.%%%%%............................................%%%%.%%%%%.....
m ..................%.......................%%............................%.......................%%............................%.......................%%..........
m ..................%........................%............................%........................%............................%........................%..........
m ..................%........................%............................%........................%............................%........................%..........
m ..................%........................%............................%........................%............................%........................%..........
m ........%%........%%..........%%%..........%..................%%........%%..........%%%..........%..................%%........%%..........%%%..........%..........
m ......%%%..........%%........%............%....1............%%%..........%%........%............%....4............%%%..........%%........%............%....5......
m %%%%%%..............%.......%.............%.........%%%%%%%%..............%.......%.............%.........%%%%%%%%..............%.......%.............%.........%%
m ....................%......%%.............................................%......%%.............................................%......%%.........................
m ....................%.......%.............................................%.......%.............................................%.......%.........................
m ...................%........%.........%..................................%........%.........%..................................%........%.........%...............
m ...................%........%.........%.......%%.........................%........%.........%.......%%.........................%........%.........%.......%%......
m ...................%........%%.......%........%%.........................%........%%.......%........%%.........................%........%%.......%........%%......
m ..................%..........%.......%%.......%%........................%..........%.......%%.......%%........................%..........%.......%%.......%%......
m ............%%....%..........%........%%......%%..................%%....%..........%........%%......%%..................%%....%..........%........%%......%%......
m ............%................%..........%.....%%..................%................%..........%.....%%..................%................%..........%.....%%......
m ...........%.................%%..........%%...%%.................%.................%%..........%%...%%.................%.................%%..........%%...%%......
m ..........%..................%%%..........%%%.%%................%..................%%%..........%%%.%%................%..................%%%..........%%%.%%......
m .........%%....................%%...........%%.................%%....................%%...........%%.................%%....................%%...........%%........
