# map type: cell maze
# random seed: 2048919981
# players 4
# area 9637, 2409 (49.1^2) per player
# cell width: 1.16892691169
# cell size: 7.36567286521
# openness: 0.165891985821
# maze type growing
# horz shear step: 3
# horz_shear
# final parameters
# area: 9216
# grid size: (1, 4)
# tile size: (128, 18) 0.140625
# map size: (128, 72) 0.5625
# hill distance  44, 18  62,114   8, 82  26, 50
#        44, 18       0      76     100      76 
#        62,114      76       0      76     100 
#         8, 82     100      76       0      76 
#        26, 50      76     100      76       0 
players 4
rows 72
cols 128
m %.....................%%........%%.....%%........%.........%%...............%.....................%........%......%%...........%
m %.....................%%.........%....%%..........%......%%%................%.....................%%.......%.......%............
m %%....................%%.........%....%..........%%%%...%%..................%%%%...................%%.....%%.......%............
m .%.....................%........%%..............%%%.%%%%%..........%.........%%%%%%%................%%.....%%......%%...........
m .%.....................%.......%%..............%%%....%%...........%...............%%%%%%%...........%......%%.....%%...........
m .%.....................%.......%%.............%%......%%...........%...................%%%..........%%.......%%....%%%..........
m .%...........%.........%........%............%%........%...........%.....................%%%........%%........%%...%%%%.........
m ..%...........%%................%...........%%.........%..........%%......................%%%.......%.........%%%%%%..%%........
m ..%%............%%%..............%........%%%..........%..........%%..............0.........%%%.....%..........%%.......%.......
m ...%%%%..........%%..............%........%%...........%..........%...........................%%%...%..........%................
m ......%%.........%...............%%......%%............%..........%.............................%%%%%%........%.................
m .......%.........%................%.....................%.........%...................%%.........%%...%%.....%%.................
m .......%%........%.......................................%........%.........%%........%%................%%%..%..................
m ........%........%................................................%.........%%.........%%.................%%%%..................
m ........%........%................................................%.........%....%%.....%%.................%%...................
m ........%%.......%................................................%.........%....%%......%%................%%............%%%%%..
m %........%......%%...........%..............%%....................%........%%.....%.......%%%%%%...........%............%...%%%%
m %.......%%......%%..........%%%.............%.....................%........%......%...........%%.......................%........
m %%.....%%........%.........%%...............%.....................%........%......%%...........%%.....................%%........
m .%....%%..........%......%%%................%.....................%%.......%.......%............%.....................%%........
m .%....%..........%%%%...%%..................%%%%...................%%.....%%.......%............%%....................%%........
m %%..............%%%.%%%%%..........%.........%%%%%%%................%%.....%%......%%............%.....................%........
m %..............%%%....%%...........%...............%%%%%%%...........%......%%.....%%............%.....................%.......%
m %.............%%......%%...........%...................%%%..........%%.......%%....%%%...........%.....................%.......%
m %............%%........%...........%.....................%%%........%%........%%...%%%%..........%...........%.........%........
m %...........%%.........%..........%%......................%%%.......%.........%%%%%%..%%..........%...........%%................
m .%........%%%..........%..........%%..............1.........%%%.....%..........%%.......%.........%%............%%%.............
m .%........%%...........%..........%...........................%%%...%..........%...................%%%%..........%%.............
m .%%......%%............%..........%.............................%%%%%%........%.......................%%.........%..............
m ..%.....................%.........%...................%%.........%%...%%.....%%........................%.........%..............
m .........................%........%.........%%........%%................%%%..%.........................%%........%..............
m ..................................%.........%%.........%%.................%%%%..........................%........%..............
m ..................................%.........%....%%.....%%.................%%...........................%........%..............
m ..................................%.........%....%%......%%................%%............%%%%%..........%%.......%..............
m ............%%....................%........%%.....%.......%%%%%%...........%............%...%%%%%........%......%%...........%..
m ............%.....................%........%......%...........%%.......................%........%.......%%......%%..........%%%.
m ............%.....................%........%......%%...........%%.....................%%........%%.....%%........%.........%%...
m ............%.....................%%.......%.......%............%.....................%%.........%....%%..........%......%%%....
m ............%%%%...................%%.....%%.......%............%%....................%%.........%....%..........%%%%...%%......
m ...%.........%%%%%%%................%%.....%%......%%............%.....................%........%%..............%%%.%%%%%.......
m ...%...............%%%%%%%...........%......%%.....%%............%.....................%.......%%..............%%%....%%........
m ...%...................%%%..........%%.......%%....%%%...........%.....................%.......%%.............%%......%%........
m ...%.....................%%%........%%........%%...%%%%..........%...........%.........%........%............%%........%........
m ..%%......................%%%.......%.........%%%%%%..%%..........%...........%%................%...........%%.........%........
m ..%%..............2.........%%%.....%..........%%.......%.........%%............%%%..............%........%%%..........%........
m ..%...........................%%%...%..........%...................%%%%..........%%..............%........%%...........%........
m ..%.............................%%%%%%........%.......................%%.........%...............%%......%%............%........
m ..%...................%%.........%%...%%.....%%........................%.........%................%.....................%.......
m ..%.........%%........%%................%%%..%.........................%%........%.......................................%......
m ..%.........%%.........%%.................%%%%..........................%........%..............................................
m ..%.........%....%%.....%%.................%%...........................%........%..............................................
m ..%.........%....%%......%%................%%............%%%%%..........%%.......%..............................................
m ..%........%%.....%.......%%%%%%...........%............%...%%%%%........%......%%...........%..............%%..................
m ..%........%......%...........%%.......................%........%.......%%......%%..........%%%.............%...................
m ..%........%......%%...........%%.....................%%........%%.....%%........%.........%%...............%...................
m ..%%.......%.......%............%.....................%%.........%....%%..........%......%%%................%...................
m ...%%.....%%.......%............%%....................%%.........%....%..........%%%%...%%..................%%%%................
m ....%%.....%%......%%............%.....................%........%%..............%%%.%%%%%..........%.........%%%%%%%............
m .....%......%%.....%%............%.....................%.......%%..............%%%....%%...........%...............%%%%%%%......
m ....%%.......%%....%%%...........%.....................%.......%%.............%%......%%...........%...................%%%......
m ....%%........%%...%%%%..........%...........%.........%........%............%%........%...........%.....................%%%....
m ....%.........%%%%%%..%%..........%...........%%................%...........%%.........%..........%%......................%%%...
m ....%..........%%.......%.........%%............%%%..............%........%%%..........%..........%%..............3.........%%%.
m %...%..........%...................%%%%..........%%..............%........%%...........%..........%...........................%%
m %%%%%%........%.......................%%.........%...............%%......%%............%..........%.............................
m .%%...%%.....%%........................%.........%................%.....................%.........%...................%%........
m ........%%%..%.........................%%........%.......................................%........%.........%%........%%........
m ..........%%%%..........................%........%................................................%.........%%.........%%.......
m ...........%%...........................%........%................................................%.........%....%%.....%%......
m ...........%%............%%%%%..........%%.......%................................................%.........%....%%......%%.....
m ...........%............%...%%%%%........%......%%...........%..............%%....................%........%%.....%.......%%%%%%
m .......................%........%.......%%......%%..........%%%.............%.....................%........%......%...........%%
