# random seed 5888921303366391504
# players 5
# area 23330
# cell width: 1.76936338398
# cell size: 7
# openness: 0.399556064588
# grid size: (1, 5)
# tile size: (155, 29) 0.187096774194
# map size: (155, 145) 0.935483870968
# horz shear step: 4
# horz_shear
# maze type recursive backtracker
# final openness 0.399556064588
# map_type cell_maze
# random_seed 5888921303366391504
players 5
rows 145
cols 155
m .......%%%%%%.....%%%%.........%%......%%.....%%........%%........%%..........%%%%%%%%%%%..........%.......................%%........%%%..%%%..........%%..
m .........%%%%%%%%%%%%%.....4...%%.......%%....%%........%%........%%..........%%.....%%%%%.........%..............%.......%%.........%%....%%%.............
m ..........%%%.....%%%%.........%%.......%%....%%........%%........%%...................%%%%%................%%%%%%%%......%%................%%%............
m .....................%.........%%.......%%%............%%..........%....................%%%%%%.............%%%%%%%%%%%...%%%.................%%%...........
m .....................%%%%.......%.......%%............%%%..........%........................%%%%..........%%........%.....%%..................%%%%%%%%%%%..
m .....................%%%%%%.............%%..........%%%%...........%..........................%%.........%%%...............%%.......%%.........%%%%%%%%%%%.
m .........................%%%..........%%%..........%%%.....................%%%.................%.........%%................%%.......%%.........%%%......%%%
m %%%..................................%%%...........%%...................%%%%%%%.......%........%%.......%%..................%%.......%%.......%%%%.......%%
m %%%.........%.......................%%............%%....................%%%..%%%.....%%%.......%%.......%%..................%%.......%%.....%%%.%%........%
m ...........%%.......................%%............%%%........%%%%.............%%%.....%%%...............%%........%.........%.........%....%%%...%%........
m .........%%%.....%%...............%%%%......%%.....%%........%%%%..............%%%.....%%%.............%%%........%%........%..............%.....%%%.......
m ........%%%......%%.............%%%%%%.......%......%.......%%..................%%......%%%...........%%%%........%%..............................%%.......
m .....%%%%.........%%........%%%%%%..%%..............%%.....%%%..................%%.......%%%%%..........%%%........%%..............................%%......
m ....%%%%..........%%%%......%%%%.....%%.............%%%.....%...................%%.......................%%........%%%%............................%%%.....
m ......%%............%%%......%%......%%.............%%..........................%%........................%%........%%%%..........%%%...............%%.....
m ......%%%............%%%......%%......%%............%%.................%%%.......%%.......................%%%.........%%........%%%%................%%.....
m .......%%.....................%%......%%%%%%%......%%.................%%%%.......%%........................%%..........%%.......%%..........%%......%%.....
m ........%%....................%%.........%%%%%....%%%.................%%%%........%%........................%%%%%.......%%.................%%%......%%%%%..
m ........%%%....................%%...........%%%%%%%%.................%%............%%...........%%%%.......%%%%%%%.......%%...............%%%........%%%%%%
m %........%%....................%%%%%.........%%%%%...........%%.....%%.............%%%..........%%%%%.....%%%...%%.......%%%%.............%%.............%%
m %........%%%%%........%%.........%%%........................%%......................%%%.............%%%..%%%....%%........%%%%%...........%...............%
m %.......%%%%%%%........%%.........%%.......................%%......................%%%%%%............%%%%%%......%%..........%%..........%%................
m %%%%%%%%%%%..%%%........%%%........%%......................%%...................%%%%%..%%%%%...........%%%.......%%...........%%...........................
m %%%%%%%%%%%....%%........%%........%%......................%.................%%%%%%%......%%%%..........%........%%%%..........%%..........................
m %%......%%.....%%........%%........%%%....................%%.................%%.............%%..........%%........%%%%.........%%..........................
m %%......%%.....%%........%%.........%%....................%%.........%......%%..............%%..........%%..........%%..........%%.........................
m %.......%%......%........%%.........%%%%%................%%.........%%%....%%................%%.........%%..........%%%.........%%%%.............%%%......%
m %%......%%......%%........%%........%%%%%...............%%%.........%%.....%.................%%.........%%%%.........%%%..........%%.............%%%.......
m %%......%%......%%.......%%%.......%%%...........%%%%%.%%%..........%.......................%%.........%%%%%%..........%%%.........%%............%.........
m %%......%%.....%%........%%........%%..........%%%%%%%%%%%..........%.......................%%........%%%..%%%..........%%.........%%%%%%.....%%%%.........
m %%.......%%....%%........%%........%%..........%%.....%%%%%.........%..............%.......%%.........%%....%%%......................%%%%%%%%%%%%%.....0...
m %%.......%%....%%........%%........%%...................%%%%%................%%%%%%%%......%%................%%%......................%%%.....%%%%.........
m %%.......%%%............%%..........%....................%%%%%%.............%%%%%%%%%%%...%%%.................%%%................................%.........
m .%.......%%............%%%..........%........................%%%%..........%%........%.....%%..................%%%%%%%%%%%.......................%%%%......
m .........%%..........%%%%...........%..........................%%.........%%%...............%%.......%%.........%%%%%%%%%%%......................%%%%%%....
m .......%%%..........%%%.....................%%%.................%.........%%................%%.......%%.........%%%......%%%.........................%%%...
m ......%%%...........%%...................%%%%%%%.......%........%%.......%%..................%%.......%%.......%%%%.......%%%%%............................
m .....%%............%%....................%%%..%%%.....%%%.......%%.......%%..................%%.......%%.....%%%.%%........%%%%.........%..................
m .....%%............%%%........%%%%.............%%%.....%%%...............%%........%.........%.........%....%%%...%%...................%%..................
m ...%%%%......%%.....%%........%%%%..............%%%.....%%%.............%%%........%%........%..............%.....%%%................%%%.....%%............
m .%%%%%%.......%......%.......%%..................%%......%%%...........%%%%........%%..............................%%...............%%%......%%............
m %%%..%%..............%%.....%%%..................%%.......%%%%%..........%%%........%%..............................%%...........%%%%.........%%........%%%
m %.....%%.............%%%.....%...................%%.......................%%........%%%%............................%%%.........%%%%..........%%%%......%%%
m ......%%.............%%..........................%%........................%%........%%%%..........%%%...............%%...........%%............%%%......%%
m %......%%............%%.................%%%.......%%.......................%%%.........%%........%%%%................%%...........%%%............%%%......%
m %......%%%%%%%......%%.................%%%%.......%%........................%%..........%%.......%%..........%%......%%............%%.....................%
m %.........%%%%%....%%%.................%%%%........%%........................%%%%%.......%%.................%%%......%%%%%..........%%....................%
m %%...........%%%%%%%%.................%%............%%...........%%%%.......%%%%%%%.......%%...............%%%........%%%%%%........%%%....................
m %%%%%.........%%%%%...........%%.....%%.............%%%..........%%%%%.....%%%...%%.......%%%%.............%%.............%%%........%%....................
m ..%%%........................%%......................%%%.............%%%..%%%....%%........%%%%%...........%...............%%........%%%%%........%%.......
m ...%%.......................%%......................%%%%%%............%%%%%%......%%..........%%..........%%................%.......%%%%%%%........%%......
m ....%%......................%%...................%%%%%..%%%%%...........%%%.......%%...........%%...........................%%%%%%%%%%%..%%%........%%%....
m ....%%......................%.................%%%%%%%......%%%%..........%........%%%%..........%%..........................%%%%%%%%%%%....%%........%%....
m ....%%%....................%%.................%%.............%%..........%%........%%%%.........%%..........................%%......%%.....%%........%%....
m .....%%....................%%.........%......%%..............%%..........%%..........%%..........%%.........................%%......%%.....%%........%%....
m .....%%%%%................%%.........%%%....%%................%%.........%%..........%%%.........%%%%.............%%%......%%.......%%......%........%%....
m .....%%%%%...............%%%.........%%.....%.................%%.........%%%%.........%%%..........%%.............%%%.......%%......%%......%%........%%...
m ....%%%...........%%%%%.%%%..........%.......................%%.........%%%%%%..........%%%.........%%............%.........%%......%%......%%.......%%%...
m ....%%..........%%%%%%%%%%%..........%.......................%%........%%%..%%%..........%%.........%%%%%%.....%%%%.........%%......%%.....%%........%%....
m ....%%..........%%.....%%%%%.........%..............%.......%%.........%%....%%%......................%%%%%%%%%%%%%.....1...%%.......%%....%%........%%....
m ....%%...................%%%%%................%%%%%%%%......%%................%%%......................%%%.....%%%%.........%%.......%%....%%........%%....
m .....%....................%%%%%%.............%%%%%%%%%%%...%%%.................%%%................................%.........%%.......%%%............%%.....
m .....%........................%%%%..........%%........%.....%%..................%%%%%%%%%%%.......................%%%%.......%.......%%............%%%.....
m .....%..........................%%.........%%%...............%%.......%%.........%%%%%%%%%%%......................%%%%%%.............%%..........%%%%......
m .............%%%.................%.........%%................%%.......%%.........%%%......%%%.........................%%%..........%%%..........%%%........
m ..........%%%%%%%.......%........%%.......%%..................%%.......%%.......%%%%.......%%%%%..................................%%%...........%%.........
m ..........%%%..%%%.....%%%.......%%.......%%..................%%.......%%.....%%%.%%........%%%%.........%.......................%%............%%..........
m %%%.............%%%.....%%%...............%%........%.........%.........%....%%%...%%...................%%.......................%%............%%%........%
m %%%..............%%%.....%%%.............%%%........%%........%..............%.....%%%................%%%.....%%...............%%%%......%%.....%%........%
m ..................%%......%%%...........%%%%........%%..............................%%...............%%%......%%.............%%%%%%.......%......%.......%%
m ..................%%.......%%%%%..........%%%........%%..............................%%...........%%%%.........%%........%%%%%%..%%..............%%.....%%%
m ..................%%.......................%%........%%%%............................%%%.........%%%%..........%%%%......%%%%.....%%.............%%%.....%.
m ..................%%........................%%........%%%%..........%%%...............%%...........%%............%%%......%%......%%.............%%........
m .........%%%.......%%.......................%%%.........%%........%%%%................%%...........%%%............%%%......%%......%%............%%........
m ........%%%%.......%%........................%%..........%%.......%%..........%%......%%............%%.....................%%......%%%%%%%......%%.........
m ........%%%%........%%........................%%%%%.......%%.................%%%......%%%%%..........%%....................%%.........%%%%%....%%%.........
m .......%%............%%...........%%%%.......%%%%%%%.......%%...............%%%........%%%%%%........%%%....................%%...........%%%%%%%%..........
m %.....%%.............%%%..........%%%%%.....%%%...%%.......%%%%.............%%.............%%%........%%....................%%%%%.........%%%%%...........%
m ......................%%%.............%%%..%%%....%%........%%%%%...........%...............%%........%%%%%........%%.........%%%........................%%
m .....................%%%%%%............%%%%%%......%%..........%%..........%%................%.......%%%%%%%........%%.........%%.......................%%.
m ..................%%%%%..%%%%%...........%%%.......%%...........%%...........................%%%%%%%%%%%..%%%........%%%........%%......................%%.
m ...............%%%%%%%......%%%%..........%........%%%%..........%%..........................%%%%%%%%%%%....%%........%%........%%......................%..
m ...............%%.............%%..........%%........%%%%.........%%..........................%%......%%.....%%........%%........%%%....................%%..
m .......%......%%..............%%..........%%..........%%..........%%.........................%%......%%.....%%........%%.........%%....................%%..
m ......%%%....%%................%%.........%%..........%%%.........%%%%.............%%%......%%.......%%......%........%%.........%%%%%................%%...
m ......%%.....%.................%%.........%%%%.........%%%..........%%.............%%%.......%%......%%......%%........%%........%%%%%...............%%%...
m ......%.......................%%.........%%%%%%..........%%%.........%%............%.........%%......%%......%%.......%%%.......%%%...........%%%%%.%%%....
m ......%.......................%%........%%%..%%%..........%%.........%%%%%%.....%%%%.........%%......%%.....%%........%%........%%..........%%%%%%%%%%%....
m ......%..............%.......%%.........%%....%%%......................%%%%%%%%%%%%%.....3...%%.......%%....%%........%%........%%..........%%.....%%%%%...
m ...............%%%%%%%%......%%................%%%......................%%%.....%%%%.........%%.......%%....%%........%%........%%...................%%%%%.
m %.............%%%%%%%%%%%...%%%.................%%%................................%.........%%.......%%%............%%..........%....................%%%%%
m %%%..........%%........%.....%%..................%%%%%%%%%%%.......................%%%%.......%.......%%............%%%..........%........................%
m .%%.........%%%...............%%.......%%.........%%%%%%%%%%%......................%%%%%%.............%%..........%%%%...........%.........................
m ..%.........%%................%%.......%%.........%%%......%%%.........................%%%..........%%%..........%%%.....................%%%...............
m ..%%.......%%..................%%.......%%.......%%%%.......%%%%%..................................%%%...........%%...................%%%%%%%.......%......
m ..%%.......%%..................%%.......%%.....%%%.%%........%%%%.........%.......................%%............%%....................%%%..%%%.....%%%.....
m ...........%%........%.........%.........%....%%%...%%...................%%.......................%%............%%%........%%%%.............%%%.....%%%....
m ..........%%%........%%........%..............%.....%%%................%%%.....%%...............%%%%......%%.....%%........%%%%..............%%%.....%%%...
m .........%%%%........%%..............................%%...............%%%......%%.............%%%%%%.......%......%.......%%..................%%......%%%..
m %..........%%%........%%..............................%%...........%%%%.........%%........%%%%%%..%%..............%%.....%%%..................%%.......%%%%
m ............%%........%%%%............................%%%.........%%%%..........%%%%......%%%%.....%%.............%%%.....%...................%%...........
m .............%%........%%%%..........%%%...............%%...........%%............%%%......%%......%%.............%%..........................%%...........
m .............%%%.........%%........%%%%................%%...........%%%............%%%......%%......%%............%%.................%%%.......%%..........
m ..............%%..........%%.......%%..........%%......%%............%%.....................%%......%%%%%%%......%%.................%%%%.......%%..........
m ...............%%%%%.......%%.................%%%......%%%%%..........%%....................%%.........%%%%%....%%%.................%%%%........%%.........
m ...%%%%.......%%%%%%%.......%%...............%%%........%%%%%%........%%%....................%%...........%%%%%%%%.................%%............%%........
m ...%%%%%.....%%%...%%.......%%%%.............%%.............%%%........%%....................%%%%%.........%%%%%...........%%.....%%.............%%%.......
m .......%%%..%%%....%%........%%%%%...........%...............%%........%%%%%........%%.........%%%........................%%......................%%%......
m ........%%%%%%......%%..........%%..........%%................%.......%%%%%%%........%%.........%%.......................%%......................%%%%%%....
m ..........%%%.......%%...........%%...........................%%%%%%%%%%%..%%%........%%%........%%......................%%...................%%%%%..%%%%%.
m %..........%........%%%%..........%%..........................%%%%%%%%%%%....%%........%%........%%......................%.................%%%%%%%......%%%
m %..........%%........%%%%.........%%..........................%%......%%.....%%........%%........%%%....................%%.................%%.............%
m %..........%%..........%%..........%%.........................%%......%%.....%%........%%.........%%....................%%.........%......%%..............%
m %%.........%%..........%%%.........%%%%.............%%%......%%.......%%......%........%%.........%%%%%................%%.........%%%....%%................
m %%.........%%%%.........%%%..........%%.............%%%.......%%......%%......%%........%%........%%%%%...............%%%.........%%.....%.................
m %.........%%%%%%..........%%%.........%%............%.........%%......%%......%%.......%%%.......%%%...........%%%%%.%%%..........%.......................%
m %........%%%..%%%..........%%.........%%%%%%.....%%%%.........%%......%%.....%%........%%........%%..........%%%%%%%%%%%..........%.......................%
m .........%%....%%%......................%%%%%%%%%%%%%.....2...%%.......%%....%%........%%........%%..........%%.....%%%%%.........%..............%.......%%
m ................%%%......................%%%.....%%%%.........%%.......%%....%%........%%........%%...................%%%%%................%%%%%%%%......%%
m .................%%%................................%.........%%.......%%%............%%..........%....................%%%%%%.............%%%%%%%%%%%...%%%
m ..................%%%%%%%%%%%.......................%%%%.......%.......%%............%%%..........%........................%%%%..........%%........%.....%%
m %.......%%.........%%%%%%%%%%%......................%%%%%%.............%%..........%%%%...........%..........................%%.........%%%...............%
m %.......%%.........%%%......%%%.........................%%%..........%%%..........%%%.....................%%%.................%.........%%................%
m %%.......%%.......%%%%.......%%%%%..................................%%%...........%%...................%%%%%%%.......%........%%.......%%..................
m %%.......%%.....%%%.%%........%%%%.........%.......................%%............%%....................%%%..%%%.....%%%.......%%.......%%..................
m %.........%....%%%...%%...................%%.......................%%............%%%........%%%%.............%%%.....%%%...............%%........%.........
m %..............%.....%%%................%%%.....%%...............%%%%......%%.....%%........%%%%..............%%%.....%%%.............%%%........%%........
m ......................%%...............%%%......%%.............%%%%%%.......%......%.......%%..................%%......%%%...........%%%%........%%........
m .......................%%...........%%%%.........%%........%%%%%%..%%..............%%.....%%%..................%%.......%%%%%..........%%%........%%.......
m .......................%%%.........%%%%..........%%%%......%%%%.....%%.............%%%.....%...................%%.......................%%........%%%%.....
m ......%%%...............%%...........%%............%%%......%%......%%.............%%..........................%%........................%%........%%%%....
m ....%%%%................%%...........%%%............%%%......%%......%%............%%.................%%%.......%%.......................%%%.........%%....
m ....%%..........%%......%%............%%.....................%%......%%%%%%%......%%.................%%%%.......%%........................%%..........%%...
m ...............%%%......%%%%%..........%%....................%%.........%%%%%....%%%.................%%%%........%%........................%%%%%.......%%..
m ..............%%%........%%%%%%........%%%....................%%...........%%%%%%%%.................%%............%%...........%%%%.......%%%%%%%.......%%.
m %.............%%.............%%%........%%....................%%%%%.........%%%%%...........%%.....%%.............%%%..........%%%%%.....%%%...%%.......%%%
m %%%...........%...............%%........%%%%%........%%.........%%%........................%%......................%%%.............%%%..%%%....%%........%%
m .%%..........%%................%.......%%%%%%%........%%.........%%.......................%%......................%%%%%%............%%%%%%......%%.........
m ..%%...........................%%%%%%%%%%%..%%%........%%%........%%......................%%...................%%%%%..%%%%%...........%%%.......%%.........
m ...%%..........................%%%%%%%%%%%....%%........%%........%%......................%.................%%%%%%%......%%%%..........%........%%%%.......
m ...%%..........................%%......%%.....%%........%%........%%%....................%%.................%%.............%%..........%%........%%%%......
m ....%%.........................%%......%%.....%%........%%.........%%....................%%.........%......%%..............%%..........%%..........%%......
m ....%%%%.............%%%......%%.......%%......%........%%.........%%%%%................%%.........%%%....%%................%%.........%%..........%%%.....
m ......%%.............%%%.......%%......%%......%%........%%........%%%%%...............%%%.........%%.....%.................%%.........%%%%.........%%%....
m .......%%............%.........%%......%%......%%.......%%%.......%%%...........%%%%%.%%%..........%.......................%%.........%%%%%%..........%%%..
