# map type: cell maze
# random seed: -1277757152
# players 3
# area 5838, 1946 (44.1^2) per player
# cell width: 1.35859159083
# cell size: 7.43417095644
# openness: 0.435600601351
# maze type prims
# horz_shear
# final parameters
# area: 5670
# grid size: (1, 3)
# tile size: (42, 45) 1.07142857143
# map size: (42, 135) 3.21428571429
# hill distance  26, 79   6, 52  19, 41   6,  7  19,131  19, 86   6, 97  26,124  26, 34
#        26, 79       0      47      57      87      71      14      40      71      71 
#         6, 52      47       0      32      55      77      47      55      87      40 
#        19, 41      57      32       0      47      57      57      77      71      14 
#         6,  7      87      55      47       0      32      77      55      40      47 
#        19,131      71      77      57      32       0      57      47      14      57 
#        19, 86      14      47      57      77      57       0      32      57      71 
#         6, 97      40      55      77      55      47      32       0      47      87 
#        26,124      71      87      71      40      14      57      47       0      71 
#        26, 34      71      40      14      47      57      71      87      71       0 
players 3
rows 42
cols 135
m .........................%.......%%...................................%.......%%...................................%.......%%..........
m .......%%...............%........%..................%%...............%........%..................%%...............%........%...........
m ........%%.............%........%%...................%%.............%........%%...................%%.............%........%%...........
m %%........%%....%%%%%%%.........%%...........%%........%%....%%%%%%%.........%%...........%%........%%....%%%%%%%.........%%...........
m %%.........%%%%%%.%%%%%......................%%.........%%%%%%.%%%%%......................%%.........%%%%%%.%%%%%......................
m %...........%%%..............................%...........%%%..............................%...........%%%..............................
m %%.....0.....%.........................%%....%%.....1.....%.........................%%....%%.....2.....%.........................%%....
m .%....................................%%......%....................................%%......%....................................%%.....
m .%%...................................%.......%%...................................%.......%%...................................%......
m .%%....................%%%%%%%%......%%.......%%....................%%%%%%%%......%%.......%%....................%%%%%%%%......%%......
m ..%...........................%......%%........%...........................%......%%........%...........................%......%%......
m ..%%%%%....%%..................%.....%.........%%%%%....%%..................%.....%.........%%%%%....%%..................%.....%.......
m .....%%%%%%%...................%%...%%............%%%%%%%...................%%...%%............%%%%%%%...................%%...%%.......
m .........%%..........................%................%%..........................%................%%..........................%.......
m ....................%%%...............%..........................%%%...............%..........................%%%...............%......
m %...................%%................%%....%%...................%%................%%....%%...................%%................%%....%
m %..................%%.......................%%..................%%.......................%%..................%%.......................%
m %..................%.........................%..................%.........................%..................%.........................
m %........%%.......%%........%................%........%%.......%%........%................%........%%.......%%........%................
m %........%%.......%%........%%...........0...%........%%.......%%........%%...........1...%........%%.......%%........%%...........2...
m %%......%.........%.........%%...............%%......%.........%.........%%...............%%......%.........%.........%%...............
m %%.....%.........%%..........%.....%%........%%.....%.........%%..........%.....%%........%%.....%.........%%..........%.....%%........
m .%%%%%%.........%%..........%%.......%........%%%%%%.........%%..........%%.......%........%%%%%%.........%%..........%%.......%.......
m %...............%%..........%.........%......%...............%%..........%.........%......%...............%%..........%.........%......
m .................%.........%%..........%%%%%%.................%.........%%..........%%%%%%.................%.........%%..........%%%%%%
m ........................%%%%%%........%%.............................%%%%%%........%%.............................%%%%%%........%%.....
m .......................%%%..%%....0...%.............................%%%..%%....1...%.............................%%%..%%....2...%......
m .......................%%....%%......%%.............................%%....%%......%%.............................%%....%%......%%......
m .........%...%.........%......%......%%...............%...%.........%......%......%%...............%...%.........%......%......%%......
m ........%%...%%........%.......%.....%...............%%...%%........%.......%.....%...............%%...%%........%.......%.....%.......
m .......%%.....%.......%%.......%%...%%..............%%.....%.......%%.......%%...%%..............%%.....%.......%%.......%%...%%.......
m ......%%......%%......%........%%..................%%......%%......%........%%..................%%......%%......%........%%............
m .....%%........%......%........%..................%%........%......%........%..................%%........%......%........%.............
m .%%%%%%........%%....%%........%..............%%%%%%........%%....%%........%..............%%%%%%........%%....%%........%.............
m %%..............%%...%%.......%%............%%%..............%%...%%.......%%............%%%..............%%...%%.......%%............%
m ................%%....%%......%............%%................%%....%%......%............%%................%%....%%......%............%%
m ..............%%%.......%................%%%...............%%%.......%................%%%...............%%%.......%................%%%.
m ........%%%%%%%%..........................%..........%%%%%%%%..........................%..........%%%%%%%%..........................%..
m .........%............................................%............................................%...................................
m ...................................%............................................%............................................%.........
m ..................................%%...........................................%%...........................................%%.........
m ..................................%............................................%............................................%..........
