# map type: cell maze
# random seed: 243053167
# players 4
# area 18728, 4682 (68.4^2) per player
# cell width: 7.0
# cell size: 15.8647086658
# openness: 0.163399978778
# maze type prims
# horz shear step: 3
# horz_shear
# final parameters
# area: 18400
# grid size: (1, 4)
# tile size: (92, 50) 0.54347826087
# map size: (92, 200) 2.17391304348
# hill distance  51, 63  16, 48  28,113  62,148  39,198  85, 98  74, 13   5,163
#        51, 63       0      96     139     136      77      69     139     146 
#        16, 48      96       0      77     146      73      73      69     136 
#        28,113     139      77       0      69     136      96     146     139 
#        62,148     136     146      69       0      73      73      77      96 
#        39,198      77      73     136      73       0     146      96      69 
#        85, 98      69      73      96      73     146       0     136      77 
#        74, 13     139      69     146      77      96     136       0     139 
#         5,163     146     136     139      96      69      77     139       0 
players 4
rows 92
cols 200
m ..................................%%%..........%%%%%%%%%.............................%%%%%.................................................................................................%%%%%%%......
m ................................%%%%%%%%%%%%%%%%%%%%%%%%...........................%%%%%%%%%...............................................................................................%%%%%%%......
m ..................%.............%%%%%%%%%%%%%%%%%%%%%%%..........................%%%%%%%%%%%%%......................................................%%%.....................%%.............%%%%%%%......
m .................%%%%%%%........%%%%%%%%%%%%%%%%%%%%%%%........................%%%%%%%%%%%%%%%%%............%%.....................................%%%%.....................%%%............%%%%%%%%%....
m %%%..............%%%%%%%........%%%%%%%%%%%%%%%%%%%%%%%%....................%%%%%%%%%%%%%%%%%%%%%%%........%%%...................................%%%%%%%...................%%%%%%..........%%%%%%%%%%%%%
m %%%%............%%%%%%%%%.......%%%%%%%%%%%%%%%%%%%%%%%%%.................%%%%%%%%%%%%%%%%%%%%%%%%%%%%....%%%%%...............................%%%%%%%%%%%..........3......%%%%%%%%.........%%%%%%%%%%%%%
m %%%%...........%%%%%%%%%%........%%%%%%%%%%%%%%%%%%%%%%%%%............%%%%%%%%%%%%%%%%%%%%%%%%%%%%%%%%%..%%%%%%......................%%%%%%.%%%%%%%%%%%%%%................%%%%%%%%%%.....%%%%%%%%%%%%%%%
m %%%%%%.........%%%%%%%%%.........%%%%%%%%%%%%%%%%%%%%%%%%%%..........%%%%%%%%%%%%%%%%%%%%%%%%%%%%%%%%%%%%%%%%%%%....................%%%%%%%%%%%%%%%%%%%%%%%...............%%%%%%%%%%%%%.%%%%%%%%%%%%%%%%
m %%%%%%%.......%%%%%%%%%..........%%%%%%%%%%%.....%%%%%%%%%%%.........%%%%%%%%%%%%%%%%.....%%%%%%%%%%%%%%%%%%%%%%..................%%%%%%%%%%%%%%%%%%%%%%%%%...............%%%%%%%%%%%%%%%%%%%%%%%%%%%%%%
m %%%%%%%%....%%%%%%%%%%...........%%%%%%%...........%%%%%%%%%%%.......%%%%%%%%%%%%%%.........%%%%%%%%%%%%%%%%%%%%%...............%%%%%%%%%%%%%%%%%%%%%%%%%%%%..............%%%%%%%%%%%%%%%%%%%%%%%%%%%%%%
m %%%%%%%%%%%%%%%%%%%%%...............................%%%%%%%%%%%....%%%%%%%%%%%%%%.............%%%%%%%%%%%%%%%%%%%%%...........%%%%%%%%%%%%%%%%%%%%%%%%%%%%%%%..............%%%%%%%%%%%%%%%%%%%%%%%%%%%%%
m %%%%%%%%%%%%%%%%%%%%.................................%%%%%%%%%....%%%%%%%%%%%%%.................%%%%%%%%%%%%%%%%%%%%%......%%%%%%%%%%%%%%%%%%%%%%%%%%%%%%%%%%%%%..............%%%%%%%%%%%%%%%%........%%
m %%%%%%%%%%%%%%%%%%%%..................................%%%%%%%.....%%%%%%%%%%%%....................%%%%%%%%%%%%%%%%%%%%%.%%%%%%%%%%%%%%%%%%%%%%%%%%..%%%%%%%%%%%%%%%%.............%%%%%%%%%%%%...........
m .%%%%%%%%%%%%%%%%%%...............................................%%%%%%%%%%%.......................%%%%%%%%%%%%%%%%%%%%%%%%%%%%%%%%%%%%%%%%%%%%%%....%%%%%%%%%%%%%%%%%%...........%%%%%%%%%............
m ..%%%%%%%%%%%%%%%%................................................%%%%%%%%%%%........................%%%%%%%%%%%%%%%%%%%%%%%%%%%%%%%%%%%%%%%%%%%%......%%%%%%%%%%%%%%%%%............%%%%%%%%............
m ..%%%%%%%%%%%%%%%%................................................%%%%%%%%%%%.........................%%%%%%%%%%%%%%%%%%%%%%%%%%%%%%%..%%%%%%%%%%.......%%%%%%%%%%%%%%%%..............%%%%%.............
m ..%%%%%%%%%%%%%.................................1...................%%%%%%%%%..........................%%%..%%%%%%%%%%%%%%%%%%%%%%.....%%%%%%%%%%.........%%%%%%%%%%%%%%...............%%%..............
m .%%%%%%%%%.............................................................%%%%%....................................%%%%%%%%%%%%%%%%........%%%%%%%%...........%%%%%%%%%%%%%%...............................
m .%%%%%%%%...............................................................%%%........................................%%%%%%%%%%%..........%%%%%%%%..............%%%%%%%%%%................................
m %%%%%%%%..............................................................................................................%%%%%%............%%%%%%%%.................%%%%%%.................................
m %%%%%%%%................................................................................................................%%%..............%%%%%%%.....................%..................................
m %%%%%%%..................................................................................................................................%%%%%%%.......................................................%
m %%%%%%%..............................%...................................................................................................%%%%%%%......................................................%%
m %%%%%%.............................%%%%%.................................................................................................%%%%%%%........................................%%%..........%%%
m %%%%%%...........................%%%%%%%%%...............................................................................................%%%%%%%......................................%%%%%%%%%%%%%%%%%%
m %%%%%..........................%%%%%%%%%%%%%......................................................%%%.....................%%.............%%%%%%%........................%.............%%%%%%%%%%%%%%%%%%
m %%%%%........................%%%%%%%%%%%%%%%%%............%%.....................................%%%%.....................%%%............%%%%%%%%%.....................%%%%%%%........%%%%%%%%%%%%%%%%%%
m %%%%%%....................%%%%%%%%%%%%%%%%%%%%%%%........%%%...................................%%%%%%%...................%%%%%%..........%%%%%%%%%%%%%%%%..............%%%%%%%........%%%%%%%%%%%%%%%%%%
m %%%%%%%.................%%%%%%%%%%%%%%%%%%%%%%%%%%%%....%%%%%...............................%%%%%%%%%%%..........2......%%%%%%%%.........%%%%%%%%%%%%%%%%%............%%%%%%%%%.......%%%%%%%%%%%%%%%%%%
m %%%%%%%%............%%%%%%%%%%%%%%%%%%%%%%%%%%%%%%%%%..%%%%%%......................%%%%%%.%%%%%%%%%%%%%%................%%%%%%%%%%.....%%%%%%%%%%%%%%%%%%%...........%%%%%%%%%%........%%%%%%%%%%%%%%%%%
m %%%%%%%%%..........%%%%%%%%%%%%%%%%%%%%%%%%%%%%%%%%%%%%%%%%%%%....................%%%%%%%%%%%%%%%%%%%%%%%...............%%%%%%%%%%%%%.%%%%%%%%%%%%%%%%%%%%%%.........%%%%%%%%%.........%%%%%%%%%%%%%%%%%
m %%%%%%%%%%.........%%%%%%%%%%%%%%%%.....%%%%%%%%%%%%%%%%%%%%%%..................%%%%%%%%%%%%%%%%%%%%%%%%%...............%%%%%%%%%%%%%%%%%%%%%%%%%%%%%%%%%%%%%.......%%%%%%%%%..........%%%%%%%%%%%.....%
m .%%%%%%%%%%%.......%%%%%%%%%%%%%%.........%%%%%%%%%%%%%%%%%%%%%...............%%%%%%%%%%%%%%%%%%%%%%%%%%%%..............%%%%%%%%%%%%%%%%%%%%%%%%%%%%%%%%%%%%%%....%%%%%%%%%%...........%%%%%%%..........
m ..%%%%%%%%%%%....%%%%%%%%%%%%%%.............%%%%%%%%%%%%%%%%%%%%%...........%%%%%%%%%%%%%%%%%%%%%%%%%%%%%%%..............%%%%%%%%%%%%%%%%%%%%%%%%%%%%%%%%%%%%%%%%%%%%%%%%%%.............................
m ...%%%%%%%%%....%%%%%%%%%%%%%.................%%%%%%%%%%%%%%%%%%%%%......%%%%%%%%%%%%%%%%%%%%%%%%%%%%%%%%%%%%%..............%%%%%%%%%%%%%%%%........%%%%%%%%%%%%%%%%%%%%%%..............................
m ....%%%%%%%.....%%%%%%%%%%%%....................%%%%%%%%%%%%%%%%%%%%%.%%%%%%%%%%%%%%%%%%%%%%%%%%..%%%%%%%%%%%%%%%%.............%%%%%%%%%%%%...........%%%%%%%%%%%%%%%%%%%%..............................
m ................%%%%%%%%%%%.......................%%%%%%%%%%%%%%%%%%%%%%%%%%%%%%%%%%%%%%%%%%%%%%....%%%%%%%%%%%%%%%%%%...........%%%%%%%%%.............%%%%%%%%%%%%%%%%%%...............................
m ................%%%%%%%%%%%........................%%%%%%%%%%%%%%%%%%%%%%%%%%%%%%%%%%%%%%%%%%%%......%%%%%%%%%%%%%%%%%............%%%%%%%%..............%%%%%%%%%%%%%%%%................................
m ................%%%%%%%%%%%.........................%%%%%%%%%%%%%%%%%%%%%%%%%%%%%%%..%%%%%%%%%%.......%%%%%%%%%%%%%%%%..............%%%%%...............%%%%%%%%%%%%%%%%................................
m ..................%%%%%%%%%..........................%%%..%%%%%%%%%%%%%%%%%%%%%%.....%%%%%%%%%%.........%%%%%%%%%%%%%%...............%%%................%%%%%%%%%%%%%.................................0.
m .....................%%%%%....................................%%%%%%%%%%%%%%%%........%%%%%%%%...........%%%%%%%%%%%%%%................................%%%%%%%%%........................................
m ......................%%%........................................%%%%%%%%%%%..........%%%%%%%%..............%%%%%%%%%%.................................%%%%%%%%.........................................
m ....................................................................%%%%%%............%%%%%%%%.................%%%%%%.................................%%%%%%%%..........................................
m ......................................................................%%%..............%%%%%%%.....................%..................................%%%%%%%%..........................................
m .......................................................................................%%%%%%%.......................................................%%%%%%%%...........................................
m .......................................................................................%%%%%%%......................................................%%%%%%%%%..............................%............
m .......................................................................................%%%%%%%........................................%%%..........%%%%%%%%%.............................%%%%%..........
m .......................................................................................%%%%%%%......................................%%%%%%%%%%%%%%%%%%%%%%%%...........................%%%%%%%%%........
m ................................................%%%.....................%%.............%%%%%%%........................%.............%%%%%%%%%%%%%%%%%%%%%%%..........................%%%%%%%%%%%%%......
m ........%%.....................................%%%%.....................%%%............%%%%%%%%%.....................%%%%%%%........%%%%%%%%%%%%%%%%%%%%%%%........................%%%%%%%%%%%%%%%%%....
m .......%%%...................................%%%%%%%...................%%%%%%..........%%%%%%%%%%%%%%%%..............%%%%%%%........%%%%%%%%%%%%%%%%%%%%%%%%....................%%%%%%%%%%%%%%%%%%%%%%%.
m %%....%%%%%...............................%%%%%%%%%%%..........1......%%%%%%%%.........%%%%%%%%%%%%%%%%%............%%%%%%%%%.......%%%%%%%%%%%%%%%%%%%%%%%%%.................%%%%%%%%%%%%%%%%%%%%%%%%%%
m %%%..%%%%%%......................%%%%%%.%%%%%%%%%%%%%%................%%%%%%%%%%.....%%%%%%%%%%%%%%%%%%%...........%%%%%%%%%%........%%%%%%%%%%%%%%%%%%%%%%%%%............%%%%%%%%%%%%%%%%%%%%%%%%%%%%%%
m %%%%%%%%%%%%....................%%%%%%%%%%%%%%%%%%%%%%%...............%%%%%%%%%%%%%.%%%%%%%%%%%%%%%%%%%%%%.........%%%%%%%%%.........%%%%%%%%%%%%%%%%%%%%%%%%%%..........%%%%%%%%%%%%%%%%%%%%%%%%%%%%%%%
m %%%%%%%%%%%%..................%%%%%%%%%%%%%%%%%%%%%%%%%...............%%%%%%%%%%%%%%%%%%%%%%%%%%%%%%%%%%%%%.......%%%%%%%%%..........%%%%%%%%%%%.....%%%%%%%%%%%.........%%%%%%%%%%%%%%%%.....%%%%%%%%%%
m %%%%%%%%%%%%%...............%%%%%%%%%%%%%%%%%%%%%%%%%%%%..............%%%%%%%%%%%%%%%%%%%%%%%%%%%%%%%%%%%%%%....%%%%%%%%%%...........%%%%%%%...........%%%%%%%%%%%.......%%%%%%%%%%%%%%.........%%%%%%%%
m %%%%%%%%%%%%%%%...........%%%%%%%%%%%%%%%%%%%%%%%%%%%%%%%..............%%%%%%%%%%%%%%%%%%%%%%%%%%%%%%%%%%%%%%%%%%%%%%%%%%...............................%%%%%%%%%%%....%%%%%%%%%%%%%%.............%%%%%%
m %%%%%%%%%%%%%%%%%......%%%%%%%%%%%%%%%%%%%%%%%%%%%%%%%%%%%%%..............%%%%%%%%%%%%%%%%........%%%%%%%%%%%%%%%%%%%%%%.................................%%%%%%%%%....%%%%%%%%%%%%%.................%%%%
m %%%%%%%%%%%%%%%%%%%.%%%%%%%%%%%%%%%%%%%%%%%%%%..%%%%%%%%%%%%%%%%.............%%%%%%%%%%%%...........%%%%%%%%%%%%%%%%%%%%..................................%%%%%%%.....%%%%%%%%%%%%....................%%
m %%%%%%%%%%%%%%%%%%%%%%%%%%%%%%%%%%%%%%%%%%%%%%....%%%%%%%%%%%%%%%%%%...........%%%%%%%%%.............%%%%%%%%%%%%%%%%%%...............................................%%%%%%%%%%%.......................
m .%%%%%%%%%%%%%%%%%%%%%%%%%%%%%%%%%%%%%%%%%%%%......%%%%%%%%%%%%%%%%%............%%%%%%%%..............%%%%%%%%%%%%%%%%................................................%%%%%%%%%%%.......................
m ..%%%%%%%%%%%%%%%%%%%%%%%%%%%%%%%..%%%%%%%%%%.......%%%%%%%%%%%%%%%%..............%%%%%...............%%%%%%%%%%%%%%%%................................................%%%%%%%%%%%.......................
m ...%%%..%%%%%%%%%%%%%%%%%%%%%%.....%%%%%%%%%%.........%%%%%%%%%%%%%%...............%%%................%%%%%%%%%%%%%.................................3...................%%%%%%%%%.......................
m ............%%%%%%%%%%%%%%%%........%%%%%%%%...........%%%%%%%%%%%%%%................................%%%%%%%%%.............................................................%%%%%........................
m ...............%%%%%%%%%%%..........%%%%%%%%..............%%%%%%%%%%.................................%%%%%%%%...............................................................%%%.........................
m ..................%%%%%%............%%%%%%%%.................%%%%%%.................................%%%%%%%%............................................................................................
m ....................%%%..............%%%%%%%.....................%..................................%%%%%%%%............................................................................................
m .....................................%%%%%%%.......................................................%%%%%%%%.............................................................................................
m .....................................%%%%%%%......................................................%%%%%%%%%..............................%..............................................................
m .....................................%%%%%%%........................................%%%..........%%%%%%%%%.............................%%%%%............................................................
m .....................................%%%%%%%......................................%%%%%%%%%%%%%%%%%%%%%%%%...........................%%%%%%%%%..........................................................
m %.....................%%.............%%%%%%%........................%.............%%%%%%%%%%%%%%%%%%%%%%%..........................%%%%%%%%%%%%%......................................................%%
m %.....................%%%............%%%%%%%%%.....................%%%%%%%........%%%%%%%%%%%%%%%%%%%%%%%........................%%%%%%%%%%%%%%%%%............%%.....................................%%%
m %%...................%%%%%%..........%%%%%%%%%%%%%%%%..............%%%%%%%........%%%%%%%%%%%%%%%%%%%%%%%%....................%%%%%%%%%%%%%%%%%%%%%%%........%%%...................................%%%%%
m %%%..........0......%%%%%%%%.........%%%%%%%%%%%%%%%%%............%%%%%%%%%.......%%%%%%%%%%%%%%%%%%%%%%%%%.................%%%%%%%%%%%%%%%%%%%%%%%%%%%%....%%%%%...............................%%%%%%%%
m %%%%................%%%%%%%%%%.....%%%%%%%%%%%%%%%%%%%...........%%%%%%%%%%........%%%%%%%%%%%%%%%%%%%%%%%%%............%%%%%%%%%%%%%%%%%%%%%%%%%%%%%%%%%..%%%%%%......................%%%%%%.%%%%%%%%%%
m %%%%%...............%%%%%%%%%%%%%.%%%%%%%%%%%%%%%%%%%%%%.........%%%%%%%%%.........%%%%%%%%%%%%%%%%%%%%%%%%%%..........%%%%%%%%%%%%%%%%%%%%%%%%%%%%%%%%%%%%%%%%%%%....................%%%%%%%%%%%%%%%%%%
m %%%%%...............%%%%%%%%%%%%%%%%%%%%%%%%%%%%%%%%%%%%%.......%%%%%%%%%..........%%%%%%%%%%%.....%%%%%%%%%%%.........%%%%%%%%%%%%%%%%.....%%%%%%%%%%%%%%%%%%%%%%..................%%%%%%%%%%%%%%%%%%%%
m %%%%%%..............%%%%%%%%%%%%%%%%%%%%%%%%%%%%%%%%%%%%%%....%%%%%%%%%%...........%%%%%%%...........%%%%%%%%%%%.......%%%%%%%%%%%%%%.........%%%%%%%%%%%%%%%%%%%%%...............%%%%%%%%%%%%%%%%%%%%%%
m %%%%%%%..............%%%%%%%%%%%%%%%%%%%%%%%%%%%%%%%%%%%%%%%%%%%%%%%%%%...............................%%%%%%%%%%%....%%%%%%%%%%%%%%.............%%%%%%%%%%%%%%%%%%%%%...........%%%%%%%%%%%%%%%%%%%%%%%%
m %%%%%%%%%%..............%%%%%%%%%%%%%%%%........%%%%%%%%%%%%%%%%%%%%%%.................................%%%%%%%%%....%%%%%%%%%%%%%.................%%%%%%%%%%%%%%%%%%%%%......%%%%%%%%%%%%%%%%%%%%%%%%%%%
m %%%%%%%%%%%%%%.............%%%%%%%%%%%%...........%%%%%%%%%%%%%%%%%%%%..................................%%%%%%%.....%%%%%%%%%%%%....................%%%%%%%%%%%%%%%%%%%%%.%%%%%%%%%%%%%%%%%%%%%%%%%%..%%
m %%%%%%%%%%%%%%%%%%...........%%%%%%%%%.............%%%%%%%%%%%%%%%%%%...............................................%%%%%%%%%%%.......................%%%%%%%%%%%%%%%%%%%%%%%%%%%%%%%%%%%%%%%%%%%%%%....
m .%%%%%%%%%%%%%%%%%............%%%%%%%%..............%%%%%%%%%%%%%%%%................................................%%%%%%%%%%%........................%%%%%%%%%%%%%%%%%%%%%%%%%%%%%%%%%%%%%%%%%%%%.....
m ..%%%%%%%%%%%%%%%%..............%%%%%...............%%%%%%%%%%%%%%%%................................................%%%%%%%%%%%.........................%%%%%%%%%%%%%%%%%%%%%%%%%%%%%%%..%%%%%%%%%%.....
m ....%%%%%%%%%%%%%%...............%%%................%%%%%%%%%%%%%.................................2...................%%%%%%%%%..........................%%%..%%%%%%%%%%%%%%%%%%%%%%.....%%%%%%%%%%.....
m .....%%%%%%%%%%%%%%................................%%%%%%%%%.............................................................%%%%%....................................%%%%%%%%%%%%%%%%........%%%%%%%%......
m ........%%%%%%%%%%.................................%%%%%%%%...............................................................%%%........................................%%%%%%%%%%%..........%%%%%%%%......
m ...........%%%%%%.................................%%%%%%%%..............................................................................................................%%%%%%............%%%%%%%%......
m ...............%..................................%%%%%%%%................................................................................................................%%%..............%%%%%%%......
m .................................................%%%%%%%%..................................................................................................................................%%%%%%%......
m ................................................%%%%%%%%%..............................%...................................................................................................%%%%%%%......
