# map type: cell maze
# random seed: -322330101
# players 7
# area 6353, 907 (30.1^2) per player
# cell width: 3.52506651154
# cell size: 10.1463684592
# openness: 0.552651011401
# maze type growing
# horz shear step: 2
# horz_shear
# final parameters
# area: 6174
# grid size: (1, 7)
# tile size: (63, 14) 0.222222222222
# map size: (63, 98) 1.55555555556
# hill distance  32, 54   2, 93  59, 26  23, 96  56, 37   5, 82  50, 68  11, 51  29, 65  14, 40  20,  9  38, 23  47, 79  41, 12
#        32, 54       0      91      64      96      41      64      32      61      89      32      59      37     121      96 
#         2, 93      91       0      37      61     116      89     121     116      84      59      52      84      52      41 
#        59, 26      64      37       0      64      89      96      96     121      91      32      41      61      59      32 
#        23, 96      96      61      64       0      91      32      64      59      37      96      89     121      41      32 
#        56, 37      41     116      89      91       0      59      37      52      84      61      84      52     116     121 
#         5, 82      64      89      96      32      59       0      32      37      41      96     121      91      61      64 
#        50, 68      32     121      96      64      37      32       0      41      61      64      91      59      89      96 
#        11, 51      61     116     121      59      52      37      41       0      52      89     116      84      84      91 
#        29, 65      89      84      91      37      84      41      61      52       0     121     116     116      52      59 
#        14, 40      32      59      32      96      61      96      64      89     121       0      37      41      91      64 
#        20,  9      59      52      41      89      84     121      91     116     116      37       0      52      84      61 
#        38, 23      37      84      61     121      52      91      59      84     116      41      52       0     116      89 
#        47, 79     121      52      59      41     116      61      89      84      52      91      84     116       0      37 
#        41, 12      96      41      32      32     121      64      96      91      59      64      61      89      37       0 
players 7
rows 63
cols 98
m ................%%%..............%%%%%%%..........%%%%............%%%%.........%%%%%%%%%%.........
m ...................................%%%%...........%%%%............%%%%...............%%%%.........
m .%%....................%%%%.........%%%..........%%%%%%%..........%%%%%...............%%%....6....
m %%%%...................%%%%.........%%%%........%%%%%%%%%.........%%%%%%%.............%%%%........
m %%%%...................%%%%.........%%%%........%%%%%%%%%%..........%%%%%%............%%%%.......%
m %%%%....................%%%..........%%%.......%%%%%%.%%%%%%.........%%%%%%.......0....%%%......%%
m %%%.....................%%%..........%%%%....%%%%%%....%%%%%...........%%%%%...........%%%%...%%%%
m %........%%.............%%%..........%%%%%%%%%%%%%......%%%%............%%%............%%%%%%%%%%%
m ........%%%%............%%%%.........%%%%%%%%%%%........................%%%............%%%%%%%%%%.
m ........%%%%............%%%%.........%%%%%%%%%%.........................%%%..............%%%%%%%..
m ........%%%%............%%%%...............%%%%............................................%%%%...
m .......%%%%%%%..........%%%%%...............%%%....3.....%%....................%%%%.........%%%...
m ......%%%%%%%%%.........%%%%%%%.............%%%%........%%%%...................%%%%.........%%%%..
m ......%%%%%%%%%%..........%%%%%%............%%%%.......%%%%%...................%%%%.........%%%%..
m .....%%%%%%.%%%%%%.........%%%%%%.......4....%%%......%%%%%%....................%%%..........%%%..
m ...%%%%%%....%%%%%...........%%%%%...........%%%%...%%%%%%%.....................%%%..........%%%%.
m %%%%%%%%......%%%%............%%%............%%%%%%%%%%%%........%%.............%%%..........%%%%%
m %%%%%%........................%%%............%%%%%%%%%%.........%%%%............%%%%.........%%%%%
m %%%%%.........................%%%..............%%%%%%%..........%%%%............%%%%.........%%%%%
m .%%%%............................................%%%%...........%%%%............%%%%..............
m ..%%%....0.....%%....................%%%%.........%%%..........%%%%%%%..........%%%%%.............
m ..%%%%........%%%%...................%%%%.........%%%%........%%%%%%%%%.........%%%%%%%...........
m ..%%%%.......%%%%%...................%%%%.........%%%%........%%%%%%%%%%..........%%%%%%..........
m ...%%%......%%%%%%....................%%%..........%%%.......%%%%%%.%%%%%%.........%%%%%%.......1.
m ...%%%%...%%%%%%%.....................%%%..........%%%%....%%%%%%....%%%%%...........%%%%%........
m ...%%%%%%%%%%%%........%%.............%%%..........%%%%%%%%%%%%%......%%%%............%%%.........
m ...%%%%%%%%%%.........%%%%............%%%%.........%%%%%%%%%%%........................%%%.........
m .....%%%%%%%..........%%%%............%%%%.........%%%%%%%%%%.........................%%%.........
m .......%%%%...........%%%%............%%%%...............%%%%.....................................
m ........%%%..........%%%%%%%..........%%%%%...............%%%....4.....%%....................%%%%.
m ........%%%%........%%%%%%%%%.........%%%%%%%.............%%%%........%%%%...................%%%%.
m ........%%%%........%%%%%%%%%%..........%%%%%%............%%%%.......%%%%%...................%%%%.
m .........%%%.......%%%%%%.%%%%%%.........%%%%%%.......5....%%%......%%%%%%....................%%%.
m .........%%%%....%%%%%%....%%%%%...........%%%%%...........%%%%...%%%%%%%.....................%%%.
m .........%%%%%%%%%%%%%......%%%%............%%%............%%%%%%%%%%%%........%%.............%%%.
m .........%%%%%%%%%%%........................%%%............%%%%%%%%%%.........%%%%............%%%%
m .........%%%%%%%%%%.........................%%%..............%%%%%%%..........%%%%............%%%%
m ...............%%%%............................................%%%%...........%%%%............%%%%
m %...............%%%....1.....%%....................%%%%.........%%%..........%%%%%%%..........%%%%
m %%%.............%%%%........%%%%...................%%%%.........%%%%........%%%%%%%%%.........%%%%
m %%%%............%%%%.......%%%%%...................%%%%.........%%%%........%%%%%%%%%%..........%%
m %%%%%.......2....%%%......%%%%%%....................%%%..........%%%.......%%%%%%.%%%%%%.........%
m .%%%%%...........%%%%...%%%%%%%.....................%%%..........%%%%....%%%%%%....%%%%%..........
m ..%%%............%%%%%%%%%%%%........%%.............%%%..........%%%%%%%%%%%%%......%%%%..........
m ..%%%............%%%%%%%%%%.........%%%%............%%%%.........%%%%%%%%%%%......................
m ..%%%..............%%%%%%%..........%%%%............%%%%.........%%%%%%%%%%.......................
m .....................%%%%...........%%%%............%%%%...............%%%%.......................
m .........%%%%.........%%%..........%%%%%%%..........%%%%%...............%%%....5.....%%...........
m .........%%%%.........%%%%........%%%%%%%%%.........%%%%%%%.............%%%%........%%%%..........
m .........%%%%.........%%%%........%%%%%%%%%%..........%%%%%%............%%%%.......%%%%%..........
m ..........%%%..........%%%.......%%%%%%.%%%%%%.........%%%%%%.......6....%%%......%%%%%%..........
m ..........%%%..........%%%%....%%%%%%....%%%%%...........%%%%%...........%%%%...%%%%%%%...........
m ..........%%%..........%%%%%%%%%%%%%......%%%%............%%%............%%%%%%%%%%%%........%%...
m ..........%%%%.........%%%%%%%%%%%........................%%%............%%%%%%%%%%.........%%%%..
m ..........%%%%.........%%%%%%%%%%.........................%%%..............%%%%%%%..........%%%%..
m ..........%%%%...............%%%%............................................%%%%...........%%%%..
m ..........%%%%%...............%%%....2.....%%....................%%%%.........%%%..........%%%%%%%
m %.........%%%%%%%.............%%%%........%%%%...................%%%%.........%%%%........%%%%%%%%
m %%..........%%%%%%............%%%%.......%%%%%...................%%%%.........%%%%........%%%%%%%%
m %%%%.........%%%%%%.......3....%%%......%%%%%%....................%%%..........%%%.......%%%%%%.%%
m %%%%...........%%%%%...........%%%%...%%%%%%%.....................%%%..........%%%%....%%%%%%....%
m %%%%............%%%............%%%%%%%%%%%%........%%.............%%%..........%%%%%%%%%%%%%......
m ................%%%............%%%%%%%%%%.........%%%%............%%%%.........%%%%%%%%%%%........
