# map type: blank
# random seed: 1693713227
# hill distance  33, 28  35, 70  14,  5  90, 97  73,  1  71, 74  52, 51  16, 47  92, 24  54, 93
#        33, 28       0      44     111     107      67     107     111     102     119      71 
#        35, 70      44       0      71      67     111     119     102      62     111      62 
#        14,  5     111      71       0     111     119     107     107      44     102      67 
#        90, 97     107      67     111       0     102     111     107      71      44     119 
#        73,  1      67     111     119     102       0      44      71     111      62      62 
#        71, 74     107     119     107     111      44       0     111      67      71     102 
#        52, 51     111     102     107     107      71     111       0     119      67      44 
#        16, 47     102      62      44      71     111      67     119       0      62     111 
#        92, 24     119     111     102      44      62      71      67      62       0     111 
#        54, 93      71      62      67     119      62     102      44     111     111       0 
players 5
rows 95
cols 115
m .%%..........%%%.....%%%............%%%%%........................%%................................................
m .%%...........%%......%%%%%.....%%%%%%%.........................%%..................................%..............
m .%%...........%%........%%%%%.%%%%%%%..........................%%...............................%%%%%%%............
m %%............%%.........%%%%%%%....................%%%%%.....%%.............................%%%%%%.%%%%...........
m %%.............%..........%%%%...................%%%%%%%%%%%.%%%...........................%%%%%......%%%..........
m %%%............%%..........%.....................%%%.....%%%%%%...........................%%%%..........%%%......%%
m .%%%...........%%...............................%%%.........%%............................%%%............%%%%..%%%%
m ..%%%%.........%%...............................%%.......................................%%%..............%%%%%%%..
m ..%%%%%........%%%..............................%%...........................%%....%%%%%%%%.................%%%....
m .....%%%%......%%%..............................%%...........................%%%%%%%%%%%%%%.................%%.....
m .......%%%%....%%%...............................%...................%%%%.....%%%%..........................%%.....
m .........%%%%%%%%%%%%.............................................%%%%%....................................%%......
m ..........%%%%%%..%%%%%.........................................%%%%%......................................%%......
m ............%........%%.........................................%%%%........................%............%%%.......
m .....0..........................................................%%.........................%%%%......%%%%%%%.......
m ......................................%%%%......................%%........................%%%%%%%%%%%%%%%..........
m ....................................%%%%%%%....4...............%%.........................%%%.%%%%%%%..............
m ....................................%%%%%%%%...................%%........................%%%....%%%................
m ........................%%..........%%%..%%%%%...............%%%%.......................%%%......%.................
m ........................%%..........%%%.....%%%............%%%%%........................%%.........................
m ........%...............%%...........%%......%%%%%.....%%%%%%%.........................%%..........................
m ....%%%%%%%.............%%...........%%........%%%%%.%%%%%%%..........................%%...........................
m .%%%%%%.%%%%...........%%............%%.........%%%%%%%....................%%%%%.....%%............................
m %%%%......%%%..........%%.............%..........%%%%...................%%%%%%%%%%%.%%%...........................%
m %%..........%%%......%%%%%............%%..........%.....................%%%.....%%%%%%...........................%%
m %............%%%%..%%%%.%%%...........%%...............................%%%.........%%............................%%
m ..............%%%%%%%....%%%%.........%%...............................%%.......................................%%%
m ................%%%......%%%%%........%%%..............................%%...........................%%....%%%%%%%%.
m ................%%..........%%%%......%%%..............................%%...........................%%%%%%%%%%%%%%.
m ................%%............%%%%....%%%...............................%...................%%%%.....%%%%..........
m ...............%%...............%%%%%%%%%%%%.............................................%%%%%.....................
m ...............%%................%%%%%%..%%%%%.........................................%%%%%.......................
m %............%%%...................%........%%.........................................%%%%........................
m %%%......%%%%%%%............1..........................................................%%.........................%
m %%%%%%%%%%%%%................................................%%%%......................%%........................%%
m %.%%%%%%%..................................................%%%%%%%....0...............%%.........................%%
m ....%%%....................................................%%%%%%%%...................%%........................%%%
m .....%.........................................%%..........%%%..%%%%%...............%%%%.......................%%%.
m ...............................................%%..........%%%.....%%%............%%%%%........................%%..
m ...............................%...............%%...........%%......%%%%%.....%%%%%%%.........................%%...
m ...........................%%%%%%%.............%%...........%%........%%%%%.%%%%%%%..........................%%....
m ........................%%%%%%.%%%%...........%%............%%.........%%%%%%%....................%%%%%.....%%.....
m ......................%%%%%......%%%..........%%.............%..........%%%%...................%%%%%%%%%%%.%%%.....
m .....................%%%%..........%%%......%%%%%............%%..........%.....................%%%.....%%%%%%......
m .....................%%%............%%%%..%%%%.%%%...........%%...............................%%%.........%%.......
m ....................%%%..............%%%%%%%....%%%%.........%%...............................%%...................
m ........%%....%%%%%%%%.................%%%......%%%%%........%%%..............................%%...................
m ........%%%%%%%%%%%%%%.................%%..........%%%%......%%%..............................%%...................
m %%%%.....%%%%..........................%%............%%%%....%%%...............................%...................
m %%....................................%%...............%%%%%%%%%%%%.............................................%%%
m ......................................%%................%%%%%%..%%%%%.........................................%%%%%
m .......................%............%%%...................%........%%.........................................%%%%.
m ......................%%%%......%%%%%%%............2..........................................................%%...
m .....................%%%%%%%%%%%%%%%................................................%%%%......................%%...
m .....................%%%.%%%%%%%..................................................%%%%%%%....1...............%%....
m ....................%%%....%%%....................................................%%%%%%%%...................%%....
m ...................%%%......%.........................................%%..........%%%..%%%%%...............%%%%....
m ...................%%.................................................%%..........%%%.....%%%............%%%%%.....
m ..................%%..................................%...............%%...........%%......%%%%%.....%%%%%%%.......
m .................%%...............................%%%%%%%.............%%...........%%........%%%%%.%%%%%%%.........
m ......%%%%%.....%%.............................%%%%%%.%%%%...........%%............%%.........%%%%%%%..............
m ...%%%%%%%%%%%.%%%...........................%%%%%......%%%..........%%.............%..........%%%%................
m ...%%%.....%%%%%%...........................%%%%..........%%%......%%%%%............%%..........%..................
m ..%%%.........%%............................%%%............%%%%..%%%%.%%%...........%%.............................
m ..%%.......................................%%%..............%%%%%%%....%%%%.........%%.............................
m ..%%...........................%%....%%%%%%%%.................%%%......%%%%%........%%%............................
m ..%%...........................%%%%%%%%%%%%%%.................%%..........%%%%......%%%............................
m ...%...................%%%%.....%%%%..........................%%............%%%%....%%%............................
m ....................%%%%%....................................%%...............%%%%%%%%%%%%.........................
m ..................%%%%%......................................%%................%%%%%%..%%%%%.......................
m ..................%%%%........................%............%%%...................%........%%.......................
m ..................%%.........................%%%%......%%%%%%%............3........................................
m ..................%%........................%%%%%%%%%%%%%%%................................................%%%%....
m .2...............%%.........................%%%.%%%%%%%..................................................%%%%%%%...
m .................%%........................%%%....%%%....................................................%%%%%%%%..
m ...............%%%%.......................%%%......%.........................................%%..........%%%..%%%%%
m %............%%%%%........................%%.................................................%%..........%%%.....%%
m %%%%.....%%%%%%%.........................%%..................................%...............%%...........%%......%
m .%%%%%.%%%%%%%..........................%%...............................%%%%%%%.............%%...........%%.......
m ..%%%%%%%....................%%%%%.....%%.............................%%%%%%.%%%%...........%%............%%.......
m ...%%%%...................%%%%%%%%%%%.%%%...........................%%%%%......%%%..........%%.............%.......
m ....%.....................%%%.....%%%%%%...........................%%%%..........%%%......%%%%%............%%......
m .........................%%%.........%%............................%%%............%%%%..%%%%.%%%...........%%......
m .........................%%.......................................%%%..............%%%%%%%....%%%%.........%%......
m .........................%%...........................%%....%%%%%%%%.................%%%......%%%%%........%%%.....
m .........................%%...........................%%%%%%%%%%%%%%.................%%..........%%%%......%%%.....
m ..........................%...................%%%%.....%%%%..........................%%............%%%%....%%%.....
m ...........................................%%%%%....................................%%...............%%%%%%%%%%%%..
m .........................................%%%%%......................................%%................%%%%%%..%%%%%
m .........................................%%%%........................%............%%%...................%........%%
m .........................................%%.........................%%%%......%%%%%%%............4.................
m ...............%%%%......................%%........................%%%%%%%%%%%%%%%.................................
m .............%%%%%%%....3...............%%.........................%%%.%%%%%%%.....................................
m .............%%%%%%%%...................%%........................%%%....%%%.......................................
m .%%..........%%%..%%%%%...............%%%%.......................%%%......%........................................
