# map type: cell maze
# random seed: 33539169
# players 4
# area 12405, 3101 (55.7^2) per player
# cell width: 1.13233073448
# cell size: 7.30965322286
# openness: 0.177307433324
# maze type growing
# vert_mirror
# horz_rotate
# final parameters
# area: 11904
# grid size: (2, 2)
# tile size: (62, 48) 0.774193548387
# map size: (124, 96) 0.774193548387
# hill distance  26,110  10, 17  10,106  69, 13  10,114  69,110  85,  9  85,106  85, 17  26, 13  85,114  10,  9
#        26,110       0      65      20      80      20      55      60      41      76      69      41      49 
#        10, 17      65       0      61      41      45      76      37      72      21      20      56      16 
#        10,106      20      61       0      76      16      41      56      21      72      65      37      45 
#        69, 13      80      41      76       0      60      69      20      65      20      55      49      41 
#        10,114      20      45      16      60       0      41      40      37      56      49      21      29 
#        69,110      55      76      41      69      41       0      49      20      65      80      20      60 
#        85,  9      60      37      56      20      40      49       0      45      16      41      29      21 
#        85,106      41      72      21      65      37      20      45       0      61      76      16      56 
#        85, 17      76      21      72      20      56      65      16      61       0      41      45      37 
#        26, 13      69      20      65      55      49      80      41      76      41       0      60      20 
#        85,114      41      56      37      49      21      20      29      16      45      60       0      40 
#        10,  9      49      16      45      41      29      60      21      56      37      20      40       0 
players 4
rows 96
cols 124
m .............%%........................%..........%......................%..........%........................%%.............
m .............%%.......................%%.........%%......................%%.........%%.......................%%.............
m .............%%.......................%..........%%......................%%..........%.......................%%.............
m .............%%.......................%..........%........................%..........%.......................%%.............
m .............%%.......................%.........%%%......................%%%.........%.......................%%.............
m .............%%......................%%........%%%%......................%%%%........%%......................%%.............
m ......%%.....%.......................%........%%..%%....................%%..%%........%.......................%.....%%......
m ......%......%........%.........%............%%....%....................%....%%............%.........%........%......%......
m ......%......%........%........%............%%......%..................%......%%............%........%........%......%......
m .....%.......%........%%......%............%%.......%..................%.......%%............%......%%........%.......%.....
m .....%...0...%...0....%.......%..........%%%........%%................%%........%%%..........%.......%....1...%...1...%.....
m ....%%.......%........%.......%..........%%.........%..................%.........%%..........%.......%........%.......%%....
m ....%........%.......%........%%.........%%.........%..................%.........%%.........%%........%.......%........%....
m ....%........%.......%.........%.........%%........%....................%........%%.........%.........%.......%........%....
m .....%..............%%.........%..........%%.......%....................%.......%%..........%.........%%..............%.....
m .....%%...........%%%%%........%...........%%.....%%....................%%.....%%...........%........%%%%%...........%%.....
m ......%%..........%...%%.......%%..........%%.....%......................%.....%%..........%%.......%%...%..........%%......
m ......%%.........%%.....%%.....%%..........%.......%....................%.......%..........%%.....%%.....%%.........%%......
m ......%%.........%.......%%.....%%.........%........%..................%........%.........%%.....%%.......%.........%%......
m ......%%.........%.......%%......%.........%........%%................%%........%.........%......%%.......%.........%%......
m .......%%.......%%.......%.......%.........%.........%%..............%%.........%.........%.......%.......%%.......%%.......
m ........%%......%........%.......%%........%..........%%............%%..........%........%%.......%........%......%%........
m .........%......%.......%.........%........%.........%%..............%%.........%........%.........%.......%......%.........
m .........%..............%.........%.......%%.........%................%.........%%.......%.........%..............%.........
m .........%.............%%.........%%.......%%..................................%%.......%%.........%%.............%.........
m .........%............%%...........%........%%................................%%........%...........%%............%.........
m .........%...3......%%%...........%%....................................................%%...........%%%......2...%.........
m .........%.......................%%......................................................%%.......................%.........
m .........%.....................%%%........................................................%%%.....................%.........
m .........%%%...................%............................................................%...................%%%.........
m ...........%%%................%%.............%................................%.............%%................%%%...........
m .............%%%..............%.............%%%%.....%................%.....%%%%.............%..............%%%.............
m %%............%%%%%..........%%............%%...%%%.%..................%.%%%...%%............%%..........%%%%%............%%
m .%%...............%%.........%............%%......%%....................%%......%%............%.........%%...............%%.
m ..%%...............%........%%..........%%%......................................%%%..........%%........%...............%%..
m ...%%...............%........%..........%%........................................%%..........%........%...............%%...
m ....%%..............%.........%.........%..........................................%.........%.........%..............%%....
m .....%%.......................%.........%..........................................%.........%.......................%%.....
m ......%%.......................%........%..........................................%........%.......................%%......
m .......%%...............................%..........................................%...............................%%.......
m ........%................................%........%.........%%%%.........%........%................................%........
m ..................................................%%.....%%%%..%%%%.....%%..................................................
m ...................................................%%.%%%%........%%%%.%%...................................................
m ....................................................%%%..............%%%....................................................
m ............................................................................................................................
m ............................................................................................................................
m ............................................................................................................................
m ............................................................................................................................
m ............................................................................................................................
m ............................................................................................................................
m ............................................................................................................................
m ............................................................................................................................
m ....................................................%%%..............%%%....................................................
m ...................................................%%.%%%%........%%%%.%%...................................................
m ..................................................%%.....%%%%..%%%%.....%%..................................................
m ........%................................%........%.........%%%%.........%........%................................%........
m .......%%...............................%..........................................%...............................%%.......
m ......%%.......................%........%..........................................%........%.......................%%......
m .....%%.......................%.........%..........................................%.........%.......................%%.....
m ....%%..............%.........%.........%..........................................%.........%.........%..............%%....
m ...%%...............%........%..........%%........................................%%..........%........%...............%%...
m ..%%...............%........%%..........%%%......................................%%%..........%%........%...............%%..
m .%%...............%%.........%............%%......%%....................%%......%%............%.........%%...............%%.
m %%............%%%%%..........%%............%%...%%%.%..................%.%%%...%%............%%..........%%%%%............%%
m .............%%%..............%.............%%%%.....%................%.....%%%%.............%..............%%%.............
m ...........%%%................%%.............%................................%.............%%................%%%...........
m .........%%%...................%............................................................%...................%%%.........
m .........%.....................%%%........................................................%%%.....................%.........
m .........%.......................%%......................................................%%.......................%.........
m .........%...0......%%%...........%%....................................................%%...........%%%......1...%.........
m .........%............%%...........%........%%................................%%........%...........%%............%.........
m .........%.............%%.........%%.......%%..................................%%.......%%.........%%.............%.........
m .........%..............%.........%.......%%.........%................%.........%%.......%.........%..............%.........
m .........%......%.......%.........%........%.........%%..............%%.........%........%.........%.......%......%.........
m ........%%......%........%.......%%........%..........%%............%%..........%........%%.......%........%......%%........
m .......%%.......%%.......%.......%.........%.........%%..............%%.........%.........%.......%.......%%.......%%.......
m ......%%.........%.......%%......%.........%........%%................%%........%.........%......%%.......%.........%%......
m ......%%.........%.......%%.....%%.........%........%..................%........%.........%%.....%%.......%.........%%......
m ......%%.........%%.....%%.....%%..........%.......%....................%.......%..........%%.....%%.....%%.........%%......
m ......%%..........%...%%.......%%..........%%.....%......................%.....%%..........%%.......%%...%..........%%......
m .....%%...........%%%%%........%...........%%.....%%....................%%.....%%...........%........%%%%%...........%%.....
m .....%..............%%.........%..........%%.......%....................%.......%%..........%.........%%..............%.....
m ....%........%.......%.........%.........%%........%....................%........%%.........%.........%.......%........%....
m ....%........%.......%........%%.........%%.........%..................%.........%%.........%%........%.......%........%....
m ....%%.......%........%.......%..........%%.........%..................%.........%%..........%.......%........%.......%%....
m .....%...3...%...3....%.......%..........%%%........%%................%%........%%%..........%.......%....2...%...2...%.....
m .....%.......%........%%......%............%%.......%..................%.......%%............%......%%........%.......%.....
m ......%......%........%........%............%%......%..................%......%%............%........%........%......%......
m ......%......%........%.........%............%%....%....................%....%%............%.........%........%......%......
m ......%%.....%.......................%........%%..%%....................%%..%%........%.......................%.....%%......
m .............%%......................%%........%%%%......................%%%%........%%......................%%.............
m .............%%.......................%.........%%%......................%%%.........%.......................%%.............
m .............%%.......................%..........%........................%..........%.......................%%.............
m .............%%.......................%..........%%......................%%..........%.......................%%.............
m .............%%.......................%%.........%%......................%%.........%%.......................%%.............
m .............%%........................%..........%......................%..........%........................%%.............
