# random seed 7762856881758027127
# players 5
# area 15825
# cell width: 5.20757906686
# cell size: 11
# openness: 0.11307447984
# grid size: (1, 5)
# tile size: (165, 18) 0.109090909091
# map size: (165, 90) 0.545454545455
# horz shear step: 3
# horz_shear
# maze type recursive backtracker
# maze joining 1 to 9 and 12
# maze joining 11 to 9 and 12
# final openness 0.11307447984
# map_type cell_maze
# random_seed 7762856881758027127
players 5
rows 90
cols 165
m %%%..........%%%%%%......%%%%%%................%%%%%%%........%%...%%%...........%%%%%%%..........%%%%%%...........%%%%%%.....................%%............%%%%%%%%%
m %%..........%%%%%%%%....%%%%%%%...............%%%%%%%..........%....%%............%%%%%%..........%%%%%%..........%%%%%%...................%%.%%%...........%%%%%%%%%
m ...........%%%%%%%......%%%%%%............%%%%%%%%%%..............................%%%%%%..........%%%%%%.........%%%%%%%..................%%%%%%%%...........%%%%%%%%
m ...........%%%%%%.......%%%%%%............%%%%%%%%%...............................%%%%%%..........%%%%%%%.......%%%%%%%.................%%%%%%%%%%%%.........%%%%%%%.
m ..........%%%%%%........%%%%%%...........%%%%%%%%%...................%...........%%%%%%%%.........%%%%%%%.....%%%%%%%%%..............%%%%%%%%%%%%%%%%.........%%%%%..
m ........%%%%%%%%.........%%%%%...........%%%%%%%%....................%%.........%%%%%%%%%%.........%%%%%%%%%%%%%%%%%%%...............%%%%%%%%%%%%%%%%%.......%%%%%%..
m ........%%%%%%%..........%%%%%............%%%%%%%...............................%%%%%%%%%%..........%%%%%%%%%%%%%%%%................%%%%%%%%%.%%%%%%%%%......%%%%%%..
m .......%%%%%%%%..........%%%%%%............%%%%%%................................%%%%%%%%%..........%%%%%%%%%%%%%%%.................%%%%%%%.....%%%%%%%%%...%%%%%%...
m .......%%%%%%%%%.........%%%%%%%............%%%%%.................................%%%%%%%%..........%%%%%%%%%%%%%%.................%%%%%%%.......%%%%%%%%%..%%%%%%...
m .......%%%%%%%%%.........%%%%%%%%............%%%%................................%%%%%%%%%..........%%%%%%%%%%%%%.................%%%%%%%.........%%%%%%%%%%%%%%%%...
m .........%%%%%%%%........%%%%%%%%%%...........................%%.................%%%%%%%%%.........%%%%%%%%...%%..................%%%%%%...........%%%%%%%%%%%%%%%...
m ...........%%%%%%%........%%%%%%%%%%%......................%%%%%%.................%..%%%%%%........%%%%%%%.......................%%%%%%%............%%%%%%%%%%%%%%...
m ............%%%%%%%.........%%%%%%%%%%.................%%%%%%%%%%....................%%%%%%........%%%%%%.......................%%%%%%%..............%%%%%%%%%%%%%...
m .............%%%%%%%%.........%%%%%%%%............%%%%%%%%%%%%%%......................%%%%%%......%%%%%%.......................%%%%%%%%...............%%%%%%%%%%%%%..
m %%%%%.........%%%%%%%%.........%%%%%%%............%%%%%%%%%%%%%%......................%%%%%%%.....%%%%%........................%%%%%%%................%%%%%%%%%%%%%%%
m %%%%%%........%%%%%%%%..........%%%%%%............%%%%%%%%%%%%%.......................%%%%%%%%%..%%%%%%.......................%%%%%%%%...............%%%%%%%%%%%%%%%%
m %%%%%%.........%%%%%%%.....2....%%%%%%...........%%%%%%%%%%%%%..........................%%%%%%%%%%%%%%...........%%%%........%%%%%%%................%%%%%%%%..%%%%%%%
m %%%%%..........%%%%%%%..........%%%%%%...........%%%%%%%%%...................%...........%%%%%%%%%%%%%..........%%%%%.......%%%%%%%................%%%%%%%%.....%%%..
m .%%%...........%%%%%%%..........%%%%%%...........%%%%%%.....................%%............%%%%%%%%%%%%..........%%%%%%......%%%%%%................%%%%%%%........%%..
m ..%%............%%%%%%..........%%%%%%..........%%%%%%...................%%.%%%...........%%%%%%%%%%%..........%%%%%%%%....%%%%%%%...............%%%%%%%..........%..
m ................%%%%%%..........%%%%%%.........%%%%%%%..................%%%%%%%%...........%%%%%%%%...........%%%%%%%......%%%%%%............%%%%%%%%%%..............
m ................%%%%%%..........%%%%%%%.......%%%%%%%.................%%%%%%%%%%%%.........%%%%%%%............%%%%%%.......%%%%%%............%%%%%%%%%...............
m ...%...........%%%%%%%%.........%%%%%%%.....%%%%%%%%%..............%%%%%%%%%%%%%%%%.........%%%%%............%%%%%%........%%%%%%...........%%%%%%%%%................
m ...%%.........%%%%%%%%%%.........%%%%%%%%%%%%%%%%%%%...............%%%%%%%%%%%%%%%%%.......%%%%%%..........%%%%%%%%.........%%%%%...........%%%%%%%%.................
m ..............%%%%%%%%%%..........%%%%%%%%%%%%%%%%................%%%%%%%%%.%%%%%%%%%......%%%%%%..........%%%%%%%..........%%%%%............%%%%%%%.................
m ...............%%%%%%%%%..........%%%%%%%%%%%%%%%.................%%%%%%%.....%%%%%%%%%...%%%%%%..........%%%%%%%%..........%%%%%%............%%%%%%.................
m ................%%%%%%%%..........%%%%%%%%%%%%%%.................%%%%%%%.......%%%%%%%%%..%%%%%%..........%%%%%%%%%.........%%%%%%%............%%%%%.................
m ...............%%%%%%%%%..........%%%%%%%%%%%%%.................%%%%%%%.........%%%%%%%%%%%%%%%%..........%%%%%%%%%.........%%%%%%%%............%%%%.................
m ...............%%%%%%%%%.........%%%%%%%%...%%..................%%%%%%...........%%%%%%%%%%%%%%%............%%%%%%%%........%%%%%%%%%%...........................%%..
m ................%..%%%%%%........%%%%%%%.......................%%%%%%%............%%%%%%%%%%%%%%..............%%%%%%%........%%%%%%%%%%%......................%%%%%%.
m ...................%%%%%%........%%%%%%.......................%%%%%%%..............%%%%%%%%%%%%%...............%%%%%%%.........%%%%%%%%%%.................%%%%%%%%%%.
m ....................%%%%%%......%%%%%%.......................%%%%%%%%...............%%%%%%%%%%%%%...............%%%%%%%%.........%%%%%%%%............%%%%%%%%%%%%%%..
m ....................%%%%%%%.....%%%%%........................%%%%%%%................%%%%%%%%%%%%%%%%%%%%.........%%%%%%%%.........%%%%%%%............%%%%%%%%%%%%%%..
m ....................%%%%%%%%%..%%%%%%.......................%%%%%%%%...............%%%%%%%%%%%%%%%%%%%%%%........%%%%%%%%..........%%%%%%............%%%%%%%%%%%%%...
m ......................%%%%%%%%%%%%%%...........%%%%........%%%%%%%................%%%%%%%%..%%%%%%%%%%%%%.........%%%%%%%.....3....%%%%%%...........%%%%%%%%%%%%%....
m ...........%...........%%%%%%%%%%%%%..........%%%%%.......%%%%%%%................%%%%%%%%.....%%%..%%%%%..........%%%%%%%..........%%%%%%...........%%%%%%%%%........
m ..........%%............%%%%%%%%%%%%..........%%%%%%......%%%%%%................%%%%%%%........%%...%%%...........%%%%%%%..........%%%%%%...........%%%%%%...........
m .......%%.%%%...........%%%%%%%%%%%..........%%%%%%%%....%%%%%%%...............%%%%%%%..........%....%%............%%%%%%..........%%%%%%..........%%%%%%............
m ......%%%%%%%%...........%%%%%%%%...........%%%%%%%......%%%%%%............%%%%%%%%%%..............................%%%%%%..........%%%%%%.........%%%%%%%............
m ....%%%%%%%%%%%%.........%%%%%%%............%%%%%%.......%%%%%%............%%%%%%%%%...............................%%%%%%..........%%%%%%%.......%%%%%%%.............
m .%%%%%%%%%%%%%%%%.........%%%%%............%%%%%%........%%%%%%...........%%%%%%%%%...................%...........%%%%%%%%.........%%%%%%%.....%%%%%%%%%.............
m .%%%%%%%%%%%%%%%%%.......%%%%%%..........%%%%%%%%.........%%%%%...........%%%%%%%%....................%%.........%%%%%%%%%%.........%%%%%%%%%%%%%%%%%%%..............
m %%%%%%%%%.%%%%%%%%%......%%%%%%..........%%%%%%%..........%%%%%............%%%%%%%...............................%%%%%%%%%%..........%%%%%%%%%%%%%%%%................
m %%%%%%%.....%%%%%%%%%...%%%%%%..........%%%%%%%%..........%%%%%%............%%%%%%................................%%%%%%%%%..........%%%%%%%%%%%%%%%.................
m %%%%%%.......%%%%%%%%%..%%%%%%..........%%%%%%%%%.........%%%%%%%............%%%%%.................................%%%%%%%%..........%%%%%%%%%%%%%%.................%
m %%%%%.........%%%%%%%%%%%%%%%%..........%%%%%%%%%.........%%%%%%%%............%%%%................................%%%%%%%%%..........%%%%%%%%%%%%%.................%%
m %%%%...........%%%%%%%%%%%%%%%............%%%%%%%%........%%%%%%%%%%...........................%%.................%%%%%%%%%.........%%%%%%%%...%%..................%%
m %%%%............%%%%%%%%%%%%%%..............%%%%%%%........%%%%%%%%%%%......................%%%%%%.................%..%%%%%%........%%%%%%%.......................%%%
m %%%..............%%%%%%%%%%%%%...............%%%%%%%.........%%%%%%%%%%.................%%%%%%%%%%....................%%%%%%........%%%%%%.......................%%%%
m %%%...............%%%%%%%%%%%%%...............%%%%%%%%.........%%%%%%%%............%%%%%%%%%%%%%%......................%%%%%%......%%%%%%.......................%%%%%
m %%................%%%%%%%%%%%%%%%%%%%%.........%%%%%%%%.........%%%%%%%............%%%%%%%%%%%%%%......................%%%%%%%.....%%%%%........................%%%%%
m %%...............%%%%%%%%%%%%%%%%%%%%%%........%%%%%%%%..........%%%%%%............%%%%%%%%%%%%%.......................%%%%%%%%%..%%%%%%.......................%%%%%%
m ................%%%%%%%%..%%%%%%%%%%%%%.........%%%%%%%.....1....%%%%%%...........%%%%%%%%%%%%%..........................%%%%%%%%%%%%%%...........%%%%........%%%%%%%
m ...............%%%%%%%%.....%%%..%%%%%..........%%%%%%%..........%%%%%%...........%%%%%%%%%...................%...........%%%%%%%%%%%%%..........%%%%%.......%%%%%%%.
m ..............%%%%%%%........%%...%%%...........%%%%%%%..........%%%%%%...........%%%%%%.....................%%............%%%%%%%%%%%%..........%%%%%%......%%%%%%..
m .............%%%%%%%..........%....%%............%%%%%%..........%%%%%%..........%%%%%%...................%%.%%%...........%%%%%%%%%%%..........%%%%%%%%....%%%%%%%..
m .........%%%%%%%%%%..............................%%%%%%..........%%%%%%.........%%%%%%%..................%%%%%%%%...........%%%%%%%%...........%%%%%%%......%%%%%%...
m .........%%%%%%%%%...............................%%%%%%..........%%%%%%%.......%%%%%%%.................%%%%%%%%%%%%.........%%%%%%%............%%%%%%.......%%%%%%...
m ........%%%%%%%%%...................%...........%%%%%%%%.........%%%%%%%.....%%%%%%%%%..............%%%%%%%%%%%%%%%%.........%%%%%............%%%%%%........%%%%%%...
m ........%%%%%%%%....................%%.........%%%%%%%%%%.........%%%%%%%%%%%%%%%%%%%...............%%%%%%%%%%%%%%%%%.......%%%%%%..........%%%%%%%%.........%%%%%...
m .........%%%%%%%...............................%%%%%%%%%%..........%%%%%%%%%%%%%%%%................%%%%%%%%%.%%%%%%%%%......%%%%%%..........%%%%%%%..........%%%%%...
m ..........%%%%%%................................%%%%%%%%%..........%%%%%%%%%%%%%%%.................%%%%%%%.....%%%%%%%%%...%%%%%%..........%%%%%%%%..........%%%%%%..
m ...........%%%%%.................................%%%%%%%%..........%%%%%%%%%%%%%%.................%%%%%%%.......%%%%%%%%%..%%%%%%..........%%%%%%%%%.........%%%%%%%.
m ............%%%%................................%%%%%%%%%..........%%%%%%%%%%%%%.................%%%%%%%.........%%%%%%%%%%%%%%%%..........%%%%%%%%%.........%%%%%%%%
m %%...........................%%.................%%%%%%%%%.........%%%%%%%%...%%..................%%%%%%...........%%%%%%%%%%%%%%%............%%%%%%%%........%%%%%%%%
m %%%%......................%%%%%%.................%..%%%%%%........%%%%%%%.......................%%%%%%%............%%%%%%%%%%%%%%..............%%%%%%%........%%%%%%%
m %%%%%.................%%%%%%%%%%....................%%%%%%........%%%%%%.......................%%%%%%%..............%%%%%%%%%%%%%...............%%%%%%%.........%%%%%
m %%%%%............%%%%%%%%%%%%%%......................%%%%%%......%%%%%%.......................%%%%%%%%...............%%%%%%%%%%%%%...............%%%%%%%%.........%%%
m %%%%%............%%%%%%%%%%%%%%......................%%%%%%%.....%%%%%........................%%%%%%%................%%%%%%%%%%%%%%%%%%%%.........%%%%%%%%.........%%
m %%%%%............%%%%%%%%%%%%%.......................%%%%%%%%%..%%%%%%.......................%%%%%%%%...............%%%%%%%%%%%%%%%%%%%%%%........%%%%%%%%..........%
m %%%%%...........%%%%%%%%%%%%%..........................%%%%%%%%%%%%%%...........%%%%........%%%%%%%................%%%%%%%%..%%%%%%%%%%%%%.........%%%%%%%.....0....%
m %%%%%...........%%%%%%%%%...................%...........%%%%%%%%%%%%%..........%%%%%.......%%%%%%%................%%%%%%%%.....%%%..%%%%%..........%%%%%%%..........%
m %%%%%...........%%%%%%.....................%%............%%%%%%%%%%%%..........%%%%%%......%%%%%%................%%%%%%%........%%...%%%...........%%%%%%%..........%
m %%%%%..........%%%%%%...................%%.%%%...........%%%%%%%%%%%..........%%%%%%%%....%%%%%%%...............%%%%%%%..........%....%%............%%%%%%..........%
m %%%%%.........%%%%%%%..................%%%%%%%%...........%%%%%%%%...........%%%%%%%......%%%%%%............%%%%%%%%%%..............................%%%%%%..........%
m %%%%%%.......%%%%%%%.................%%%%%%%%%%%%.........%%%%%%%............%%%%%%.......%%%%%%............%%%%%%%%%...............................%%%%%%..........%
m %%%%%%.....%%%%%%%%%..............%%%%%%%%%%%%%%%%.........%%%%%............%%%%%%........%%%%%%...........%%%%%%%%%...................%...........%%%%%%%%.........%
m %%%%%%%%%%%%%%%%%%%...............%%%%%%%%%%%%%%%%%.......%%%%%%..........%%%%%%%%.........%%%%%...........%%%%%%%%....................%%.........%%%%%%%%%%.........
m .%%%%%%%%%%%%%%%%................%%%%%%%%%.%%%%%%%%%......%%%%%%..........%%%%%%%..........%%%%%............%%%%%%%...............................%%%%%%%%%%.........
m .%%%%%%%%%%%%%%%.................%%%%%%%.....%%%%%%%%%...%%%%%%..........%%%%%%%%..........%%%%%%............%%%%%%................................%%%%%%%%%.........
m .%%%%%%%%%%%%%%.................%%%%%%%.......%%%%%%%%%..%%%%%%..........%%%%%%%%%.........%%%%%%%............%%%%%.................................%%%%%%%%.........
m .%%%%%%%%%%%%%.................%%%%%%%.........%%%%%%%%%%%%%%%%..........%%%%%%%%%.........%%%%%%%%............%%%%................................%%%%%%%%%.........
m %%%%%%%%...%%..................%%%%%%...........%%%%%%%%%%%%%%%............%%%%%%%%........%%%%%%%%%%...........................%%.................%%%%%%%%%.........
m %%%%%%%.......................%%%%%%%............%%%%%%%%%%%%%%..............%%%%%%%........%%%%%%%%%%%......................%%%%%%.................%..%%%%%%........
m %%%%%%.......................%%%%%%%..............%%%%%%%%%%%%%...............%%%%%%%.........%%%%%%%%%%.................%%%%%%%%%%....................%%%%%%........
m %%%%%.......................%%%%%%%%...............%%%%%%%%%%%%%...............%%%%%%%%.........%%%%%%%%............%%%%%%%%%%%%%%......................%%%%%%......%
m %%%%........................%%%%%%%................%%%%%%%%%%%%%%%%%%%%.........%%%%%%%%.........%%%%%%%............%%%%%%%%%%%%%%......................%%%%%%%.....%
m %%%%.......................%%%%%%%%...............%%%%%%%%%%%%%%%%%%%%%%........%%%%%%%%..........%%%%%%............%%%%%%%%%%%%%.......................%%%%%%%%%..%%
m %%%...........%%%%........%%%%%%%................%%%%%%%%..%%%%%%%%%%%%%.........%%%%%%%.....4....%%%%%%...........%%%%%%%%%%%%%..........................%%%%%%%%%%%
m %%%..........%%%%%.......%%%%%%%................%%%%%%%%.....%%%..%%%%%..........%%%%%%%..........%%%%%%...........%%%%%%%%%...................%...........%%%%%%%%%%
