# map type: blank
# random seed: -1117698561
# hill distance 114,111  58, 53  86, 82   2,140  30, 24
#       114,111       0     136      79      79     136 
#        58, 53     136       0      79     136      79 
#        86, 82      79      79       0     136     136 
#         2,140      79     136     136       0      79 
#        30, 24     136      79     136      79       0 
players 5
rows 140
cols 145
m ...........................%%%.....................%..........%%.....%%.......%%................%%........%%.......%...........%......%%.........
m .............................%%%...................%.........%%......%%.......................%%%.........%.........%.................%..........
m .....%%%.....................%%%%%.......%%........%........%%........%......................%%..........%%.........%.................%.....4....
m ..%%%..%%....................%...%%%....%%.........%........%.........%....................%%...........%%..........%.................%..........
m .%.......%%...%%............%......%%%%%...........%........%.........%....................%............%%...........%................%%.........
m %%........%%%%%.............%........%%..........%%%......%%%.........%%..................%%............%.............%...............%..........
m %..........................%.............................%%............%..................%..............%.............%.............%%.........%
m ...........................%..............................................................%..............%..............%%...........%..........%
m ..........................%..................................................%...........%%..............%%%.............%%%........%%.........%%
m ..........................%...........%%.........................%%..........%%........%%%.................%.............%%.........%..........%%
m .........................%...........%%%%%.......................%%..........%........%%....................%............%%........%%............
m .......................%%............%...%%%.....................%%..........%..............................%%...........%......%%%..............
m ..........%............%............%......%%%...................%%.........%................................%..........%%.......................
m ..........%%...........%...........%.........%%%.................%%........%%...................%............%%.........%........................
m .....%.....%%.....................%%..........%%%%................%%%.....%%....................%.............%.........%........................
m ....%%......%%...............................%%..%%%....%%%.........%%%.%%......................%%............%........%%.................%%%....
m ....%........%%.............................%%.....%%%%%..%%%%........%%........................%%.............%.......%..................%%%%...
m ....%.........%%............................%........%.......%.................................%%%%............%......%%.................%%..%%..
m ...%%........%%%%..........................%..................................................%%..%%...........%%.....%%.................%....%%%
m %%%%.........%%...........................%%.................................................%%....%%...........%%......................%.......%
m ............%................%%%%%%%.....%%.........................................%%......%%......%%...........%%....................%%........
m ...........%...............%%%%.....%....%............................%...........%%.......%%........%............%............%%......%.........
m ..........%...............%....................................%%%%%%%%%.........%...................%............%............%.................
m ......%%%%................%....................................%.......%%..%%%%%%....................%...........%%............%.................
m .......%%%...............%..............................................%%%%%...%....................%...........%%............%.................
m .........%..........%%%%%%.........................%%%..........................%....................%%..........%............%%.........%%......
m ..........%........%%%..........................%%%..%%.........................%...................%%%%%.....................%.........%%....%..
m ..........%........%...........................%.......%%.......................%...........%......%%....%%%..................%.........%......%.
m ...........%......%%....................................%%%.....................%..........%%.....%%.......%%................%%........%%.......%
m %.................%.......................................%%%...................%.........%%......%%.......................%%%.........%.........
m %.................%.....0.........%%%.....................%%%%%.......%%........%........%%........%......................%%..........%%.........
m %.................%............%%%..%%....................%...%%%....%%.........%........%.........%....................%%...........%%..........
m .%................%%..........%.......%%...%%............%......%%%%%...........%........%.........%....................%............%%..........
m ..%...............%..........%%........%%%%%.............%........%%..........%%%......%%%.........%%..................%%............%...........
m ...%.............%%.........%%..........................%.............................%%............%..................%..............%..........
m ....%%...........%..........%...........................%..............................................................%..............%..........
m .....%%%........%%.........%%..........................%..................................................%...........%%..............%%%........
m .....%%.........%..........%%..........................%...........%%.........................%%..........%%........%%%.................%........
m .....%%........%%.....................................%...........%%%%%.......................%%..........%........%%....................%.......
m .....%......%%%.....................................%%............%...%%%.....................%%..........%..............................%%......
m ....%%.................................%............%............%......%%%...................%%.........%................................%......
m ....%..................................%%...........%...........%.........%%%.................%%........%%...................%............%%.....
m ....%.............................%.....%%.....................%%..........%%%%................%%%.....%%....................%.............%.....
m ...%%.................%%%........%%......%%...............................%%..%%%....%%%.........%%%.%%......................%%............%.....
m ...%..................%%%%.......%........%%.............................%%.....%%%%%..%%%%........%%........................%%.............%....
m ..%%.................%%..%%......%.........%%............................%........%.......%.................................%%%%............%....
m ..%%.................%....%%%...%%........%%%%..........................%..................................................%%..%%...........%%...
m ....................%.......%%%%%.........%%...........................%%.................................................%%....%%...........%%..
m ...................%%....................%................%%%%%%%.....%%.........................................%%......%%......%%...........%%.
m ...........%%......%....................%...............%%%%.....%....%............................%...........%%.......%%........%............%.
m ...........%...........................%...............%....................................%%%%%%%%%.........%...................%............%.
m ...........%.......................%%%%................%....................................%.......%%..%%%%%%....................%...........%%.
m ...........%........................%%%...............%..............................................%%%%%...%....................%...........%%.
m ..........%%.........%%...............%..........%%%%%%.........................%%%..........................%....................%%..........%..
m ..........%.........%%....%............%........%%%..........................%%%..%%.........................%...................%%%%%...........
m ..........%.........%......%...........%........%...........................%.......%%.......................%...........%......%%....%%%........
m .........%%........%%.......%...........%......%%....................................%%%.....................%..........%%.....%%.......%%.......
m .......%%%.........%.........%.................%.......................................%%%...................%.........%%......%%................
m ......%%..........%%.........%.................%.....1.........%%%.....................%%%%%.......%%........%........%%........%................
m ....%%...........%%..........%.................%............%%%..%%....................%...%%%....%%.........%........%.........%................
m ....%............%%...........%................%%..........%.......%%...%%............%......%%%%%...........%........%.........%................
m ...%%............%.............%...............%..........%%........%%%%%.............%........%%..........%%%......%%%.........%%...............
m ...%..............%.............%.............%%.........%%..........................%.............................%%............%...............
m ...%..............%..............%%...........%..........%...........................%...........................................................
m ..%%..............%%%.............%%%........%%.........%%..........................%..................................................%.........
m %%%.................%.............%%.........%..........%%..........................%...........%%.........................%%..........%%........
m %....................%............%%........%%.....................................%...........%%%%%.......................%%..........%........%
m .....................%%...........%......%%%.....................................%%............%...%%%.....................%%..........%.........
m ......................%..........%%.................................%............%............%......%%%...................%%.........%..........
m .........%............%%.........%..................................%%...........%...........%.........%%%.................%%........%%..........
m .........%.............%.........%.............................%.....%%.....................%%..........%%%%................%%%.....%%...........
m .........%%............%........%%.................%%%........%%......%%...............................%%..%%%....%%%.........%%%.%%.............
m .........%%.............%.......%..................%%%%.......%........%%.............................%%.....%%%%%..%%%%........%%...............
m ........%%%%............%......%%.................%%..%%......%.........%%............................%........%.......%.........................
m .......%%..%%...........%%.....%%.................%....%%%...%%........%%%%..........................%...........................................
m ......%%....%%...........%%......................%.......%%%%%.........%%...........................%%...........................................
m .....%%......%%...........%%....................%%....................%................%%%%%%%.....%%.........................................%%.
m ....%%........%............%............%%......%....................%...............%%%%.....%....%............................%...........%%...
m ..............%............%............%...........................%...............%....................................%%%%%%%%%.........%.....
m ..............%...........%%............%.......................%%%%................%....................................%.......%%..%%%%%%......
m ..............%...........%%............%........................%%%...............%..............................................%%%%%...%......
m ..............%%..........%............%%.........%%...............%..........%%%%%%.........................%%%..........................%......
m .............%%%%%.....................%.........%%....%............%........%%%..........................%%%..%%.........................%......
m .....%......%%....%%%..................%.........%......%...........%........%...........................%.......%%.......................%......
m ....%%.....%%.......%%................%%........%%.......%...........%......%%....................................%%%.....................%......
m ...%%......%%.......................%%%.........%.........%.................%.......................................%%%...................%......
m ..%%........%......................%%..........%%.........%.................%.....2.........%%%.....................%%%%%.......%%........%......
m ..%.........%....................%%...........%%..........%.................%............%%%..%%....................%...%%%....%%.........%......
m ..%.........%....................%............%%...........%................%%..........%.......%%...%%............%......%%%%%...........%......
m %%%.........%%..................%%............%.............%...............%..........%%........%%%%%.............%........%%..........%%%......
m %............%..................%..............%.............%.............%%.........%%..........................%.............................%
m ................................%..............%..............%%...........%..........%...........................%..............................
m ...................%...........%%..............%%%.............%%%........%%.........%%..........................%...............................
m .......%%..........%%........%%%.................%.............%%.........%..........%%..........................%...........%%..................
m .......%%..........%........%%....................%............%%........%%.....................................%...........%%%%%................
m .......%%..........%..............................%%...........%......%%%.....................................%%............%...%%%..............
m .......%%.........%................................%..........%%.................................%............%............%......%%%............
m .......%%........%%...................%............%%.........%..................................%%...........%...........%.........%%%..........
m ........%%%.....%%....................%.............%.........%.............................%.....%%.....................%%..........%%%%........
m %.........%%%.%%......................%%............%........%%.................%%%........%%......%%...............................%%..%%%....%%
m %%%%........%%........................%%.............%.......%..................%%%%.......%........%%.............................%%.....%%%%%..
m ...%.................................%%%%............%......%%.................%%..%%......%.........%%............................%........%....
m ....................................%%..%%...........%%.....%%.................%....%%%...%%........%%%%..........................%..............
m ...................................%%....%%...........%%......................%.......%%%%%.........%%...........................%%..............
m ..........................%%......%%......%%...........%%....................%%....................%................%%%%%%%.....%%...............
m ............%...........%%.......%%........%............%............%%......%....................%...............%%%%.....%....%................
m .....%%%%%%%%%.........%...................%............%............%...........................%...............%...............................
m .....%.......%%..%%%%%%....................%...........%%............%.......................%%%%................%...............................
m ..............%%%%%...%....................%...........%%............%........................%%%...............%................................
m ......................%....................%%..........%............%%.........%%...............%..........%%%%%%.........................%%%....
m ......................%...................%%%%%.....................%.........%%....%............%........%%%..........................%%%..%%...
m ......................%...........%......%%....%%%..................%.........%......%...........%........%...........................%.......%%.
m %.....................%..........%%.....%%.......%%................%%........%%.......%...........%......%%....................................%%
m %%%...................%.........%%......%%.......................%%%.........%.........%.................%.......................................
m %%%%%.......%%........%........%%........%......................%%..........%%.........%.................%.....3.........%%%.....................
m %...%%%....%%.........%........%.........%....................%%...........%%..........%.................%............%%%..%%....................
m ......%%%%%...........%........%.........%....................%............%%...........%................%%..........%.......%%...%%............%
m ........%%..........%%%......%%%.........%%..................%%............%.............%...............%..........%%........%%%%%.............%
m ............................%%............%..................%..............%.............%.............%%.........%%..........................%.
m .............................................................%..............%..............%%...........%..........%...........................%.
m ................................................%...........%%..............%%%.............%%%........%%.........%%..........................%..
m .........%%.........................%%..........%%........%%%.................%.............%%.........%..........%%..........................%..
m ........%%%%%.......................%%..........%........%%....................%............%%........%%.....................................%...
m ........%...%%%.....................%%..........%..............................%%...........%......%%%.....................................%%....
m .......%......%%%...................%%.........%................................%..........%%.................................%............%.....
m ......%.........%%%.................%%........%%...................%............%%.........%..................................%%...........%.....
m .....%%..........%%%%................%%%.....%%....................%.............%.........%.............................%.....%%................
m ................%%..%%%....%%%.........%%%.%%......................%%............%........%%.................%%%........%%......%%...............
m ...............%%.....%%%%%..%%%%........%%........................%%.............%.......%..................%%%%.......%........%%..............
m ...............%........%.......%.................................%%%%............%......%%.................%%..%%......%.........%%.............
m ..............%..................................................%%..%%...........%%.....%%.................%....%%%...%%........%%%%............
m .............%%.................................................%%....%%...........%%......................%.......%%%%%.........%%..............
m %%%%%%%.....%%.........................................%%......%%......%%...........%%....................%%....................%................
m %%.....%....%............................%...........%%.......%%........%............%............%%......%....................%...............%%
m ..................................%%%%%%%%%.........%...................%............%............%...........................%...............%..
m ..................................%.......%%..%%%%%%....................%...........%%............%.......................%%%%................%..
m ...........................................%%%%%...%....................%...........%%............%........................%%%...............%...
m ......................%%%..........................%....................%%..........%............%%.........%%...............%..........%%%%%%...
m ...................%%%..%%.........................%...................%%%%%.....................%.........%%....%............%........%%%.......
m ..................%.......%%.......................%...........%......%%....%%%..................%.........%......%...........%........%.........
