# map type: cell maze
# random seed: 652336002
# players 10
# area 12439, 1243 (35.3^2) per player
# cell width: 1.69062195294
# cell size: 7.79484223043
# openness: 0.12769222442
# maze type prims
# vert_rotate
# horz_copy
# final parameters
# area: 12000
# grid size: (2, 5)
# tile size: (30, 40) 1.33333333333
# map size: (60, 200) 3.33333333333
# hill distance  44,  5  44, 85  44,125  15, 74  15,114  15,194  44, 45  44,165  15, 34  15,154
#        44,  5       0     110     110     106     120      40      70      70      66      80 
#        44, 85     110       0      70      40      66     120      70     110      80     106 
#        44,125     110      70       0      80      40     106     110      70     120      66 
#        15, 74     106      40      80       0      70     110      66     120      70     110 
#        15,114     120      66      40      70       0     110     106      80     110      70 
#        15,194      40     120     106     110     110       0      80      66      70      70 
#        44, 45      70      70     110      66     106      80       0     110      40     120 
#        44,165      70     110      70     120      80      66     110       0     106      40 
#        15, 34      66      80     120      70     110      70      40     106       0     110 
#        15,154      80     106      66     110      70      70     120      40     110       0 
players 10
rows 60
cols 200
m %%........................%............%%%........................%............%%%........................%............%%%........................%............%%%........................%............%
m %%%.......................%%............%%%.......................%%............%%%.......................%%............%%%.......................%%............%%%.......................%%............
m .%%%.......................%%%...........%%%.......................%%%...........%%%.......................%%%...........%%%.......................%%%...........%%%.......................%%%..........
m ..%%%.......................%%............%%%.......................%%............%%%.......................%%............%%%.......................%%............%%%.......................%%..........
m ...%%%......%%...............%.............%%%......%%...............%.............%%%......%%...............%.............%%%......%%...............%.............%%%......%%...............%..........
m ....%%%....%%%...............%%.............%%%....%%%...............%%.............%%%....%%%...............%%.............%%%....%%%...............%%.............%%%....%%%...............%%.........
m .....%%%.%%%..................%..............%%%.%%%..................%..............%%%.%%%..................%..............%%%.%%%..................%..............%%%.%%%..................%.........
m ......%%%%....................%%..............%%%%....................%%..............%%%%....................%%..............%%%%....................%%..............%%%%....................%%........
m .......%%.........%%..........%%%..............%%.........%%..........%%%..............%%.........%%..........%%%..............%%.........%%..........%%%..............%%.........%%..........%%%.......
m .......%...........%...........%%%%%%..........%...........%...........%%%%%%..........%...........%...........%%%%%%..........%...........%...........%%%%%%..........%...........%...........%%%%%%...
m ......%%...........%%.........%%..............%%...........%%.........%%..............%%...........%%.........%%..............%%...........%%.........%%..............%%...........%%.........%%........
m ......%%...........%%........%%...............%%...........%%........%%...............%%...........%%........%%...............%%...........%%........%%...............%%...........%%........%%.........
m .....%%%%..........%%........%%..............%%%%..........%%........%%..............%%%%..........%%........%%..............%%%%..........%%........%%..............%%%%..........%%........%%.........
m ...%%%%%%%%........%%........%%............%%%%%%%%........%%........%%............%%%%%%%%........%%........%%............%%%%%%%%........%%........%%............%%%%%%%%........%%........%%.........
m ..%%%....%%%......%%.........%%...........%%%....%%%......%%.........%%...........%%%....%%%......%%.........%%...........%%%....%%%......%%.........%%...........%%%....%%%......%%.........%%.........
m .%%%.......%%%....%%.........%%...0......%%%.......%%%....%%.........%%...2......%%%.......%%%....%%.........%%...3......%%%.......%%%....%%.........%%...4......%%%.......%%%....%%.........%%...5.....
m .%%.........%%%%%%%..........%%..........%%.........%%%%%%%..........%%..........%%.........%%%%%%%..........%%..........%%.........%%%%%%%..........%%..........%%.........%%%%%%%..........%%.........
m .%%...........%%%%...........%%..........%%...........%%%%...........%%..........%%...........%%%%...........%%..........%%...........%%%%...........%%..........%%...........%%%%...........%%.........
m .%%..........................%%%.........%%..........................%%%.........%%..........................%%%.........%%..........................%%%.........%%..........................%%%........
m ..%%.......................%%%%%%%%.......%%.......................%%%%%%%%.......%%.......................%%%%%%%%.......%%.......................%%%%%%%%.......%%.......................%%%%%%%%.....
m ..%%......................%%%....%%%......%%......................%%%....%%%......%%......................%%%....%%%......%%......................%%%....%%%......%%......................%%%....%%%....
m ...%%...................%%%.......%........%%...................%%%.......%........%%...................%%%.......%........%%...................%%%.......%........%%...................%%%.......%.....
m ....%%.................%%%..................%%.................%%%..................%%.................%%%..................%%.................%%%..................%%.................%%%..............
m ....%%.................%%...................%%.................%%...................%%.................%%...................%%.................%%...................%%.................%%...............
m .....%%......................................%%......................................%%......................................%%......................................%%.................................
m .....%%......................................%%......................................%%......................................%%......................................%%.................................
m .....%%%.....................................%%%.....................................%%%.....................................%%%.....................................%%%................................
m ......%%%%%...................................%%%%%...................................%%%%%...................................%%%%%...................................%%%%%.............................
m ........................................................................................................................................................................................................
m ........................................................................................................................................................................................................
m ........................................................................................................................................................................................................
m ........................................................................................................................................................................................................
m .............................%%%%%...................................%%%%%...................................%%%%%...................................%%%%%...................................%%%%%......
m ................................%%%.....................................%%%.....................................%%%.....................................%%%.....................................%%%.....
m .................................%%......................................%%......................................%%......................................%%......................................%%.....
m .................................%%......................................%%......................................%%......................................%%......................................%%.....
m ...............%%.................%%...................%%.................%%...................%%.................%%...................%%.................%%...................%%.................%%....
m ..............%%%.................%%..................%%%.................%%..................%%%.................%%..................%%%.................%%..................%%%.................%%....
m .....%.......%%%...................%%........%.......%%%...................%%........%.......%%%...................%%........%.......%%%...................%%........%.......%%%...................%%...
m ....%%%....%%%......................%%......%%%....%%%......................%%......%%%....%%%......................%%......%%%....%%%......................%%......%%%....%%%......................%%..
m .....%%%%%%%%.......................%%.......%%%%%%%%.......................%%.......%%%%%%%%.......................%%.......%%%%%%%%.......................%%.......%%%%%%%%.......................%%..
m ........%%%..........................%%.........%%%..........................%%.........%%%..........................%%.........%%%..........................%%.........%%%..........................%%.
m .........%%...........%%%%...........%%..........%%...........%%%%...........%%..........%%...........%%%%...........%%..........%%...........%%%%...........%%..........%%...........%%%%...........%%.
m .........%%..........%%%%%%%.........%%..........%%..........%%%%%%%.........%%..........%%..........%%%%%%%.........%%..........%%..........%%%%%%%.........%%..........%%..........%%%%%%%.........%%.
m .....1...%%.........%%....%%%.......%%%......6...%%.........%%....%%%.......%%%......7...%%.........%%....%%%.......%%%......8...%%.........%%....%%%.......%%%......9...%%.........%%....%%%.......%%%.
m .........%%.........%%......%%%....%%%...........%%.........%%......%%%....%%%...........%%.........%%......%%%....%%%...........%%.........%%......%%%....%%%...........%%.........%%......%%%....%%%..
m .........%%........%%........%%%%%%%%............%%........%%........%%%%%%%%............%%........%%........%%%%%%%%............%%........%%........%%%%%%%%............%%........%%........%%%%%%%%...
m .........%%........%%..........%%%%..............%%........%%..........%%%%..............%%........%%..........%%%%..............%%........%%..........%%%%..............%%........%%..........%%%%.....
m .........%%........%%...........%%...............%%........%%...........%%...............%%........%%...........%%...............%%........%%...........%%...............%%........%%...........%%......
m ........%%.........%%...........%%..............%%.........%%...........%%..............%%.........%%...........%%..............%%.........%%...........%%..............%%.........%%...........%%......
m ...%%%%%%...........%...........%..........%%%%%%...........%...........%..........%%%%%%...........%...........%..........%%%%%%...........%...........%..........%%%%%%...........%...........%.......
m .......%%%..........%%.........%%..............%%%..........%%.........%%..............%%%..........%%.........%%..............%%%..........%%.........%%..............%%%..........%%.........%%.......
m ........%%....................%%%%..............%%....................%%%%..............%%....................%%%%..............%%....................%%%%..............%%....................%%%%......
m .........%..................%%%.%%%..............%..................%%%.%%%..............%..................%%%.%%%..............%..................%%%.%%%..............%..................%%%.%%%.....
m .........%%...............%%%....%%%.............%%...............%%%....%%%.............%%...............%%%....%%%.............%%...............%%%....%%%.............%%...............%%%....%%%....
m ..........%...............%%......%%%.............%...............%%......%%%.............%...............%%......%%%.............%...............%%......%%%.............%...............%%......%%%...
m ..........%%.......................%%%............%%.......................%%%............%%.......................%%%............%%.......................%%%............%%.......................%%%..
m ..........%%%.......................%%%...........%%%.......................%%%...........%%%.......................%%%...........%%%.......................%%%...........%%%.......................%%%.
m ............%%.......................%%%............%%.......................%%%............%%.......................%%%............%%.......................%%%............%%.......................%%%
m %............%........................%%%............%........................%%%............%........................%%%............%........................%%%............%........................%%
