# random seed -6967697768099053231
# players 2
# area 26960
# cell width: 1.19465937583
# cell size: 7
# openness: 0.436727947317
# grid size: (1, 2)
# tile size: (180, 74) 0.411111111111
# map size: (180, 148) 0.822222222222
# horz_copy
# maze type recursive backtracker
# final openness 0.436727947317
# map_type cell_maze
# random_seed -6967697768099053231
players 2
rows 148
cols 180
m .........%%...............%%.................%........%%.........%...%%%%%..................%%........................%%..........%%%%...........%%.............................%...
m ........%%.......%%.......%%................%%........%%.........%%%%%%...%.................%..............%..........%...........%..............%...................%..........%...
m .......%%..................%................%..........%.........%.........%..............%%............%%%%%.........%..........%%.............%....................%..........%...
m .......%%.............................%...............%%........%...........%%..........%%...........%%%%....%.......%%.........%%........%....%%....................%%.........%...
m ........%............................%................%.........%...........%%................................%......%..........%....................................%%.........%...
m ........%.......%%..................%%................%.........%%...........%..................................................%..........................%.........%%.........%...
m ........%........%................%%%................%%..........%.........................................................................................%........%...............
m .......%%.........%.....%%....................%%......%....................................................................................................%.......%........%.......
m .......%%.........%%..........................%.......%%............................%%............%%%...................................%%................%%.....%%........%........
m ..%.....%%.........%.........................%%........%..............%..........%%%%...........%%%.%%...%%%%.........%..........%........................%.......%.................
m ..%......%%..................................%........%%%%............%..........%...................%%%%%%...........%..........%.................%................................
m ..........%................%%%.............%%%........%%.%%%..........%..........%...................................%.........%%%................%%................................
m ...........%................%%%%..........%%.........%.....%%.........%.........%%.............................................%...........%%.....%.................................
m ...........%%.....%............%%........%..........%.......%.........%.........%..............................%...........................%%....%%.................................
m ............%%..%%..............%%.......%........%%........%%.......%........%%%...........%%.................%..........................%......%%.................%.....%.........
m %%...........%%%%.......%........%......%.........%%.........%......%.......%%%............%%.................%..........................%........%................%%.....%%....%%%%
m .............%%%.................%................%%.........%%%%%%%........%..............%..................%........................%%.........................%%.......%%%%%%%..
m ............%....................%.................%.........%%%%%%.........%.............%............%...............%...............%%..................%%%%%.%%.................
m ...........%....................%..................%....................1..%%.............%............%.....................%.........%.................%%%...%%%..................
m ..........%.....................%.........%........%.......................%%......%%.................%......................%.........%................%%..........................
m ....%%%%%%...............%%.....%.........%%%....%%........................%.......%.................%%..........%%%.........%%.......%.............................................
m .........................%......%%.......%...%%%%%........%................%.......%.................%............%%%................%..............................................
m ........................%%.......%%.....%......%..........%................%......%%................%%..............................%.........%%....................................
m ....................%..%%..............%..................%.......................%................%%...............................%..........%...........................%%%......
m ...................%%%%%...............................................%.........%%................%................................%.................%%%....................%%.....
m .................%%%...%..............................................%...........%...............%.........%.......................%...............%%%..........%%............%%...
m ...............%%%......%%............................................%...........%..............%%.........%.......................%...............%..........%%.....%.........%%%.
m .............%%%.........%%%......................................................%%.......%%%...%%..........%.........%%.....................................%%..................%.
m ............%%%.............%%%..................................%..................%%............%%.........%..........%%...................................%%....................%
m %...........%.................%%........%......%%....................................%.............%%........%...........%...................................%.....................%
m %%..............................%............%%%.....................................%..............%........%..........%%....%%.........%%..................%.........%............
m .%%.............................%%...........%%......%%..............................%..............%%.......%..........%%.....%.........%%..................%.........%............
m ..%%....%.......................%%%%.........%%.......%...................%%.........%...............%%......%..........%...............%%..........................................
m .............................................%........%%..................%%.........%...............%%......%%.........%..............%%...........................................
m ...................%%%%......................%.........%.......%..........%..........%...............%........%........%..............%%...........%%%%%....................%.......
m ...................%.........................%................%%..........%.........................%%........%%.......%.............%%..........%%%...%.........%%%................
m ..................%%.........................%................................................%.....%..........%......%%............%%...........%...............%%%................
m ..................%........%................%%...............................................%%.......................%%..........%%%%..............................................
m .........%........%........%%.........%.....%%.......................%%........%............%%.......................%%%%...........%........................................%......
m .................%%........%%.........%%%%%%%%......%..........................%...........%%...........................%%%.........%%......................................%%.....%
m .................%...................%....%%%%.....%%...........................%.........%%..............................%%.........%.....................................%%......%
m ................%%..................%........%.......%..........................%........%%...............%...................................%%............%..........%%%%%........
m .................%.................%..................%.....%..................%%.......%%.............%%%%..................................%%............%%%...........%%.........
m .................%......%.........%....................%....%%.................%........%....................................................%%............%........................
m ..%%%%...........%%...............%....................%.....%%...............%...................................%%.........................%............%.......%.................
m .....%%..........%................%....................%......%%......%.......%.................................%%%..........................%.........%%%%.........................
m ......%..........%...........................%........%%.......%%....%........%%...................%%%.........%%............................%.........%............................
m .......%........%%....................................%..............%.........%............................................%%....%..........%......................................
m ................%%....................................%..............%.........%..........................................%%%.....%%.........%......................................
m .................%...........%.........%%............%%..............%.........%%.......%%..............................%%%........%.........%.....................%........%%%%%...
m .................%%.........%%.......................%%..............%%.........%%%%%%.%%...............................%%..................%%....................%%.......%%..%%...
m ..................%%%........%...................%%%%%%...............%%............%%%%........%........................%%.................%%...................%%........%........
m ....................%%........%..................%%....%%..............%%.............%.........%............%%%..........%..................%%%%%%%..........%%%%..................
m .....%%..............%........%..................%.......%%%.............%%...........%.........%..........%%..%%.........%....................%%%...........%%%%...................
m %%%%%%%........................%......%.........%.........................%%..........%..........%........%%.....%%........%................................%......................%
m %..............................%.......%........%................%.........%%.........%..........%%.......%.......%........%...............................%........................
m ........................................%........................%..........%.....................%%%....%%.......%........%%.............................%.........................
m ..........%%%%...........................%.......................%%.........%%......................%%%%%%.........%.....................................%%..............%%.........
m .........%%%%%%..........................%........................%..........%%%.....................%.............%.............%%...%%.................%%...............%%........
m .........%....%%%.....%..................%...............%........%............%%..................................%%%...........%%.....................%%..........%......%%.......
m .........%......%%%.%%%......%%..........%.............%%%.......%%....%........%.........%%.........................%%..........%.....................%%..........%%.......%%......
m ........%.........%%%.........%......................%%%........%%.....%..................%%.....................................%..............%%....%%........%%%%.........%%.....
m ........%..........%..........%....................%%%.........%%.........................%%.....................................%.............%%....%%.......%%%.............%%%%%.
m .......%%..........%................%..............%%.........%%..........................%%.................%%.................%%............%%..............................%%....
m .....%%%...........%................%..............%..........%%.........................%%........%.........%.........%%......%%............%%...............................%.....
m ....%%.............%................%.........................%%.................%.......%..........%........%................%%.............%......................................
m ....%%.............%................%%........%...............%%.................%%.................%%.......%................%............%%%.......................%%.............
m ....%................................%........%...............%%........%%........%%.................%......%%................%...........%%...........................%%...........
m ...%%................................%.......%.................%%.................%%.......................%%................%%.........%%..........................................
m ...%.........%%......................%%%%%%%%%..........%%......%.................%%...............................%%........%%........%%..............%%...%%......................
m ...%........%%%............%........%%.......%..........%.......%.................%%................................%........%........................%%......%%....................
m ..%%........%%.............%.......%%........%..........%.......%.................%%..............%..................%...............................%%........%....................
m ..%........%%..............%..................%........%........%%............................%%%%%..................%%.............................%%.........%.........%..........
m ..........%%..............%%.................%%........%.........%...........................%%.......................%..............%%...........%%%...........%...............%%..
m .........%%...............%%.................%........%%.........%...%%%%%..................%%........................%%..........%%%%...........%%.............................%...
m ........%%.......%%.......%%................%%........%%.........%%%%%%...%.................%..............%..........%...........%..............%...................%..........%...
m .......%%..................%................%..........%.........%.........%..............%%............%%%%%.........%..........%%.............%....................%..........%...
m .......%%.............................%...............%%........%...........%%..........%%...........%%%%....%.......%%.........%%........%....%%....................%%.........%...
m ........%............................%................%.........%...........%%................................%......%..........%....................................%%.........%...
m ........%.......%%..................%%................%.........%%...........%..................................................%..........................%.........%%.........%...
m ........%........%................%%%................%%..........%.........................................................................................%........%...............
m .......%%.........%.....%%....................%%......%....................................................................................................%.......%........%.......
m .......%%.........%%..........................%.......%%............................%%............%%%...................................%%................%%.....%%........%........
m ..%.....%%.........%.........................%%........%..............%..........%%%%...........%%%.%%...%%%%.........%..........%........................%.......%.................
m ..%......%%..................................%........%%%%............%..........%...................%%%%%%...........%..........%.................%................................
m ..........%................%%%.............%%%........%%.%%%..........%..........%...................................%.........%%%................%%................................
m ...........%................%%%%..........%%.........%.....%%.........%.........%%.............................................%...........%%.....%.................................
m ...........%%.....%............%%........%..........%.......%.........%.........%..............................%...........................%%....%%.................................
m ............%%..%%..............%%.......%........%%........%%.......%........%%%...........%%.................%..........................%......%%.................%.....%.........
m %%...........%%%%.......%........%......%.........%%.........%......%.......%%%............%%.................%..........................%........%................%%.....%%....%%%%
m .............%%%.................%................%%.........%%%%%%%........%..............%..................%........................%%.........................%%.......%%%%%%%..
m ............%....................%.................%.........%%%%%%.........%.............%............%...............%...............%%..................%%%%%.%%.................
m ...........%....................%..................%....................0..%%.............%............%.....................%.........%.................%%%...%%%..................
m ..........%.....................%.........%........%.......................%%......%%.................%......................%.........%................%%..........................
m ....%%%%%%...............%%.....%.........%%%....%%........................%.......%.................%%..........%%%.........%%.......%.............................................
m .........................%......%%.......%...%%%%%........%................%.......%.................%............%%%................%..............................................
m ........................%%.......%%.....%......%..........%................%......%%................%%..............................%.........%%....................................
m ....................%..%%..............%..................%.......................%................%%...............................%..........%...........................%%%......
m ...................%%%%%...............................................%.........%%................%................................%.................%%%....................%%.....
m .................%%%...%..............................................%...........%...............%.........%.......................%...............%%%..........%%............%%...
m ...............%%%......%%............................................%...........%..............%%.........%.......................%...............%..........%%.....%.........%%%.
m .............%%%.........%%%......................................................%%.......%%%...%%..........%.........%%.....................................%%..................%.
m ............%%%.............%%%..................................%..................%%............%%.........%..........%%...................................%%....................%
m %...........%.................%%........%......%%....................................%.............%%........%...........%...................................%.....................%
m %%..............................%............%%%.....................................%..............%........%..........%%....%%.........%%..................%.........%............
m .%%.............................%%...........%%......%%..............................%..............%%.......%..........%%.....%.........%%..................%.........%............
m ..%%....%.......................%%%%.........%%.......%...................%%.........%...............%%......%..........%...............%%..........................................
m .............................................%........%%..................%%.........%...............%%......%%.........%..............%%...........................................
m ...................%%%%......................%.........%.......%..........%..........%...............%........%........%..............%%...........%%%%%....................%.......
m ...................%.........................%................%%..........%.........................%%........%%.......%.............%%..........%%%...%.........%%%................
m ..................%%.........................%................................................%.....%..........%......%%............%%...........%...............%%%................
m ..................%........%................%%...............................................%%.......................%%..........%%%%..............................................
m .........%........%........%%.........%.....%%.......................%%........%............%%.......................%%%%...........%........................................%......
m .................%%........%%.........%%%%%%%%......%..........................%...........%%...........................%%%.........%%......................................%%.....%
m .................%...................%....%%%%.....%%...........................%.........%%..............................%%.........%.....................................%%......%
m ................%%..................%........%.......%..........................%........%%...............%...................................%%............%..........%%%%%........
m .................%.................%..................%.....%..................%%.......%%.............%%%%..................................%%............%%%...........%%.........
m .................%......%.........%....................%....%%.................%........%....................................................%%............%........................
m ..%%%%...........%%...............%....................%.....%%...............%...................................%%.........................%............%.......%.................
m .....%%..........%................%....................%......%%......%.......%.................................%%%..........................%.........%%%%.........................
m ......%..........%...........................%........%%.......%%....%........%%...................%%%.........%%............................%.........%............................
m .......%........%%....................................%..............%.........%............................................%%....%..........%......................................
m ................%%....................................%..............%.........%..........................................%%%.....%%.........%......................................
m .................%...........%.........%%............%%..............%.........%%.......%%..............................%%%........%.........%.....................%........%%%%%...
m .................%%.........%%.......................%%..............%%.........%%%%%%.%%...............................%%..................%%....................%%.......%%..%%...
m ..................%%%........%...................%%%%%%...............%%............%%%%........%........................%%.................%%...................%%........%........
m ....................%%........%..................%%....%%..............%%.............%.........%............%%%..........%..................%%%%%%%..........%%%%..................
m .....%%..............%........%..................%.......%%%.............%%...........%.........%..........%%..%%.........%....................%%%...........%%%%...................
m %%%%%%%........................%......%.........%.........................%%..........%..........%........%%.....%%........%................................%......................%
m %..............................%.......%........%................%.........%%.........%..........%%.......%.......%........%...............................%........................
m ........................................%........................%..........%.....................%%%....%%.......%........%%.............................%.........................
m ..........%%%%...........................%.......................%%.........%%......................%%%%%%.........%.....................................%%..............%%.........
m .........%%%%%%..........................%........................%..........%%%.....................%.............%.............%%...%%.................%%...............%%........
m .........%....%%%.....%..................%...............%........%............%%..................................%%%...........%%.....................%%..........%......%%.......
m .........%......%%%.%%%......%%..........%.............%%%.......%%....%........%.........%%.........................%%..........%.....................%%..........%%.......%%......
m ........%.........%%%.........%......................%%%........%%.....%..................%%.....................................%..............%%....%%........%%%%.........%%.....
m ........%..........%..........%....................%%%.........%%.........................%%.....................................%.............%%....%%.......%%%.............%%%%%.
m .......%%..........%................%..............%%.........%%..........................%%.................%%.................%%............%%..............................%%....
m .....%%%...........%................%..............%..........%%.........................%%........%.........%.........%%......%%............%%...............................%.....
m ....%%.............%................%.........................%%.................%.......%..........%........%................%%.............%......................................
m ....%%.............%................%%........%...............%%.................%%.................%%.......%................%............%%%.......................%%.............
m ....%................................%........%...............%%........%%........%%.................%......%%................%...........%%...........................%%...........
m ...%%................................%.......%.................%%.................%%.......................%%................%%.........%%..........................................
m ...%.........%%......................%%%%%%%%%..........%%......%.................%%...............................%%........%%........%%..............%%...%%......................
m ...%........%%%............%........%%.......%..........%.......%.................%%................................%........%........................%%......%%....................
m ..%%........%%.............%.......%%........%..........%.......%.................%%..............%..................%...............................%%........%....................
m ..%........%%..............%..................%........%........%%............................%%%%%..................%%.............................%%.........%.........%..........
m ..........%%..............%%.................%%........%.........%...........................%%.......................%..............%%...........%%%...........%...............%%..
